دادن	pænɒːhdɒːdæn,tekɒːndɒːdæn,pænddɒːdæn,d͡ʒɒːdɒːdæn
!یاهو	jɒːhuː!
.واشینگتن دی.سی	vɒːʃenɡtondiː.siː.
آئورت	ɒːʔoɾt
آب	ɒːb
آب اکسیژنه	ɒːboksiːʒene
آب حیات	ɒːbehejɒːt
آب دادن	ɒːbdɒːdæn
آب زدن	ɒːbzædæn
آب سیب	ɒːbesiːb
آب شدن	ɒːbʃodæn
آب معدنی	ɒːbmæʔdæniː
آب و هوا	ɒːbohævɒː
آب کردن	ɒːbkæɾdæn
آب کشیدن	ɒːbkeʃiːdæn
آب گرفتن	ɒːbɡeɾeftæn
آبادان	ɒːbædæn
آبادی	ɒːbɒːdiː
آبان	ɒːbɒːn
آباژور	ɒːbɒːʒuːɾ
آبتنی	ɒːbtæniː
آبتنی کردن	ɒːbtæniːkæɾdæn
آبجو	ɒːbd͡ʒoʊ,ɒːbd͡ʒo
آبجو زدن	ɒːbd͡ʒozædæn
آبخاز	ɒːbxɒːz
آبخازستان	ɒːbxɒːzestɒːn
آبخازیه	ɒːbxɒːziːje
آبدست	ɒːbdæst
آبراه	ɒːbɾɒːh
آبریز	ɒːbɾiːz
آبزی شناسی	ɒːbziːʃenɒːsiː
آبزیدان	ɒːbziːdɒːn
آبستنی	ɒːbestæniː
آبشار	ɒːbʃɒːɾʔ,ɒːbʃɒːɾ
آبغوره	ɒːbɢuːɾe
آبغوره گرفتن	ɒːbɢuːɾeɡeɾeftæn
آبفشاری	ɒːbfeʃæɾiː
آبمیوه	ɒːbmiːve
آبْلرْزه	ɒːblæɾze
آبچین	ɒːbt͡ʃiːn
آبکش	ɒːbkeʃ
آبکش کردن	ɒːbkeʃkæɾdæn
آبگونه	ɒːbɡuːne
آبگینه	ɒːbɡiːne
آبی	ɒːbiː
آبی آسمانی	ɒːbiːjeɒːsemɒːniː
آب‌سنگ	ɒːbsænɡ
آب‌نما	ɒːbnæmɒː
آب‌پنیر	ɒːbpæniːɾ
آتش	ɒːtæʃ
آتش زدن	ɒːtæʃzædæn
آتش کشیدن	ɒːtæʃkeʃiːdæn
آتش گرفتن	ɒːtæʃɡeɾeftæn
آتشسوزی	ɒːtæʃsuːziː
آتش‌بس	ɒːtæʃbæs
آتش‌فشان	ɒːteʃfeʃɒːn
آتش‌نشان	ɒːtæʃneʃɒːn
آتن	ɒːten
آتنا	ɒːtenɒː
آجر	ɒːd͡ʒoɾ
آجری	ɒːd͡ʒoɾiː
آخ	ɒːx
آخر	ɒːxæɾ
آخر هفته	ɒːxeɾehæfte,ɒːxæɾehæfte
آخرت	ɒːxeɾæt
آخشیج	ɒːxʃiːd͡ʒ
آخور	ɒːxoɾ
آخوندک	ɒːxuːndæk
آدام	ɒːdɒːm
آدامس	ɒːdɒːms
آدرس	ɒːdɾes
آدم	ɒːdæm
آدم برفی	ɒːdæmbæɾfiː
آدمی	ɒːdæmiː
آدم‌خواری	ɒːdæmxɒːɾiː
آدیس آبابا	ɒːdiːsɒːbɒːbɒː
آدینه	ɒːdiːne
آذر	ɒːzæɾ
آذربایجان	ɒːzæɾbɒːjed͡ʒɒːn,ɒːzæɾbɒːjd͡ʒɒːn
آذربایجانی	ɒːzæɾbɒːjd͡ʒɒːniː
آذرخش	ɒːzæɾæxʃ
آذری	ɒːzæɾiː
آرارات	ɒːɾæɾæt
آراستن	ɒːɾɒːstæn
آرام	ɒːɾɒːm
آرام شدن	ɒːɾɒːmʃodæn
آرام گرفتن	ɒːɾɒːmɡeɾeftæn
آرامش	ɒːɾɒːmeʃ
آرامش بخشیدن	ɒːɾɒːmeʃbæxʃiːdæn
آرامگاه	ɒːɾɒːmɡɒːh
آرانی	ɒːɾɒːniː
آرايشگر	ɒːɾɒːjeʃɡæɾ
آرایش	ɒːɾɒːjeʃ
آرایش دادن	ɒːɾɒːjeʃdɒːdæn
آرایه	ɒːɾɒːje
آرخانگلسک	ɒːɾxɒːnɡelsk
آرد	ɒːɾd
آرزو	ɒːɾezuː
آرزو داشتن	ɒːɾezuːdɒːʃtæn,ɒːɾezuːdɒːʃtæn
آرزو كردن	ɒːɾezuːkæɾdæn
آرزو کردن	ɒːɾezuːkæɾdæn
آرزو کشیدن	ɒːɾezuːkeʃiːdæn
آرزومندی	ɒːɾezuːmændiː
آرسنیک	ɒːɾseniːk
آرمان	ɒːɾmɒːn
آرمانی	ɒːɾmɒːniː
آرماگدون	ɒːɾmæɡedon
آرنج	ɒːɾænd͡ʒ,ɒːɾend͡ʒ
آره	ɒːɾe
آروغ	ɒːɾoɢ
آروغ زدن	ɒːɾoɢzædæn
آرژانتین	ɒːɾʒɒːntiːn
آرگون	ɒːɾɡon
آریایی	ɒːɾiːjɒːjiː
آزاد	ɒːzɒːd
آزاد ساختن	ɒːzɒːdsɒːxtæn
آزاد کردن	ɒːzɒːdkæɾdæn
آزادماهی	ɒːzɒːdmɒːhiː
آزادی	ɒːzɒːdiː
آزادی بیان	ɒːzɒːdiːjebejɒːn
آزادی مطبوعات	ɒːzɒːdiːjemætbuːʔɒːt
آزار	ɒːzɒːɾ
آزار دادن	ɒːzɒːɾdɒːdæn
آزمایش	ɒːzmɒːjeʃ
آزمایشگاه	ɒːzmɒːjeʃɡɒːh
آزمودن	ɒːzmuːdæn
آزمون‌پذیر	ɒːzmuːnpæziːɾ
آزمون‌پذیری	ɒːzmuːnpæziːɾiː
آسان	ɒːsɒːn
آستانه	ɒːstɒːne
آستریکس	ɒːsteɾjks
آسفالت	ɒːsfɒːlt
آسفالت شدن	ɒːsfɒːltʃodæn
آسفالت کردن	ɒːsfɒːltkæɾdæn
آسمان	ɒːsmɒːn,ɒːsemɒːn
آسیا	ɒːsiːjɒː
آسیای جنوبی	ɒːsiːjɒːjed͡ʒonuːbiː
آسیب	ɒːsiːb
آسیب خوردن	ɒːsiːbxoɾdæn
آسیب رسیدن	ɒːsiːbɾesiːdæn
آسیب زدن	ɒːsiːbzædæn
آسیب‌شناسی	ɒːsiːbʃenɒːsiː
آشامیدن	ɒːʃɒːmiːdæn
آشامیدنی	ɒːʃɒːmiːdæniː
آشتی	ɒːʃtiː,æʃtiː
آشتی دادن	æʃtiːdɒːdæn
آشتی کردن	æʃtiːkæɾdæn
آشخال	ɒːʃxɒːl
آشغال	ɒːʃɢɒːl
آشنا	ɒːʃenɒː,ɒːʃnɒː
آشنا شدن	ɒːʃnɒːʃodæn
آشنایی	ɒːʃnɒːjiː
آشنایی دادن	ɒːʃnɒːjiːdɒːdæn
آشوب	ɒːʃuːb
آشور	ɒːʃuːɾ
آشپز	ɒːʃpæz
آشپزخانه	ɒːʃpæzxɒːne
آشپزی	ɒːʃpæziː
آشکار کردن	ɒːŝkɒːɾkæɾdæn
آشیانه	ɒːʃjɒːne
آشیانه گرفتن	ɒːʃjɒːneɡeɾeftæn
آغا	ɒːɢɒː
آغاز	ɒːɢɒːz
آغاز شدن	ɒːɢɒːzʃodæn
آغوش	ɒːɢuːʃ
آغوش کشیدن	ɒːɢuːʃkeʃiːdæn
آغوش گرفتن	ɒːɢuːʃɡeɾeftæn
آفت	ɒːfæt
آفتاب	ɒːftɒːb
آفتاب گرفتن	ɒːftɒːbɡeɾeftæn
آفتابه	ɒːftɒːbe
آفتابگیر	ɒːftɒːbɡiːɾ
آفتابگیر زدن	ɒːftɒːbɡiːɾzædæn
آفتابی	ɒːftɒːbiː
آفتاب‌پرست	ɒːftɒːbpæɾæst
آفریدن	ɒːfæɾiːdæn
آفریقا	ɒːfɾiːɢɒː
آفریقای جنوبی	ɒːfɾiːɢɒːjed͡ʒonuːbiː
آفریقایی	ɒːfɾiːɢɒːjiː
آفریکانز	ɒːfɾiːkɒːnz
آفریکانس	ɒːfɾiːkɒːns
آقا	ɒːɢɒː,ɒːĝɒː
آقاپسر	ɒːɢɒːpesæɾ
آلاباما	ɒːlɒːbɒːmɒː
آلاسکا	ɒːlæskæ
آلبالو	ɒːlbɒːluː
آلبانی	ɒːlbɒːniː
آلت	ɒːlæt
آلت تناسلی مرد	ɒːlætetænɒːsoliːjemæɾd
آلتای	ɒːltɒːj
آلش	ɒːlæʃ
آلفا	ɒːlfɒː
آلمان	ɒːlmɒːn
آلمان شرقی	ɒːlemɒːnʃæɾɢiː
آلمانی	ɒːlmæniː
آلو	ɒːluː
آلو بخارا	ɒːluːboxɒːɾɒː
آلومینیم	ɒːluːmiːniːjom
آلوچه جنگلی	ɒːluːt͡ʃed͡ʒænɡæliː
آلپ	ɒːlp
آماج	ɒːmɒːd͡ʒ
آماج گرفتن	ɒːmɒːd͡ʒɡeɾeftæn
آماده	ɒːmɒːde,ɒːmɒːdæ
آمدن	ɒːmædæn
آمریکا	ɒːmɾiːkɒː
آمریکای جنوبی	ɒːmɾiːkɒːjed͡ʒænuːbiː
آمریکای شمالی	ɒːmɾiːkɒːjeʃomɒːliː
آمریکایی	ɒːmɾiːkɒːjiː
آمریکایی‌سازی	ɒːmɾiːkɒːjiːsɒːziː
آمریکیوم	ɒːmeɾiːkiːjom
آمو دریا	ɒːmuːdæɾjɒː
آموختن	ɒːmuːxtæn
آمودریا	ɒːmuːdæɾjɒː
آمور	ɒːmuːɾ
آموزش	ɒːmuːzeʃ
آموزش دادن	ɒːmuːzeʃdɒːdæn
آموزشگاه	ɒːmuːzeʃɡæh
آموزگار	ɒːmuːzɡɒːɾ
آمپول	ɒːmpuːl
آمپول زدن	ɒːmpuːlzædæn
آمیختن	ɒːmiːxtæn
آمیخته	ɒːmiːxte,ɒːmiːxtæ
آمیزش	ɒːmiːzeʃ
آمیزش جنسی	ɒːmiːzeʃed͡ʒensiː
آمیزش جنسی مقعدی	ɒːmiːzeʃed͡ʒensiːjemæɢʔædiː
آمیزه	ɒːmiːze,ɒːmiːzæ
آمین	ɒːmiːn
آن	ɒːn
آناتولی	ɒːnætoliː
آناتومی	ɒːnætomiː
آنان	ɒːnɒːn
آناناس	ɒːnɒːnɒːs
آناپا	ɒːnɒːpɒː
آنتن	ɒːnten
آنتن زدن	ɒːntenzædæn
آنتیگوا و باربودا	ɒːntiːɡvɒːvæbɒːɾbuːdɒː
آندورا	ɒːndoɾɒː
آنها	ɒːnhɒː
آنکارا	ɒːnkæɾæ
آنگولا	ɒːnɡuːlɒː
آنی	بلافاصله
آه	ɒːh
آه کشیدن	ɒːhkeʃiːdæn
آها	ɒːhɒː
آهار	ɒːhɒːɾ
آهار زدن	ɒːhɒːɾzædæn
آهسته	ɒːheste
آهن	ɒːhæn
آهنگ	ɒːhænɡ
آهنگ جمله	ɒːhænɡed͡ʒomle
آهنگ داشتن	ɒːhænɡdɒːʃtæn
آهنگ زدن	ɒːhænɡzædæn
آهنگساز	ɒːhænɡsɒːz
آهو	ɒːhuː
آهو ماده	ɒːhuːjemɒːde
آهوبره	ɒːhuːbæɾɾe
آوا	ɒːvɒː
آواز	ɒːvɒːz
آواز خواندن	ɒːvɒːzxɒːndæn
آواز دادن	ɒːvɒːzdɒːdæn
آواز زدن	ɒːvɒːzzædæn
آواشناسی	ɒːvæʃenɒːsiː
آوردن	ɒːvæɾdæn,ɒːvoɾdæn
آوریل	ɒːvɾîl
آوند	ɒːvænd
آووکادو	ɒːvokɒːdo
آويزان كردن	ɒːviːzɒːnkæɾdæn
آپارتمان	ɒːpɒːɾtemɒːn
آچمز	ɒːt͡ʃmæz
آژان پرووکاتور	ɒːʒɒːnpɾovokɒːtoɾ
آژانس ازدواج	ɒːʒɒːnsezdevɒːd͡ʒ
آکندن	ɒːkændæn
آکواریوم	ɒːkvɒːɾjuːm
آکوردئون	ɒːkoɾdeʔon
آگاهی	ɒːɡɒːhiː
آگاهی دادن	ɒːɡɒːhiːdɒːdæn
آگرا	ɒːɡɾɒː
آگره	ɒːɡɾe
آگهی	ɒːɡæhiː
آگهی دادن	ɒːɡæhiːdɒːdæn
آیت‌الله	ɒːjætollɒːh
آینده	ɒːjænde
آیین	ɒːjiːn
آیینه	ɒːjiːne
آی‌فون	ɒːjfuːn
آی‌پاد	ɒːjpɒːd
ابا	æbɒː
ابابیل	æbɒːbiːl
اباختر	æbɒːxtæɾ
ابجد	ɒːbǧæd
ابر	æbæɾ
ابر اورت	æbɾeuːɾt
ابراهیم	iːbɾɒːhiːm,ebɾɒːhiːm
ابربازار	æbɾæbɒːzɒːɾ
ابرنواختر	æbæɾnouːæxtæɾ
ابرو	æbɾuː
ابریشم	æbɾiːʃæm
ابریق	ebɾiːɢ
ابلاغ	eblɒːɢ
ابلاغ کردن	eblɒːɢkæɾdæn
ابن سینا	ebnesiːnɒː
ابهام	ebhɒːm
ابوالهول	æbuːælhuːl
ابوظبی	æbuːzɒːbiː
اتازونی	etɒːzuːniː
اتاق	otɒːɢ
اتاق گاز	otɒːɢeɡɒːz
اتحاد	ettehɒːd
اتحاد جماهیر شوروی سوسیالیستی	ettehɒːded͡ʒæmɒːhiːɾeʃuːɾæviːjesosiːjɒːliːstiː
اتحاد شوروی	ettehɒːdeʃuːɾæviː,ettehɒːdeʃouːɾæviː
اتحادیه آفریقا	ettehɒːdiːjeɒːfɾiːɢɒː
اتحادیه اروپا	ettehɒːdiːjeoɾuːpɒː
اتریش	otɾiːʃ
اتصال	ettesɒːl
اتصال مجازی	ettesɒːlemæd͡ʒɒːziː
اتفاقا	ettefɒːɢæn
اتفاقه دیگه	ettefɒːɢediːɡe
اتهام	ettehɒːm
اتهام خوردن	ettehɒːmxoɾdæn
اتهام زدن	ettehɒːmzædæn
اتو	otuː
اتو زدن	otuːzædæn
اتو کردن	otuːkæɾdæn
اتوبوس	otobuːs
اتود	etuːd
اتود زدن	etuːdzædæn
اثر	æsæɾ
اثر کردن	æsæɾkæɾdæn
اثر گرفتن	æsæɾɡeɾeftæn
اجاره	ed͡ʒɒːɾe
اجاره دادن	ed͡ʒɒːɾedɒːdæn,ed͡ʒɒːɾedɒːdæn
اجاره کردن	ed͡ʒɒːɾekæɾdæn,ed͡ʒɒːɾekæɾdæn
اجازه	ed͡ʒɒːze
اجازه دادن	ed͡ʒɒːzedɒːdæn
اجاس	ed͡ʒɒːs
اجاق	od͡ʒɒːɢ
اجرا	ed͡ʒɾɒː
اجرا کردن	ed͡ʒɾɒːkæɾdæn
اجماع	ed͡ʒmɒːʔ
اجنبی	æd͡ʒnæbiː
احترام	ehteɾɒːm
احترام گذاشتن	ehteɾɒːmɡozɒːʃtæn,ehteɾɒːmɡozɒːʃtæn
احتياط	ehtiːɒːt
احتياط کردن	entiːɒːtkæɾdæn
احتیاج	ehtiːɒːd͡ʒ
احتیاج داشتن	ehtiːɒːd͡ʒdɒːʃtæn
احساس	ehsɒːs
احساس کردن	ehsɒːskæɾdæn
احضار	ehzɒːɾ
احضار کردن	ehzɒːɾkæɾdæn
احمق	æhmæɢ
احمقانه	æhmæɢɒːne
اخبار	æxbæɾ
اختر	æxtæɾ
اختربین	æxtæɾbiːn
اخترشناس	æxtæɾʃenɒːs
اخترمار	æxtæɾmɒːɾ
اختری	æxtæɾiː
اختصاص	extesɒːs
اختصاص دادن	extesɒːsdɒːdæn
اختصاص داشتن	extesɒːsdɒːʃtæn
اختلاط	extelɒːt
اختلاط کردن	extelɒːtkæɾdæn
اختلاف	extelɒːf
اخته	æxte
اختیار	extiːɒːɾ
اختیار افتادن	extiːɒːɾoftɒːdæn
اختیار دادن	extiːɒːɾdɒːdæn
اختیار گذاشتن	extiːɒːɾɡozɒːʃtæn
اخراج	exɾɒːd͡ʒ
اخراج کردن	exɾɒːd͡ʒkæɾdæn
اخطار	extɒːɾ
اخطار کردن	extɒːɾkæɾdæn
اخلاق	æxlɒːɢ
اخم	æxm
اخم کردن	æxmkæɾdæn
اخیرا	æxiːɾæn
ادا	ædɒː
ادا آمدن	ædɒːɒːmædæn
ادا درآوردن	ædɒːdæɾɒːvæɾdæn
ادا کردن	ædɒːkæɾdæn
اداره	edɒːɾe
اداره پست	edɒːɾejepost
ادامه	edɒːme
ادامه دادن	edɒːmedɒːdæn
ادامه داشتن	edɒːmedɒːʃtæn
ادامه یافتن	edɒːmejɒːftæn
ادب	ædæb
ادبی	ædæbiː
ادرار	edɾɒːɾ
ادراری	edɾɒːɾiː
ادعا	eddeʔɒː
ادعا کردن	eddeʔɒːkæɾdæn
ادوکلن	odokolon
ادویه	ædviːje
ادویه زدن	ædviːjezædæn
ادکلن	odkolon
ادیان ابراهیمی	ædjɒːneebɾɒːhiːmiː
اذان	æzɒːn
اذیت	æziːjæt
اذیت کردن	æziːjætkæɾdæn
ارائه	eɾɒːʔe
ارائه دادن	eɾɒːʔedɒːdæn
ارائه شدن	eɾɒːʔeʃodæn
ارابه	æɾɾɒːbe,æɾɒːbe
ارت	eɾt
ارت کردن	eɾtkæɾdæn
ارتباط	eɾtebɒːt
ارتداد	eɾtedɒːd
ارتش	æɾteʃ
ارتفاع	eɾtefɒːʔ
ارث	eɾs
ارث بردن	eɾsboɾdæn
ارث رسیدن	eɾsɾesiːdæn
ارث گذاشتن	eɾsɡozɒːʃtæn
ارج نهادن	æɾd͡ʒnæhɒːdæn
ارد	oɾd
اردنگی 	oɾdænɡiː
اردنگی  زدن	oɾdænɡiːzædæn
اردو	oɾduː
اردو زدن	oɾduːzædæn
اردک	oɾdæk
اردیبهشت	oɾdiːbeheʃt
ارزان	æɾzɒːn
ارزانی	æɾzɒːniː
ارزانی داشتن	æɾzɒːniːdɒːʃtæn
ارزش	æɾzeʃ
ارزشگذاری	æɾzeʃɡodhæɾiː
ارزن	æɾzæn
ارزیابی	æɾzjɒːbiː
ارزیابی کردن	æɾzjɒːbiːkæɾdæn
ارس	æɾæs
ارسال	eɾsɒːl
ارسال کردن	eɾsɒːlkæɾdæn
ارسطو	æɾestuː
ارشاد	eɾʃɒːd
ارشاد کردن	eɾʃɒːdkæɾdæn
ارشمیدس	æɾʃemiːdes
ارعابگری	eɾʔɒːbɡæɾiː
ارغنون	æɾɢænuːn
ارغوانی	æɾɢævɒːniː
ارقام رومی	æɾɢɒːmeɾuːmiː
ارمغان	æɾmæɢɒːn
ارمغان دادن	æɾmæɢɒːndɒːdæn
ارمنستان	æɾmænestɒːn
ارمنی	æɾmæniː
ارمود	æɾmuːd
ارنبورگ	oɾenbuːɾɡ
ارنی ترنگ	oɾniːtoɾænɡ
اره	æɾɾe
اره كردن	æɾɾekæɾdæn
اره و اوره و شمسی کوره	ɒːɾeuːɾeʃæmsiːkuːɾe
اره کشیدن	æɾɾekeʃiːdæn
اره‌ماهی	æɾɾemɒːhiː
اروتیکی	eɾotiːkiː
اروس	eɾuːs
ارومیه	oɾuːmiːe
اروپا	oɾuːpɒː
اروپای مرکزی	oɾuːpɒːjemeɾkæziː
اروگوئه	oɾuːɡuːʔe
ارکاک	eɾkɒːk
ارکستر	oɾkestɾ
ارگ	oɾɡ
ارگاسم	oɾɡɒːsm
از	æz
از بر	æzbæɾ
از حالا	æzhɒːlæn
از حفظ	æzhefz
از دست دادن	æzdæstdɒːdæn
از طرف ديگر	æztæɾæfdîɡæɾ
از کی	æzkej
از کی تا حالا	æzkejtɒːhɒːlɒː
ازبکستان	ozbækestɒːn
ازبکی	ozbækiː
ازدواج	ezdevɒːd͡ʒ
ازدواج کردن	ezdevɒːd͡ʒkæɾdæn,ezdevɒːd͡ʒkæɾdæn
ازن	ozon
ازوپ	ezuːp
ازگیل	æzɡiːl
اس ام اس	esemes,esemes
اس ام اس زدن	esemeszædæn
اس ام اس کردن	esemeskæɾdæn
اسب	æsb
اسب آبی	æsbeɒːbiː
اسب دریایی	æsbedæɾjɒːjiː
اسباب	æsbɒːb
اسباب بازی	æsbɒːbbɒːziː
اسباب کشیدن	æsbɒːbkeʃiːdæn
است	æst
استاتین	æstɒːtiːn
استاد	ostɒːd
استارباکس	estɒːɾbɒːks
استارت	estɒːɾt
استارت زدن	estɒːɾtzædæn
استانبول	estɒːmbuːl
استاندارد	estɒːndɒːɾd
استثمار	estesmɒːɾ
استثمار شدن	estesmɒːɾʃodæn
استثنایی	estesnæeiː
استخدام	estexdɒːm
استخدام شدن	estexdɒːmʃodæn
استخدام کردن	estexdɒːmkæɾdæn
استخر	estæxɾ
استخوان	ostoxɒːn,ostexwɒːn
استخوانی	ostexɒniː
استخوان‌بندی	ostoxɒːnbændiː
استخون	ostoxuːn
استراتفورد	estɾɒːtfoɾd
استراتژی	esteɾɒːteʒiː
استراحت	esteɾɒːhæt
استراحت کردن	esteɾɒːhætkæɾdæn
استرالیا	ostɾɒːliːjæ
استرونسیم	æstɾuːnsiːm
استعداد	esteʔdɒːd
استعمارگری	esteʔmɒːɾɡæɾiː
استفاده	estefɒːde
استفاده شدن	estefɒːdeʃodæn
استفاده کردن	estefɒːdekæɾdæn,estefɒːdekæɾdæn
استفراغ	estefɾɒːɢ
استفراغ افتادن	estefɾɒːɢoftɒːdæn
استفراغ کردن	estefɾɒːɢkæɾdæn
استقبال	esteɢbɒːl
استقبال کردن	esteɢbɒːlkæɾdæn
استمنا کردن	estemnɒːkæɾdæn
استنباط	estembɒːt
استنباط شدن	estembɒːtʃodæn
استنطاق	estentɒːɢ
استنطاق کردن	estentɒːɢkæɾdæn
استنطاق کشیدن	estentɒːɢkeʃiːdæn
استوار بودن	ostovɒːɾbuːdæn
استوخودوس	ostoxuːddos
استودیو	estuːdiːjuː
استونی	estuːniː
استونیائی	estuːniːjɒːʔiː
استونیایی	estuːniːjɒːjiː
استکان	estekɒːn
استکان زدن	estekɒːnzædæn
اسحاق	eʃɒːɢ
اسرائیل	esɾɒːʔiːl
اسرائیلی	esɾɒːʔiːliː
اسفناج	esfenɒːd͡ʒ
اسفنج	esfænd͡ʒ
اسفند	esfænd
اسقف	osɢof
اسلام	eslɒːm
اسلامی	eslɒːmiː
اسلام‌آباد	eslɒːmɒːbɒːd
اسلام‌هراسی	eslɒːmhæɾɒːsiː
اسلام‌گرا	eslɒːmɡæɾɒː
اسلام‌گرایی	eslɒːmɡæɾɒːjiː
اسلاو	eslɒːv
اسلحه گرم	æslæheɡæɾm
اسلو	oslo
اسلوونی	esloveniː
اسلوونیائی	esluːveniːjɒːʔiː
اسلوونیایی	esluːveniːjɒːjiː
اسلیمی	esliːmiː
اسم	esm
اسم جمع	esmed͡ʒæmʔ
اسم فامیل	esmefɒːmiːl
اسمبلی	æsembeliː
اسمیت	iːsmiːt
اسمیم	osmiːjom
اسنوکر	esnuːkeɾ
اسهال	eshɒːl
اسهال زدن	eshɒːlzædæn
اسوار	æsvæɾ
اسير	æsiːɾ
اسپارت	espɒːɾt
اسپانیا	espɒːniːjæ
اسپانیایی	espɒːniːjɒːiː
اسپرانتو	espeɾɒːnto
اسپرز	espoɾz
اسپرماتوزئید	espeɾmɒːtozoʔiːd
اسپریس	æspɾiːs
اسپست	æspest,espest
اسپین	espiːn
اسکاتلند	eskɒːtlænd
اسکار	oskæɾ
اسکلت	eskelet
اسکناس	eskenɒːs
اسکندر	eskændæɾ
اسکندر مقدونی	eskændæɾmæɢeduːniː
اسکوپیا	iːskopiːjɒː
اسکوپیه	iːskopiːjæh
اسیر	æsiːɾ
اشاره	eʃɒːɾe
اشاره کردن	eʃɒːɾekæɾdæn
اشتباه	eʃtebɒːh
اشتباه شدن	eʃtebɒːhʃodæn
اشتباه کردن	eʃtebɒːhkæɾdæn
اشتراوس	eʃtɾɒːuːs
اشتیاق	eʃtiːjɒːɢ
اشغال	eʃɢɒːl
اشغال کردن	eʃɢɒːlkæɾdæn
اشک	æʃk
اشک ریختن	æʃkɾiːxtæn
اصابت	esɒːbæt
اصابت کردن	esɒːbætkæɾdæn
اصرار	esɾɒːɾ
اصرار کردن	esɾɒːɾkæɾdæn
اصفهان	esfæhɒːn
اصل	æsl
اصلاح	eslɒːh
اصلاح کردن	eslɒːhkæɾdæn
اصلی	æsliː
اصول اخلاق	osuːleæxlɒːɢ
اض پوشت ب ژلو گوضشتن	æzpoʃtbed͡ʒeloɡozæʃtæn
اضافه	ezɒːfe
اطاعت	etɒːʔæt
اطاعت کردن	etɒːʔætkæɾdæn
اطاق خواب	otɒːɢexɒːb
اطلاع	ettelɒːʔ
اطلاعات	ettelɒːʔɒːt
اطلس	ætlæs
اطمینان	etmiːnɒːn
اطمینان دادن	etmiːnɒːndɒːdæn
اطمینان داشتن	etmiːnɒːndɒːʃtæn
اطو	otuː
اظهار	ezhɒːɾ,æzhɒːɾ
اظهار کردن	ezhɒːɾkæɾdæn
اظهارنظر	ezhɒːɾenæzæɾ
اظهارنظر کردن	ezhɒːɾenæzæɾkæɾdæn
اعتبار	eʔtebɒːɾ
اعتراف	eʔteɾɒːf
اعتراف کردن	eʔteɾɒːfkæɾdæn
اعتصاب	eʔtesɒːb
اعتقاد	eʔteɢɒːd
اعتقاد داشتن	eʔteɢɒːddɒːʃtæn
اعتماد	eʔtemɒːd
اعتماد کردن	eʔtemɒːdkæɾdæn
اعتنا	eʔtenɒː
اعتنا کردن	eʔtenɒːkæɾdæn
اعدام	eʔdɒːm
اعدام کردن	eʔdɒːmkæɾdæn
اعضا	æzɒː
اعلام	eʔlɒːm
اعلام شدن	eʔlɒːmʃodæn
اعلام کردن	eʔlɒːmkæɾdæn
اعلامیه	eʔlɒːmiːje
اعلامیه زدن	eʔlɒːmiːjezædæn
اغاز کردن	æɢɒːzkæɾdæn
اغلب	æɢlæb
اغوز	uːɢuːz
افتادن	oftɒːdæn
افتخار	eftexɒːɾ
افتخار کردن	eftexɒːɾkæɾdæn
افترا	efteɾɒː
افترا خوردن	efteɾɒːxoɾdæn
افترا زدن	efteɾɒːzædæn
افروختن	æfɾuːxtæn
افزاره	æfzɒːɾe
افزایش	æfzɒːjeŝ,æfzɒːjeʃ
افزایش دادن	æfzɒːjeʃdɒːdæn
افزایش گرفتن	æfzɒːjeʃɡeɾeftæn
افزایه	æfzɒːje
افزودن	æfzuːdæn
افسس	æfss
افسوس	æfsuːs
افشردن	æfʃoɾdæn
افشنگ	æfʃænɡ
افشک	æfʃæk
افغان	æfɢɒːn
افغانستان	æfɢɒːnestɒːn
افغانی	æfɢɒːniː
افق	ofoɢ
افلاطون	æflɒːtuːn
افندی	efendiː
افیون	æfjuːn
اف‌بی‌آی	efbiːɒːj
اقتصاد	eɢtesɒːd
اقرار	eɢɾɒːɾ
اقرار کردن	eɢɾɒːɾkæɾdæn
اقریطس	eɢɾiːts
اقلا	æɢælæn
اقلیم	eɢliːm
اقلیم‌شناسی	eɢliːmʃenɒːsiː
اقیانوس	oɢjɒːnuːs
اقیانوس آرام	oɢjɒːnuːseɒːɾɒːm
اقیانوس اطلس	oɢjɒːnuːseætlæs
اقیانوس منجمد جنوبی	oɢjɒːnuːsemond͡ʒæmeded͡ʒænuːbiː
اقیانوس منجمد شمالی	oɢjɒːnuːsemond͡ʒæmedeʃemɒːliː
اقیانوس هند	oɢjɒːnuːsehend
اقیانوسیه	oɢjɒːnuːsiːje
الاغ	olɒːɢ
الان	ælɒːn
البته	ælbæte
البروس	elbɾuːs
التزام	eltezɒːm
التزام دادن	eltezɒːmdɒːdæn
التزامی	eltezɒːmiː
التماس	eltemɒːs
التماس کردن	eltemɒːskæɾdæn
الجزایر	æld͡ʒæzɒːjeɾ
الجزیره	æld͡ʒæzîɾe,æld͡ʒæziːɾe
الحمد لله	ælhæmdoleʔllɒːh
الف	ælef
الفبا	ælefbɒː
الفبای سیریلیک	ælefbɒːjesiːɾiːliːk
القاعده	ælɢɒːde
الله	ællɒːh
الله آباد	ællɒːhɒːbɒːd
الله اکبر	ællɒːhoækbæɾ
الماس	ælmɒːs
المپ	olæmp
المپیک	olæmpiːk
الهام	elhɒːm
الهام شدن	elhɒːmʃodæn
الهیات	elæhiːjɒːt
الو	ælo
الکترومغناطیس	elektɾomæɢnɒːtiːs
الکترون	elektɾon
الکترونی	elekteɾoniː
الکترونیک	elekteɾoniːk
الکل	ælkol
الکلی	ælkoliː
الگو	olɡuː
الگو زدن	olɡuːzædæn
الگو کشیدن	olɡuːkeʃiːdæn
الگوریتم	ælɡoɾiːtm
الیستا	eliːstɒː
ام	em,æm
اما	ɒːmmæ,æmmɒː
امارات عربی متحده	emɒːɾɒːtæɾæbiːmotæhiːde
امام	emɒːm
امان	æmɒːn
امان آمدن	æmɒːnɒːmædæn
امان آوردن	æmɒːnɒːvæɾdæn
امان دادن	æmɒːndɒːdæn
امانت	æmɒːnæt
امانت دادن	æmɒːnætdɒːdæn
امانت گرفتن	æmɒːnætɡeɾeftæn
اماکن	æmɒːken
امت	ommæt
امتحان	emtehɒːn
امتحان دادن	emtehɒːndɒːdæn
امر	æmɾ
امرود	æmɾuːd
امروز	emɾuːz
امروز صبح	emɾuːzsobh
امروز غروب	emɾuːzɢoɾuːb
امروزه	emɾuːze
امری	æmɾiː
امسال	emsɒːl
امشب	emʃæb
امضا	emzɒː
امنیت	æmniːjæt
امپراتوری روم	empeɾɒːtuːɾiːjeɾuːm
امپراتوری عثمانی	empeɾɒːtuːɾiːʔosmɒːniː
امپراطوری	empɾɒːtuːɾiː
امپریالیسم	æmpeɾiːjɒːliːsm
امکان	emkɒːn
امگا	omeɡɒː
امیب	æmiːb
امید	omiːd
امیدوار بودن	omiːdvɒːɾbuːdæn
امیر	æmiːɾ
ان	æn
انار	ænɒːɾ
انبار	ænbɒːɾ
انبار شدن	ænbɒːɾʃodæn
انبار مهمات	ænbɒːɾemohemmɒːt
انبار کردن	ænbɒːɾkæɾdæn
انباره	ænbæɾe
انباز	ænbɒːz
انباز شدن	ænbɒːzʃodæn
انباشتن	ænbɒːʃtæn
انبه	ænbe
انتخابات	entexɒːbɒːt
انترناسیونال	enteɾnɒːsjuːnɒːl
انتظار داشتن	entezɒːɾdɒːʃtæn,entezæɾdæʃtæn
انتقاد	enteɢɒːd
انتقاد شدن	enteɢɒːdʃodæn
انتقاد کردن	enteɢɒːdkæɾdæn
انتقام	enteɢɒːm
انتقام گرفتن	enteɢɒːmɡeɾeftæn
انتها	entehæ
انتگرال	ænteɡɾɒːl
انتگرال گرفتن	ænteɡɾɒːlɡeɾeftæn
انتیموان	æntiːmoɒːn
انجام	ænd͡ʒɒːm
انجام دادن	ænd͡ʒɒːmdɒːdæn
انجام رساندن	ænd͡ʒɒːmɾesɒːndæn
انجام گرفتن	ænd͡ʒɒːmɡeɾeftæn
انجمن	ænd͡ʒomæn
انجيلي	end͡ʒiːliː
انجیر	ænd͡ʒiːɾ
انجیل	end͡ʒiːl
انداختن	ændɒːxtæn
اندازه	ændɒːze
اندازه زدن	ændɒːzezædæn
اندازه شدن	ændɒːzeʃodæn
اندازه کردن	ændɒːzekæɾdæn
اندازه گرفتن	ændɒːzeɡeɾeftæn
اندازه‌گیر	ændɒːzeɡiːɾ
اندازه‌گیری	ændɒːzeɡiːɾiː
اندام	hændɒːm,ændɒːm
اندر	ændæɾ
اندرز	ændæɾz
اندرز دادن	ændæɾzdɒːdæn
اندروا	ændæɾvɒː
اندرون	ændæɾuːn
اندریاس	ændɾiːjɒːs
اندلس	ændælos
اندونزی	iːndoneziː
اندونزیایی	enduːneziːjɒːjiː,ændonesiːjejiː
اندیشه	ændiːʃe,ændiːŝæ,ændiːŝe
اندیشیدن	ændiːʃiːdæn
انرژی	eneɾʒiː
انرژی هسته‌ای	eneɾʒiːjehæsteʔiː
انزال	enzɒːl
انس	ons
انس گرفتن	onsɡeɾeftæn
انسان	ensɒːn
انسان جایزالخطاست	ensænd͡ʒɒːjezolxætæst
انسولین	ensuːliːn
انفورماتیک	ænfoɾmɒːtiːk
انقلاب	enɢelɒːb
انگ	ænɡ
انگ زدن	ænɡzædæn
انگاشت	enɡɒːŝt
انگبین	ænɡæbiːn,ænɡobiːn
انگشت	ænɡoʃt
انگشت زدن	ænɡoʃtzædæn
انگشت پا	ænɡoʃtepɒː
انگلستان	enɡelestæn
انگلیسی	enɡeliːsiː
انگلیسی آمریکایی	enɡeliːsiːjeɒːmɾiːkɒːjiː
انگلیسی قدیم	enɡeliːsiːɢædiːm
انگور	ænɡuːɾ
انگوین	ænɡoviːn
انگيختار	ænɡiːxtɒːɾ
انگیختن	ænɡiːxtæn
انیمی	æniːme
انیمیشن ژاپنی	æniːmeʒɒːponiː
ان‌شاءالله	enʃɒːʔællɒːh
اهریمن	æhɾiːmæn
اهمیت	æhæmmiːjæt
اهمیت دادن	æhæmmiːjætdɒːdæn
او	æw,oʊ,uː
او را	uːɾɒː
اوآگادوگو	oɒːɡɒːduːɡuː
اوباما	obɒːmɒː
اوت	uːt
اوج	oʊd͡ʒ
اوج لذت جنسی	od͡ʒlezætd͡ʒensiː
اوج گرفتن	oʊd͡ʒɡeɾeftæn
اوراسیا	oɾɒːsiːjɒː
اورانیوم	uːɾɒːnjuːm
اوردن	ovoɾdæn
اورشلیم	oɾʃæliːm
اورشلیم مقدس	oɾʃæliːmemoɢæddæs
اوروپول	oɾuːpuːl
اورپا	oɾuːpɒː
اوزبکستان	uːzbækestɒːn
اوستا	ævestɒː
اوستیا	osetiːjɒː
اوستیای جنوبی	osetiːjɒːjed͡ʒænuːbiː
اوستیایی	osetiːjɒːjiː
اول	ævvæl
اولان‌باتور	uːlɒːnbɒːtuːɾ
اولین	ævvæliːn
اولین عشق	ævvæliːneʔeʃɢ
اوکرائین	uːkɾɒːʔiːn
اوکراین	uːkɾɒːjn
اوکراینی	uːkɾɒːiːniː
اوگاندا	uːɡɒːndɒː
اينقدر	iːnɢædɾ
اپاختر	æpɒːxtæɾ
اپسیلون	epsiːlon
اپل	epl
اپی فیلوم	epiːfiːluːm
اچ‌تی‌ام‌ال	et͡ʃtiːemel
اژدر	æʒdæɾ
اژدها	eʒdehæ
اژدهابلم	eʒdehæbælæm
اژدهای بالدار	eʒdehæjebældæɾ
اکتبر	oktobɾ
اکتفا	ektefɒː
اکتفا کردن	ektefɒːkæɾdæn
اکتینیم	æktiːniːjom
اکتیو	æktiːv
اکسید	oksiːd
اکسیر	eksiːɾ
اکسیژن	oksiːʒen
اکنون	æknuːn
اکوادور	ekvɒːdoɾ
اکوسیستم	ekuːsiːstem
اگر	æɡæɾ
اگر و فقط اگر	æɡæɾvæfæɢætæɡæɾ
اگرچه	æɡæɾt͡ʃe
اگزیستانسیالیسم	eɡziːstɒːnsiːɒːliːsm
ایالات متحده	ejɒːlɒːtemottæhede
ایالات متحدۀ آمریکا	ejɒːlɒːtemottæhedejeɒːmɾiːkɒː
ایتالیا	iːtɒːliːjɒː
ایتالیایی	iːtæliːjɒːjiː
ایجاد	iːd͡ʒɒːd
ایجاد شدن	iːd͡ʒɒːdʃodæn
ایجاد کردن	iːd͡ʒɒːdkæɾdæn
ایدز	ejdz
ایده	iːde
ایراد	iːɾɒːd
ایراد گرفتن	iːɾɒːdɡeɾeftæn
ایران	iːɾɒːn
ایرانی	iːɾɒːniː
ایرلند	ʔiːɾlænd
ایرلندی	iːɾlændiː
ایروان	eɾævɒːn
ایرکوتسک	iːɾkuːtsk
ایزد	iːzæd
ایست	est
ایستادن	iːstɒːdæn
ایستر	iːstæɾ
ایستگاه	iːstɡɒːh
ایستگاه اتوبوس	iːstɡɒːheotobuːs
ایسلند	ʔiːslænd
ایسلندی	ʔiːslændiː
ایسیک کول	iːstiːkkuːl
ایشان	iːʃɒːn
ایمان	iːmɒːn
ایمان آوردن	iːmɒːnɒːvæɾdæn
ایمیل	iːmejl
ایمیل زدن	iːmejlzædæn
ایمیل کردن	iːmejlkæɾdæn
این	iːn
این به اون در	iːnbeondæɾ
این ماه	iːnmɒːh
این هفته	iːnhæfte
اینترلینگو	iːnteɾliːnɡuːæ
اینترنت	iːnteɾnet
اینجا	iːnd͡ʒɒː
ایوان	ejvɒːn,iːvɒːn
ایژوسک	iːʒevsk
ایگوانا	iːɡvɒːnɒː
با	bɒː
با احترام	bɒːehteɾɒːm
با این حال	bæiːnhɒː
با هم	bɒːhæm
با یک تیر دو نشان زدن	bɒːjektiːɾdoneʃɒːnzædæn
بابا	bɒːbɒː
بابا نوئل	bɒːbɒːnoʔel
بابا یاگا	bɒːbɒːjɒːɡɒː
باباآدم	bɒːbɒːdæm
بابل	bɒːbel
بات	bɒːt
باتری	bɒːtɾiː
باتنگان	bɒːtenɡɒːn
باج	bɒːd͡ʒ
باج گرفتن	bɒːd͡ʒɡeɾeftæn
باجناق	bɒːd͡ʒenɒːɢ
باخ	bɒːx
باختر	bɒːxtæɾ
باختریان	bɒːxtæɾiːjɒːn
باختن	bɒːxtæn
باد	bɒːd
باد خورشیدی	bɒːdexoɾʃiːdiː
باد دادن	bɒːddɒːdæn
باد زدن	bɒːdzædæn
باد ستاره‌ای	bɒːdesetɒːɾeʔiː
باد کردن	bɒːdkæɾdæn
بادام	bɒːdɒːm
بادام زمینی	bɒːdɒːmezæmiːniː,bɒːdɒːmzæmiːniː
بادام هندی	bɒːdɒːmehendiː
بادام کوهی	bɒːdɒːmkuːhiː
بادبادک	bɒːdbɒːdæk
بادبان	bɒːdbɒːn
بادبزن	bɒːdbezæn
بادنجان	bɒːdend͡ʒɒːn
بادنگان	bɒːdenɡɒːn
باده	bɒːdæ
بار	bɒːɾ
بار آوردن	bɒːɾɒːvæɾdæn
بار زدن	bɒːɾzædæn
بار کردن	bɒːɾkæɾdæn
باران	bɒːɾɒːn
باران آمدن	bɒːɾɒːnɒːmædæn
باران گرفتن	bɒːɾɒːnɡeɾeftæn
باراک	bɒːɾɒːk
باردار	bɒːɾdæɾ
بارداری	bɒːɾdɒːɾiː
بارو	bɒːɾuː
باروت	bɒːɾuːt
بارود	bɒːɾuːd
بارون	bɒːɾuːn
بارکد	bɒːɾkod
بارگذاری	bɒːɾɡozɒːɾiː
بارگیری	bɒːɾɡiːɾiː
باریدن	bɒːɾiːdæn
باریم	bɒːɾiːjom
باز	bɒːz
باز خواندن	bɒːzxɒːndæn
باز کردن	bɒːzkæɾdæn
بازار	bɒːzɒːɾ
بازاریابی	bɒːzɒːɾjɒːbiː
بازالت	bɒːzɒːlt
بازتاب	bɒːztɒːb
بازتاب دادن	bɒːztɒːbdɒːdæn
بازداشتن	bɒːzdɒːʃtæn
بازدم	bɒːzdæm
بازسازی	bɒːzsɒːziː
بازماندن	bɒːzmɒːndæn
بازنامیدن	bɒːznɒːmiːdæn
بازنده	bɒːzænde
بازو	bɒːzuː
بازوبند	bɒːzuːbænd
بازگشت	bɒːzɡæʃt
بازگشتن	bɒːzɡæʃtæn
بازگو	bɒːzɡuː
بازگو کردن	bɒːzɡuːkæɾdæn
بازگیری	bɒːzɡiːɾiː
بازی	bɒːziː
بازی کردن	bɒːziːkæɾdæn,bɒːziːkæɾdæn
بازی گرفتن	bɒːziːɡeɾeftæn
بازیافت	bɒːzjɒːft
بازیهای رایانه	bɒːziːhɒːjeɾɒːjɒːne
بازیچه	bɒːziːt͡ʃe
بازیکن	bɒːziːkon
بازیگر	bɒːziːɡæɾ
بازی‌های المپیک	bɒːziːhɒːjeolæmpiːk
باستان‌شناسی	bɒːstɒːnʃenɒːsiː
باسلق	bɒːsloɢ
باسک	bɒːsk
باسکی	bɒːskiː
باش	bɒːʃ
باشه	bɒːʃe
باعث	bɒːʔes
باعث شدن	bɒːʔesʃodæn
باغ	bɒːğ,bɒːɢ
باغ وحش	bɒːɢevæhʃ
باغبانی کردن	bɒːɢbɒːniːkæɾdæn
باغلاما	bɒːɢlɒːmɒː
باغچه	bɒːɢt͡ʃe
باغی	bɒːɢiː
بافت	bɒːft
بافتن	bɒːftæn
بافر	bɒːfeɾ
باقالا	bɒːɢɒːlɒː
باقلوا	bɒːɢlævɒː
بال	bɒːl
بال بال	bɒːlbɒːl
بال بال زدن	bɒːlbɒːlzædæn
بال زدن	bɒːlzædæn
بال گرفتن	bɒːlɡeɾeftæn
بالا	bɒːlɒː
بالا زدن	bɒːlɒːzædæn
بالا کشیدن	bɒːlɒːkeʃiːdæn
بالاتر	bɒːlɒːtæɾ
بالش	bɒːleʃ
بالعکس	bɒːlʔæks
باله	bɒːle
بالون	bɒːluːn
بالکن	bɒːlkon
بالگرد	bɒːlɡæɾd
بام	bɒːm
بامبول	bɒːmbuːl
بامبول زدن	bɒːmbuːlzædæn
بامداد	bɒːmdɒːd
بان	bɒːn
بانو	bɒːnuː
بانوج	bɒːnuːd͡ʒ
بانک	bɒːnk
بانک اطلاعات	bɒːnkettelɒːʔɒːt
بانکوک	bɒːnkok
بانگ	bɒːnɡ
بانگ زدن	bɒːnɡzædæn
بانگ کشیدن	bɒːnɡkeʃiːdæn
باهاما	bɒːhɒːmɒː
باهوش	bɒːhuːʃ
باور	bɒːvæɾ
باور دادن	bɒːvæɾdɒːdæn
باور شدن	bævɒːɾʃodæn
باور کردن	bɒːvæɾkæɾdæn,bɒːvæɾkæɾdæn
باکتریا	bɒːktæɾiːjɒː
باکره	bɒːkeɾe
باکرگی	bɒːkeɾeɡiː
باگ	bɒːɡ
باید	bɒːjæd
باینجا	bæʔiːnd͡ʒɒː
ببخشید	bebæxʃiːd
ببر	bæbɾ
بت	bot
بتا	betɒː
بتن	beton
بت‌کده	botkæde
بجز	bed͡ʒoz
بجنب	bed͡ʒonb
بحث	bæhs,bæhæs
بحث کردن	bæhskæɾdæn
بحر	bæhɾ
بخار	boxɒːɾ
بخار شدن	boxɒːɾʃodæn
بخارا	boxɒːɾɒː
بخاری	boxɒːɾiː
بخش	bæxʃ
بخشنده	bæxʃænde,bæxŝænde,bæxŝændæ
بخشیدن	bæxʃiːdæn
بخشیش	bæxʃiːʃ
بخواه	bexɒːh
بخواهد	bexɒːhæd
بخواهم	bexɒːhæm
بخواهند	bexɒːhænd
بخواهی	bexɒːhiː
بخواهید	bexɒːhiːd
بخواهیم	bexɒːhiːm
بخیه	bæxiːje
بخیه خوردن	bæxiːjexoɾdæn
بخیه زدن	bæxiːjezædæn
بخیه کردن	bæxiːjekæɾdæn
بد	bæd
بد انجامیدن	bædænd͡ʒɒːmiːdæn
بد ترکیب	bædtæɾkiːb
بدبختانه	bædbæxtɒːne
بدبختی	bædbæxtiː
بدبختی کشیدن	bædbæxtiːkeʃiːdæn
بدبده	bædbæde
بدبو	bædbuː
بدتر	bædtæɾ
بدرقه	bædɾæɢe
بدرقه کردن	bædɾæɢekæɾdæn
بدرود	bedɾuːd
بدست آوردن	bedæstɒːvoɾdæn
بدعت	bedʔæt
بدل	bædæl
بدل شدن	bædælʃodæn
بدل کردن	bædælkæɾdæn
بدلیل	dæliːl
بدلیل آن	bedæliːleɒːn
بدن	bædæn
بدهی	bedehiː
بدو بدو	bodobodo
بدو بدو زدن	bodobodozædæn
بدون	beduːne
بدی	bædiː
بر	boɾ,beɾ,bæɾ
بر آن بودن	bæɾɒːnbuːdæn
بر خوردن	boɾxoɾdæn
بر داشتن	bæɾdɒːʃtæn
بر زدن	beɾzædæn,boɾzædæn
بر گشتن	bæɾɡæʃtæn
برآمده	bæɾɒːmæde
برابر	bæɾɒːbæɾ
برابری	bæɾɒːbæɾiː
براتیسلاوا	bɾɒːtiːslɒːvɒː
برادر	bæɾɒːdæɾ
برادرخوانده	bæɾɒːdæɾxwɒːnde
برادرزاده	bæɾɒːdæɾzɒːde
برادرزن	bæɾɒːdæɾzæn
برادرشوهر	bæɾɒːdæɾʃoʊhæɾ
برادری	bæɾɒːdæɾiː
براروسی	bæɾɒːɾuːsiː
براز	boɾɒːz
برازندگی	bæɾɒːzændæɡiː
برانداز	bæɾændɒːz
برانداز کردن	bæɾændɒːzkæɾdæn
برانکارد	bɾɒːnkɒːɾd
برانگیختن	bæɾɒːnɡiːxtæn
برانگیزنده	bæɾɒːnɡiːzænde,bæɾɒːnɡiːzændæ
برای	bæɾɒːje
برای اینکه	bæɾɒːjeiːnke
برای من	bɾɒːjemæn
برای همیشه	bæɾɒːjehæmiːʃe
بربخ	bæɾbæx
بربط	bæɾbæt
برتونی	beɾetuːniː,beɾetoniː
برج	boɾd͡ʒ
برج حوت	boɾd͡ʒehot
برج لندن	boɾd͡ʒelændæn
برجستگی	bæɾd͡ʒæsteɡiː
برخاستن	bæɾxɒːstæn
برخواندن	bæɾxɒːndæn
برخورد	bæɾxoɾd
برخیزیدن	bæɾxiːziːdæn
برداشت	bæɾdɒːʃt
برداشتن	bæɾdɒːʃtæn
بردن	boɾdæn
برده	bæɾdæ
بررسی	bæɾɾesiː
برز	boɾz
برزیل	beɾziːl,beɾeziːl
برس	boɾos
برس کشیدن	boɾoskeʃiːdæn
برش	boɾʃ,boɾeʃ
برش خوردن	boɾeʃxoɾdæn
برش زدن	boɾeʃzædæn
برشتن	beɾeʃtæn
برعکس	bæɾʔæks
برف	bæɾf
برف آمدن	bæɾfɒːmædæn
برف دانه	bæɾfedɒːne
برف گرفتن	bæɾfɡeɾeftæn
برفک	bæɾfæk
برفی	bæɾfiː
برق	bæɾɢ
برق انداختن	bæɾɢændɒːxtæn
برق زدن	bæɾɢzædæn
برق گرفتن	bæɾɢɡeɾeftæn
برقع	boɾɢæʔ
برقي	bæɾɢiː
برلوسکونی	beɾluːskuːniː
برلین	beɾliːn
برم	boɾom
برمه	beɾme
برمه‌ای	beɾmeʔɒːjiː
برن	beɾn
برنا	boɾnɒː
برنامه	bæɾnɒːme
برنامه‌نویسی	bæɾnɒːmeneviːsiː
برنامک	bæɾnɒːmæk
برنج	beɾend͡ʒ
برنجاسف	beɾend͡ʒɒːsef
برنجی	beɾend͡ʒiː
برنده	bæɾænde
برنز	bɾonz
برنزه	bɾonze
بره	bæɾɾe,bæɾe
برهمن	bɾæhmæn
برهنه	beɾæhne
برهنگی	beɾæhneɡiː
برو	boɾuː,bæɾuː
بروت	boɾuːt
بروز	boɾuːz
بروز دادن	boɾuːzdɒːdæn
برون	beɾuːn
برونئی	boɾuːnej
بروکسل	bɾuːksel
برّه	bæɾɾe
برچسب	bæɾt͡ʃæsb
برچسب زدن	bæɾt͡ʃæsbzædæn,bæɾt͡ʃæsbzædæn
برکلیم	beɾkeliːom
برگ	bæɾɡ
برگ زدن	bæɾɡzædæn
برگزیده	bæɾɡoziːde
برگزیده شده	bæɾɡoziːdeʃode
برگشت	bæɾɡæʃt
برگشت خوردن	bæɾɡæʃtxoɾdæn
برگشت زدن	bæɾɡæʃtzædæn
برگشتن	bæɾɡæʃtæn
برگشتی	bæɾɡæʃtiː
برگه	bæɾɡæ
برگه نخست	bæɾɡejenoxost
بری	bɾiː
بریتانی	beɾiːtɒːniː
بریتانیا	beɾiːtɒːniːjɒː
بریتانیای کبیر	beɾiːtɒːniːjɒːjekæbiːɾ
بریدن	boɾiːdæn
بریلیوم	beɾiːliːjom
بز	boz
بزباش	bozbɒːʃ
بزدل	bozdel
بزرگ	bozoɾɡ
بزرگتر	bozoɾɡtæɾ
بزرگسال	bozoɾɡsɒːl
بزن به تخته	bezænbetæxtæ
بزه	beze
بزودی	bezuːdiː
بزک	bæzæk
بزک کردن	bæzækkæɾdæn
بست	bæst
بست زدن	bæstzædæn
بستر	bestæɾ
بستن	bæstæn
بستنی	bæstæniː
بسته	bæste
بسته بندی	bestebændiː
بسته بندی کردن	bestebændiːkæɾdæn
بسته‌بندی کردن	bæstebændiːkæɾdæn
بسط	bæst
بسط دادن	bæstdɒːdæn
بسط یافتن	bæstjɒːftæn
بسنده	bæssænde
بسنده کردن	bæsændekæɾdæn
بسپار	bæspɒːɾ
بسکتبال	bæsketbɒːl
بسکتبالیست	bæsketbɒːliːst
بسیار	besiːjɒːɾ
بشارت	beʃɒːɾæt
بشارت دادن	beʃɒːɾætdɒːdæn
بشقاب	boʃɢɒːb
بشکن	beʃkæn
بشکن زدن	beʃkænzædæn
بشیر	bæʃiːɾ
بعد	bæʔd,bæʔde
بعد از	bæʔdæz
بعد از ظهر	bæʔdæzzohɾ
بعدا	bæʔdæn
بعدتر	bæʔdtæɾ
بعضی وقتها	bæziːvæɢthɒː
بغ	bæɢ
بغداد	bæɢdɒːd
بغض	boɢz
بغض کردن	boɢzkæɾdæn
بغض گرفتن	boɢzɡeɾeftæn
بغل	bæɢæl
بغل زدن	bæɢælzædæn
بغل کردن	bæɢælkæɾdæn
بغل گرفتن	bæɢælɡeɾeftæn
بقال	bæɢɢɒːl
بقالی	bæɢɒːliː
بلا	bælɒː
بلاروس	belɒːɾuːs
بلال	bælɒːl
بلاگ	blɒːɡ
بلبل	bolbol
بلخ	bælx
بلد	bælæd
بلد بودن	bælædbuːdæn
بلدرچین	beldeɾt͡ʃiːn
بلروسى	belæɾuːsiː
بلشویک	bolʃeviːk
بلعیدن	bæliːdæn,bælʔiːdæn
بلغار	bolɢɒːɾ
بلغارستان	bolɢɒːɾestɒːn
بلغاری	bolɢɒːɾiː
بلغراد	belɢeɾɒːd
بلغم	bælɢæm
بلن کردن	bolænkæɾdæn
بلند	bolænd
بلند کردن	bolændkæɾdæn
بلندگو	bolændɡouː
بله	bæle
بلودى مارى	bluːdiːmɒːɾiː
بلور	bellôɾ
بلوز	boluːz,bluːz
بلوط	boluːt,bæluːt
بلوف	bolof
بلوف خوردن	bolofxoɾdæn
بلوف زدن	bolofzædæn
بلوچی	bæluːt͡ʃiː
بلژیک	belʒiːk
بلک‌بری	blækbeɾiː
بلگراد	belɡeɾɒːd
بلیت	beliːt
بلیط	beliːt
بمب	bomb
بمب خوردن	bombxoɾdæn
بمب زدن	bombzædæn
بمب ساعتی	bombesɒːʔætiː
بمبئی	bombæʔiː
بن	bon
بنانج	bænɒːnd͡ʒ
بنتلی	bentliː
بند	bănd,bænd
بند آمدن	bændɒːmædæn
بند آوردن	bændɒːvæɾdæn
بند زدن	bændzædæn
بندباز	bændbɒːz
بندر	bændæɾ
بندر سری بگاوان	bændæɾseɾiːbeɡɒːvɒːn
بندرگاه	bændæɾɡɒːh
بنده	bændæ
بندپایان	bændpɒːjɒːn
بندی	bændiː
بنزن	bænzæn
بنزین	benziːn
بنزین زدن	benziːnzædæn
بنفش	bænæfʃ
بنفش روشن	bænæfʃeɾoʃæn
بنفشه	bænæfʃe
بنيانگذاري	bonjɒːnɡozɒːɾiː
بنگ	bænɡ
بنگاه تجاری	bonɡɒːheted͡ʒɒːɾiː
بنگلادش	bænɡlɒːdeʃ
بنیاد	bonjɒːd
بنیانگذار	bonjɒːnɡozɒːɾ
به	bæh,bæ,be,beh
به امید دیدار	beomiːdediːdɒːɾ
به این زودی	beiːnzuːdiː
به حال خود رها کردن	behɒːlxuːdɾæhɒːkæɾdæn
به خاطر	bexɒːteɾe
به دنیا آمدن	bedonjɒːɒːmædæn
به دنیا آوردن	bedonjɒːɒːvæɾdæn
به سلامت	besælɒːmæt
به سمت	hesemet
به صحنه آوردن	besæhneævæɾdæn
به قلاب انداختن	beɢollɒːbændɒːxtæn
به قلاب وصل كردن	beɢollɒːbvæslkæɾdæn
به ندرت	benodtɾæt
به هنگام	behænɡɒːme
به یاد آوردن	bejɒːdɒːvæɾdæn
به یاد داشتن	bejɒːddɒːʃtæn
بها	bæhɒː
بها دادن	bæhɒːdɒːdæn
بهار	bæhɒːɾ
بهار عربی	bæhɒːɾeʔæɾæbiː
بهانه	bæhɒːne
بهانه آوردن	bæhɒːneɒːvæɾdæn
بهانه کردن	bæhɒːnekæɾdæn
بهانه گرفتن	bæhɒːneɡeɾeftæn
بهبود	behbuːd
بهبود دادن	behbuːddɒːdæn
بهت	boht
بهت زدن	bohtzædæn
بهتان	bohtɒːn
بهتان خوردن	bohtɒːnxoɾdæn
بهتان زدن	bohtɒːnzædæn
بهتر	behtæɾ
بهترین	behtæɾiːn
بهرام	bæhɾɒːm
بهره	bæhɾe,bæhɾæ
بهره بردن	bæhɾeboɾdæn
بهره گرفتن	bæhɾeɡeɾeftæn
بهره‌برداری	bæhɾebæɾdɒːɾiː
بهره‌برداری کردن	bæhɾebæɾdɒːɾiːkæɾdæn
بهشت	‎beheʃt,beheʃt
بهمن	bæhmæn
بهی	behiː
بهینه	bæhiːnæ,behiːne
بو	buː
بو دادن	buːdɒːdæn
بو داشتن	büdɒːʃtæn
بو کردن	buːkæɾdæn,buːkæɾdæn
بو کشیدن	buːkeʃiːdæn
بو گرفتن	buːɡeɾeftæn
بوئنوس آیرس	buːʔenuːsɒːjɾes
بوئین	bhouːʔiːn
بوئینگ	boʔiːnɡ
بوتان	buːtɒːn
بوته	buːte
بود	buːd
بودا	buːdɒː
بوداپست	buːdɒːpest
بودن	buːdæn
بور	boɾ,buːɾ
بورد	buːɾd
بورس	buːɾs
بوره	buːɾe
بوریم	boɾiːom
بوزینه	buːziːne
بوس کردن	buːskæɾdæn
بوستان	buːstɒːn
بوسنی و هرزگوین	bosniːvæheɾzeɡoviːn,bosniːoheɾzeɡoviːn
بوسنیائی	bosniːjɒːʔiː
بوسه	buːse
بوسه زدن	buːsezædæn
بوسیدن	buːsiːdæn
بوش	buːʃ
بوف	buːf
بوفالو	buːfɒːlo
بوق	buːɢ
بوق زدن	buːɢzædæn
بوقلمون	buːɢælæmuːn
بولیوی	boliːviː
بومی	buːmiː
بوم‌شناسی	buːmʃenɒːsiː
بووم	buːm
بوگوتا	boɡotɒː
بوی	büj
بوییدن	büjiːdæn
بي ابهام	biːebhɒːm
بي صدا	biːsedɒː
بيست	biːst
بيگـاری	biːɡɒːɾiː
بيگـاری گرفتن	biːɡɒːɾiːɡeɾeftæn
بچ	bæt͡ʃ
بچه	bæt͡ʃt͡ʃe
بچه قورباغه	bæt͡ʃt͡ʃejeɢuːɾbɒːɢe
بچه گرگ	bæt͡ʃeɡoɾɡ
بچگی	bæt͡ʃeɡiː
بژ	beʒ
بژم	bæʒm
بکار بردن	bekɒːɾboɾdæn
بکارت	bækɒːɾæt
بکن	bokon
بگذریم	beɡzæɾiːm
بی	biː
بی خوابی	biːxɒːbiː
بی خوابی کشیدن	biːxɒːbiːkeʃiːdæn
بی قرار	biːɢæɾɒːɾ
بی قراری	biːɢæɾɒːɾiː
بی کار	biːkɒːɾ
بیا بریم	biːjɒːbeɾiːm
بیابان	biːjɒːbɒːn
بیان	bæjɒːn,bejɒːn
بیان شدن	bæjɒːnʃodæn
بیتلز	biːtlz
بیتولا	biːtolɒː
بیت‌المقدس	bejtolmoɢæddæs
بید	biːd
بید مجنون	biːdmæd͡ʒnuːn
بیدار شدن	biːdɒːɾʃodæn
بیدار کردن	biːdɒːɾkæɾdæn
بیراهه	biːɾɒːhe
بیراهه زدن	biːɾɒːhezædæn
بیروت	bejɾuːt
بیرون	biːɾuːn
بیرون زدن	biːɾuːnzædæn
بیرون کردن	biːɾuːnkæɾdæn
بیرونی	biːɾuːniː
بیزار بودن	biːzɒːɾbuːdæn
بیزار کردن	biːzɒːɾkæɾdæn
بیزاری	biːzɒːɾiː
بیزانس	biːzɒːns
بیست	biːst
بیست و پنج سنتی	biːstopænd͡ʒsentiː
بیسموت	biːsmuːt
بیشتر	biːʃtæɾ
بیشه	biːʃe
بیشکک	biːʃkek
بیطار	bejtɒːɾ
بیل	biːl
بیل زدن	biːlzædæn
بیلیارد	biːljɒːɾd
بیلیون	biːljuːn
بیم	biːm
بیمار	biːmɒːɾ
بیمار شدن	biːmɒːɾʃodæn
بیمارستان	biːmɒːɾestɒːn
بیماری	biːmɒːɾiː
بیماری آلزایمر	biːmɒːɾeɒːlzɒːjmeɾ
بیماری زدن	bebiːmɒːɾiːzædæn
بیماری قند	biːmɒːɾiːjeɢænd
بیمناک	biːmnɒːk
بین	biːn,bejn
بینایی	biːnɒːjiː
بینش	biːneʃ
بینوایی	biːnævɒːjiː
بینی	biːniː
بین‌المللی	bejnolmelæliː
بیهوشی	biːhuːʃiː
بیهوشی زدن	biːhuːʃiːzædæn
بیوشیمی	biːoʃiːmiː
بیولوژی	biːoloʒiː
بیپ	biːp
بیکاری	biːkɒːɾiː
بیکاری کشیدن	biːkɒːɾiːkeʃiːdæn
بیگ بن	biːɡben
بیگانه	biːɡɒːnæ,biːɡɒːne
بیگانه‌هراسی	biːɡɒːnehæɾɒːsiː
بی‌تفاوتی	biːtæfɒːvotiː
بی‌تفاوتی زدن	biːtæfɒːvotiːzædæn
بی‌جنس‌گرایی	biːd͡ʒensɡæɾɒːjiː
بی‌خانمان	biːxɒːnemɒːn
بی‌خوابی	biːxɒːbiː
بی‌خیالی	biːxiːjɒːliː
بی‌خیالی زدن	biːxiːjɒːliːzædæn
بی‌رنگ	biːɾænɡ
بی‌ستاره	biːsetɒːɾe
بی‌سیم	biːsiːm
بی‌سیم زدن	biːsiːmzædæn
بی‌شمار	biːʃomɒːɾ
بی‌معنی	biːmæʔniː
بی‌مغز	biːmæɢz
بی‌مهره	biːmohɾe
بی‌کاری	biːkɒːɾiː
تئاتر	teʔɒːtɾ
تئوری توطئه	teʔoɾiːjetouːteʔe
تا	tɒː
تا اين اندازه	tɒːiːnændɒːzæ,tɒːiːnændɒːze
تا شدن	tɒːʃodæn
تا کردن	tɒːkæɾdæn,tɒːkæɾdæn
تاب	tɒːb
تابستان	tɒːbestɒːn
تابع	tɒːbeʔ
تابع گاما	tɒːbeeɡæmmæ
تابلوی اعلانات	tɒːblojeeʔlɒːnɒːt
تابناک	tɒːbnɒːk
تابه	tɒːbe
تابوت	tɒːbuːt
تاتار	tɒːtɒːɾ
تاتارستان	tætæɾstɒːn
تاج	tɒːd͡ʒ
تاجیک	tɒːd͡ʒiːk
تاجیکستان	tɒːd͡ʒiːkestɒːn
تاجیکی	tɒːd͡ʒiːkiː
تاج‌محل	tɒːd͡ʒmæhæl
تاراج	tɒːɾɒːd͡ʒ
تاراج کردن	tɒːɾɒːd͡ʒkæɾdæn
تارتنک	tɒːɾtænæk
تارنما	tɒːɾnæmɒː
تاریخ	tɒːɾîx,tɒːɾiːx
تاریک	tɒːɾiːk
تاریکی	tɒːɾiːkiː
تازه	tɒːze
تازه‌ها	tɒːzehɒː
تازی	tɒːziː
تازیانه	tɒːziːɒːne,tɒːziːjɒːne
تازیانه زدن	tɒːziːɒːnezædæn
تازیانه‌ها	tɒːziːjɒːnehɒː
تاسمانی	tɒːsmɒːniː
تاسیس	tæʔsiːs
تاسیس کردن	tæʔsiːskæɾdæn
تاشکند	tɒːʃkænd
تامبوف	tɒːmbuːf
تاميل	tɒːmiːl
تاندون	tɒːndon
تانزانیا	tɒːnzɒːniːjɒː
تانک	tɒːnk
تاول	tɒːvæl
تاول زدن	tɒːvælzædæn
تاکتیک	tɒːktiːk
تاکسی	tɒːksiː
تاکید	tæʔkiːd
تاکید کردن	tæʔkiːdkæɾdæn
تایتانیک	tejtɒːniːk
تایلند	tɒːjlɒːnd
تایلندی	tɒːjlændiː
تایوان	tɒːiːvɒːn
تایپه	tɒːjpe
تایید	tæʔiːd
تایید شدن	tæʔiːdʃodæn
تایید کردن	tæʔiːdkæɾdæn
تب	tæb
تب کردن	tæbkæɾdæn
تبار	tæbɒːɾ
تباری	tæbɒːɾiː
تباه	tæbɒːh
تبت	tæbbæt,tebbet
تبخال	tæbxɒːl
تبخال زدن	tæbxɒːlzædæn
تبدیل	tæbdiːl
تبدیل کردن	tæbdiːlkæɾdæn
تبر	tæbæɾ
تبر زدن	tæbæɾzædæn
تبرئه	tæbɾæʔe
تبرئه کردن	tæbɾæʔekæɾdæn
تبریز	tæbɾiːz
تبریک	tæbɾiːk
تبریک گفتن	tæbɾiːkɡoftæn
تبسم	tæbæssom
تبسم کردن	tæbæssomkæɾdæn
تبلیغ	tæbliːɢ
تبلیغات	tæbliːɢɒːt
تبیلیسی	tiːbiːliːsiː
تتراهیدروکانابینول	tetɾɒːhiːdɾokɒːnɒːbiːnol
تثبیت	tæsbiːt
تثبیت کردن	tæsbiːtkæɾdæn
تجارت	ted͡ʒɒːɾæt
تجارتخانه	ted͡ʒɒːɾætxɒːnæ,ted͡ʒɒːɾætxɒːne
تجاری	ted͡ʒɒːɾiː
تجاوز	tæd͡ʒɒːvoz
تجاوز جنسی	tæd͡ʒɒːvozd͡ʒensiː
تجدید نظر کردن	tæd͡ʒdiːdenæzæɾkæɾdæn
تجدیدنظر	tæd͡ʒdiːdenæzæɾ
تجدیدنظر کردن	tæd͡ʒdiːdenæzæɾkæɾdæn
تجربه	tæd͡ʒɾobe
تجربه کردن	tæd͡ʒɾobekæɾdæn
تجنیس	tæd͡ʒniːs
تجویز	tæd͡ʒviːz
تجویز کردن	tæd͡ʒviːzkæɾdæn
تحریك	tæhɾiːk
تحریك کردن	tæhɾiːkkæɾdæn
تحریم	tæhɾiːm
تحریم‌	tæhɾiːm
تحریم‌ کردن	tæhɾiːmkæɾdæn
تحسین	tæhsiːn
تحقق	tæhæɢɢoɢ
تحقق یافتن	tæhæɢɢoɢjɒːftæn
تحمل	tæhæmmol
تحمل کردن	tæhæmmolkæɾdæn
تحمیل	tæhmiːl
تحمیل کردن	tæhmiːlkæɾdæn
تحول	tæhævvol
تحویل	tæhviːl
تحویل دادن	tæhviːldɒːdæn
تحویل گرفتن	tæhviːlɡeɾeftæn
تخت	tæxt
تخت جمشید	tæxted͡ʒæmʃiːd
تخت طاووس	tæxtetɒːvuːs
تخته	tæxte
تخته زدن	tæxtezædæn
تخته سنگ	tæxtesænɡ,tæxtæsænɡ
تخته سیاه	tæxtejesiːjɒːh
تخته نرد	tæxtenæɾd
تخته نرد زدن	tæxtenæɾdzædæn
تخته‌پاک‌کن	tæxtepɒːkkon
تخفیف	tæxfiːf
تخفیف دادن	tæxfiːfdɒːdæn
تخم	toxm
تخم مرغ	toxmemoɾɢ,toxmemoɾɢ
تخم کردن	toxmkæɾdæn
تخمه	toxmæ
تخمین	tæxmiːn
تخمین زدن	tæxmiːnzædæn
تخمین کردن	tæxmiːnkæɾdæn
تخم‌دان	toxmdɒːn
تدوینگر	tædviːnɡæɾ
تذکر	tæzækkoɾ
تذکر دادن	tæzækkoɾdɒːdæn
ترا	toɾɒː
ترابار كردن	tæɾɒːbɒːɾ
ترازو	tæɾɒːzuː
تراش	tæɾɒːʃ
تراموای	tɾɒːmvɒːj
ترانسیلوانیا	teɾɒːnsiːlvɒːniːjɒː
ترانه	tæɾɒːne
تراوش	tæɾɒːvoʃ
تراوش کردن	tæɾɒːvoʃkæɾdæn
ترب	toɾob
ترجمان	tæɾd͡ʒomɒːn
ترجمه	tæɾd͡ʒome
ترجمه ماشینی	tæɾd͡ʒomemɒːʃiːniː
ترجمه کردن	tæɾd͡ʒomekæɾdæn,tæɾd͡ʒomekæɾdæn
ترجیح	tæɾd͡ʒiːh
ترجیح دادن	tæɾd͡ʒiːhdɒːdæn,tæɾd͡ʒiːhdɒːdæn
ترخانه	tæɾxɒːnæ
تردستی	tæɾdæstiː
ترس	tæɾs
ترسا	tæɾsɒː
ترساندن	tæɾsɒːndæn
ترسایی	tæɾsɒːjiː
ترسناک	tæɾsnɒːk
ترسو	tæɾsuː
ترسیدن	tæɾsiːdæn
ترش	toɾʃ
ترشی	toɾʃiː
ترشیده	toɾʃiːdæh
ترغیب	tæɾɢiːb
ترغیب کردن	tæɾɢiːbkæɾdæn
ترفند	tæɾfænd
ترفند زدن	tæɾfændzædæn
ترمتای	tæɾmætɒːj
ترمذ	teɾmez
ترمز	toɾmoz
ترمز کردن	toɾmozkæɾdæn
ترنج	toɾænd͡ʒ
ترنسنیستریا	tɾænsniːstɾiːjɒː
تره	tæɾe
تروریست	teɾoɾiːst
تروریسم	teɾuːɾiːsm
ترول	tɾuːl
ترویج	tæɾviːd͡ʒ
ترویج کردن	tæɾviːd͡ʒkæɾdæn
ترک	toɾk,tæɾk,tæɾæk
ترک برداشتن	tæɾækbæɾdɒːʃtæn
ترک زدن	tæɾækzædæn
ترک کردن	tæɾækkæɾdæn,tæɾkkæɾdæn
ترکستان	toɾkestɒːn
ترکمنستان	toɾkæmænestɒːn
ترکی	toɾkiː
ترکی عثمانی	toɾkiːjeʔosmɒːniː
ترکیه	toɾkiːje
ترکیه‏ای	toɾkiːjeʔiː
ترگمان	tæɾɡomɒːn
تزار	tzɒːɾ
تزیین	tæzʔiːn
تزیین کردن	tæzʔiːnkæɾdæn
تسار	tsɒːɾ
تسبیح	tæsbiːh
تسلط	tæsællot
تسلط داشتن	tæsælotdɒːʃtæn,tæsællotdɒːʃtæn
تسلیم	tæsliːm
تسلیم شدن	tæsliːmʃodæn
تسلیم کردن	tæsliːmkæɾdæn
تسکین	tæskiːn
تسکین دادن	tæskiːndɒːdæn
تشبیه	tæʃbiːh
تشبیه کردن	tæʃbiːhkæɾdæn
تشخیص	tæʃxiːs
تشخیص دادن	tæʃxiːsdɒːdæn
تشدید	tæʃdiːd
تشدید کردن	tæʃdiːdkæɾdæn
تشر	tæʃæɾ
تشر زدن	tæʃæɾzædæn
تشریف	tæʃɾiːf
تشریف آوردن	tæʃɾiːfɒːvæɾdæn
تشریف بردن	tæʃɾiːfboɾdæn
تشنه	teʃne
تشويق	tæʃviːɢ
تشويق شدن	tæʃviːɢʃodæn
تشويق کردن	tæʃviːɢkæɾdæn
تشویق	tæʃviːɢ
تشویق کردن	tæʃviːɢkæɾdæn
تشکر	tæʃækoɾ,tæʃækkoɾ
تشکر کردن	tæʃækkoɾkæɾdæn
تشکیل	tæʃkiːl
تشکیل دادن	tæʃkiːldɒːdæn
تشکیل شدن	tæʃkiːlʃodæn
تصاحب	tæsɒːhob
تصاحب کردن	tæsɒːhobkæɾdæn
تصادفی	tæsɒːdofiː
تصدیق	tæsdiːɢ
تصدیق کردن	tæsdiːɢkæɾdæn
تصرف	tæsæɾɾof
تصرف کردن	tæsæɾɾofkæɾdæn
تصمیم گرفتن	tæsmiːmɡeɾeftæn
تصنيف هجائی	tæsniːfehed͡ʒɒːʔiː
تصور	tæsævvoɾ
تصور کردن	tæsævvoɾkæɾdæn
تصویب	tæsviːb
تصویب رسیدن	tæsviːbɾesiːdæn
تصویب کردن	tæsviːbkæɾdæn
تصویر	tæsviːɾ
تضاد	tæzzɒːd
تطبیق	tætbiːɢ
تطبیق دادن	tætbiːɢdɒːdæn
تطبیق کردن	tætbiːɢkæɾdæn
تعارف	tæʔɒːɾof
تعارف کردن	tæʔɒːɾofkæɾdæn
تعجب	tæʔæd͡ʒd͡ʒob
تعجب ساختن	tæʔæd͡ʒobsɒːxtæn
تعجب کردن	tæʔæd͡ʒd͡ʒobkæɾdæn
تعریف	tæʔɾiːf
تعریف کردن	tæʔɾiːfkæɾdæn,tæʔɾiːfkæɾdæn
تعظیم	tæʔziːm
تعظیم کردن	tæʔziːmkæɾdæn
تعقیب	tæʔɢiːb
تعقیب کردن	tæʔɢiːbkæɾdæn
تعلق	tæʔælloɢ
تعلق داشتن	tæʔælloɢdɒːʃtæn
تعلق گرفتن	tæʔælloɢɡeɾeftæn
تعلم	tæʔællom
تعلیم	tæʔliːm
تعمیر	tæʔmiːɾ
تعمیر کردن	tæʔmiːɾkæɾdæn
تعمیرکار	tæʔmiːɾkɒːɾ
تعیین	tæʔiːn
تعیین کردن	tæʔiːnkæɾdæn
تغییر	tæɢʔiːɾtæɢjiːɾ,tæɢjiːɾ
تغییر کردن	tæɢʔiːɾkæɾdæn
تغییرعقیده	tæɢʔiːɾeæɢiːde
تغییرعقیده دادن	tæɢʔiːɾeæɢiːdedɒːdæn
تغییرمسیر	tæɢjiːɾemæsiːɾ
تف	tof
تف کردن	tofkæɾdæn
تفریح	tæfɾiːh
تفلیس	tiːfliːs
تفنگ	tofænɡ
تقدیر	tæɢdiːɾ
تقریب	tæɢɾiːb
تقریب زدن	tæɢɾiːbzædæn
تقریبا	tæɢɾiːbæn
تقلا	tæɢællɒː
تقلا کردن	tæɢællɒːkæɾdæn
تقلید	tæɢliːd
تقلید کردن	tæɢliːdkæɾdæn,tæɢliːdkæɾdæn
تقویت	tæɢviːæt
تقویت شدن	tæɢviːætʃodæn
تقویت نمودن	tæɢviːætnemuːdæn
تقویت کردن	tæɢviːætkæɾdæn
تقویم	tæɢviːm
تكرار	tekɾɒːɾ
تكرار کردن	tekɾɒːɾkæɾdæn
تكواژ	tækvɒːʒ
تلاش	tælɒːʃ
تلاش بودن	tælɒːʃbuːdæn
تلاش کردن	tælɒːʃkæɾdæn
تلافی	tælɒːfiː
تلافی کردن	tælɒːfiːkæɾdæn
تلخ	tælx
تلسکوپ	teleskop
تلف	tælæf
تلف کردن	tælæfkæɾdæn
تلفظ	tælæffoz
تلفظ کردن	tælæffozkæɾdæn
تلفن	telefon
تلفن زدن	telefonzædæn,telefonzædæn
تلفن موبایل	telefonemobɒːjl
تلفن همراه	telefonehæmɾɒːh
تلفن هوشمند	telefonehuːʃmænd
تلفن کردن	telefonkæɾdæn,telefonkæɾdæn
تلمبه	tolombe
تلمبه زدن	tolombezædæn
تلنگر	tælænɡoɾ
تلنگر زدن	tælænɡoɾzædæn
تلویزیون	televiːziːon
تلویزیون کابلی	televiːziːonkɒːbliː
تلگراف	teleɡɾɒːf
تلگراف زدن	teleɡɾɒːfzædæn
تلگراف شدن	teleɡɾɒːfʃodæn
تلگراف کردن	teleɡɾɒːfkæɾdæn
تماس	tæmɒːs
تماس گرفتن	tæmɒːsɡeɾeftæn,tæmɒːsɡeɾeftæn
تماشا	tæmɒːʃɒː
تماشا کردن	tæmɒːʃɒːkæɾdæn,tæmɒːʃɒːkæɾdæn
تماشا‌کردن	tæmɒːʃækæɾdæn
تمام	tæmɒːm
تمام شدن	tæmɒːmʃodæn
تمام کردن	tæmɒːmkæɾdæn
تمام‌خط	tæmɒːmxæt
تمبر	tæmbɾ,tæmɾ
تمبر زدن	tæmɾzædæn
تمبر پستی	tæmbɾepostiː
تمبک	tombæk
تمرین	tæmɾiːn
تمرین کردن	tæmɾiːnkæɾdæn
تمساح	temsɒːh
تمشک	tæmeʃk
تمنا	tæmænnɒː
تمنا کردن	tæmænnɒːkæɾdæn
تمیز	tæmiːz
تمیز کردن	tæmiːzkæɾdæn
تن	ton,tæn
تن دادن	tændɒːdæn
تن داشتن	tændɒːʃtæn
تن کردن	tænkæɾdæn
تنباکو	tæbɒːko
تنبل	tænbæl
تند	tond
تندر	tondæɾ
تندرست	tændoɾost,tændæɾæst
تندپز	tondpæz
تنندگان	tænændeɡɒːn
تنه	tæne
تنه زدن	tænezædæn
تنها	tænhɒː
تنهایی	tænhɒːjiː
تنور	tænuːɾ
تنگ	tænɡ
تنگدستی	tænɡdæstiː
تنگستن	tænɡesten
تنگنا	tænɡnɒː
تنگه بسفر	tænɡæbosfoɾ
تنگه هرمز	tænɡejehoɾmoz
تنگی نفس	tænɡiːenæfæs
تنی	tæniː
تنیس	teniːs
تنیس زدن	teniːszædæn
تن‌فروشی	tænfoɾuːʃiː
ته تغاری	tætoɢɒːɾiː
تهدید	tæhdiːd
تهدید کردن	tæhdiːdkæɾdæn
تهران	tehɾɒːn
تهرانی	tehɾɒːniː
تهرون	tehɾuːn
تهمت	tohmæt
تهمت زدن	tohmætzædæn
تهيه	tæhiːje
تهيه دیدن	tæhiːjediːdæn
تهيه کردن	tæhiːjekæɾdæn
تهی	tohiː
تو	to,tuː
تو را	tuːɾɒː
تو راه	tuːɾɒːh
توازن قدرت	tævɒːzoneɢodɾæt
توافق	tævɒːfoɢ
توافق رسیدن	tævɒːfoɢɾesiːdæn
توالت	tuːɒːlet
توان	tævɒːn
توان بویایی	tævɒːnebuːjɒːjiː
توانستن	tævɒːnestæn
توبه	toʊbe
توبه کردن	toʊbekæɾdæn
توت	tuːt
توت فرنگی	tuːtfæɾænɡiː
توت‌فرنگی	tuːtfæɾænɡiː
توجه	tævæd͡ʒd͡ʒoh
توجه شدن	tævæd͡ʒd͡ʒohʃodæn
توجه کردن	tævæd͡ʒd͡ʒohkæɾdæn
توجیه	tod͡ʒiːh
توجیه کردن	tod͡ʒiːhkæɾdæn
توحید	touːhiːd
تودار	tuːdɒːɾ
تودهنی	tuːdæhæniː
تودهنی زدن	tuːdæhæniːzædæn
تورات	tuːɾɒːt,tævɾɒːt
تورم	tævæɾɾom
توزلا	tuːzlɒː
توزیع	toziːæ
توسری	tuːsæɾiː
توسری زدن	tuːsæɾiːzædæn
توصیف	toʊsiːf
توصیف کردن	toʊsiːfkæɾdæn
توضیح	toʊziːh
توضیح دادن	tæwziːhdɒːdæn,toʊziːhdɒːdæn
توفا	tuːfɒː
توقع	tævæɢɢoʔ
توقع داشتن	tævæɢɢoʔdɒːʃæn
تولد	tævællod,tævælod
تولدت مبارک	tævɒːllodætmobɒːɾæk
توله	tuːle
توله سگ	tuːlesæɡ
تولید	touːliːd
تومسک	tomsk
توندرا	tuːndɾɒː
تونس	tuːnes
تونل	tuːnel
تونل زدن	tuːnelzædæn
تونل کشیدن	tuːnelkeʃiːdæn
توهین	toʊhiːn
توهین کردن	toʊhiːnkæɾdæn
توپ	tuːp
توپ وتشر	tuːpotæʃæɾ
توپ وتشر زدن	tuːpotæʃæɾzædæn
توکان	tuːkɒːn
توگوشی	tuːɡuːʃiː
توگوشی زدن	tuːɡuːʃiːzædæn
تپق	topoɢ
تپق زدن	topoɢzædæn
تپه	tæpe
تک	tæk
تکان	tekɒːn
تکان خوردن	tekɒːnxoɾdæn
تکاوری	tækɒːvæɾiː
تکرار	tekɾɒːɾ,tækɾɒːɾ
تکرار شدن	tekɾɒːɾʃodæn,tækɾɒːɾʃodæn
تکرار کردن	tekɾɒːɾkæɾdæn
تکمه	tokme,tokmæ
تکنولوژی	teknoloʒiː
تکنیک	tekniːk
تکه	tekke
تکیه	tækjetekje,tækje
تکیه دادن	tækjedɒːdæn
تکیه زدن	tækjezædæn
تک‌تیرانداز	tæktiːɾændɒːz
تگرگ	tæɡæɾɡ
تگزاس	teɡzɒːs
تگزاسی	teɡzɒːsiː
تیتر	tiːtɾ
تیتر زدن	tiːtɾzædæn
تیر	tîɾ,tiːɾ
تیر زدن	tiːɾzædæn
تیر و کمان	tiːɾokæmɒːn
تیر کشیدن	tiːɾkeʃiːdæn
تیرانداز	tiːɾændɒːz
تیز	tiːz
تیزآب	tiːzɒːb
تیزآب سلطانی	tiːzɒːbesoltæniː
تیغ	tiːɢ
تیغ اوکام	tiːɢokɒːm
تیغ زدن	tiːɢzædæn
تیله	tiːle
تیم	tiːm
تیهو	tiːhuː
تیپا	tiːpɒː
تیپا زدن	tiːpɒːzædæn
ثابت	sɒːbet
ثابت پلانک	sɒːbeteplɒːnk
ثانیه	sɒːniːje
ثبت	sæbt
ثبت کردن	sæbtkæɾdæn
ثروت	seɾvæt
ثروتمند	seɾvætmænd
ثریا	ʃoɾæiːjɒː
ثمر	sæmæɾ
ثمر داشتن	sæmæɾdɒːʃtæn
ثمر رسیدن	sæmæɾɾesiːdæn
جا	d͡ʒɒː
جا به جا	d͡ʒɒːbed͡ʒɒː
جا به جا شدن	d͡ʒɒːbed͡ʒɒːʃodæn
جا به جا کردن	d͡ʒɒːbed͡ʒɒːkæɾdæn
جا زدن	d͡ʒɒːzædæn
جا لباسي	d͡ʒɒːlebɒːsiː
جا گرفتن	d͡ʒɒːɡeɾeftæn
جادار	d͡ʒɒːdɒːɾ
جاده	d͡ʒɒːdde
جاده زدن	d͡ʒɒːddezædæn
جاده کشیدن	d͡ʒɒːddekeʃiːdæn
جادو	d͡ʒɒːduː
جادوی سیاه	d͡ʒɒːduːjesiːjɒːh
جادویی	d͡ʒɒːduːjiː
جار	d͡ʒɒːɾ
جار زدن	d͡ʒɒːɾzædæn
جار کشیدن	d͡ʒɒːɾkeʃiːdæn
جارو	d͡ʒɒːɾuː
جارو برقی	d͡ʒɒːɾuːbæɾɢiː
جارو زدن	d͡ʒɒːɾuːzædæn
جارو کردن	d͡ʒɒːɾuːkæɾdæn
جارو کشیدن	d͡ʒɒːɾuːkeʃiːdæn
جاروب	d͡ʒɒːɾuːb
جاری	d͡ʒɒːɾiː
جاز	d͡ʒɒːz
جاسوس	d͡ʒɒːsuːs
جاسوسی	d͡ʒɒːsuːsiː
جالب	d͡ʒɒːleb
جام	d͡ʒɒːm
جامدادی	d͡ʒɒːmedɒːdiː
جامع	d͡ʒɒːmeʔ
جامعه	d͡ʒɒːmeʔe
جان	d͡ʒɒːn
جان دادن	d͡ʒɒːndɒːdæn
جان گرفتن	d͡ʒɒːnɡeɾeftæn
جانان	d͡ʒɒːnɒːn
جانماز	d͡ʒɒːnæmɒːz
جانور	d͡ʒɒːnvæɾ
جانورشناسی	d͡ʒɒːnvæɾʃenɒːsiː
جاوا	d͡ʒɒːvɒː
جاوه	d͡ʒɒːve
جاوی	d͡ʒɒːviː
جاچسبی	d͡ʒɒːt͡ʃæsbiː
جاکارتا	d͡ʒɒːkɒːɾtɒː
جاکش	d͡ʒɒːkeʃ
جای	d͡ʒɒːj
جایزه	d͡ʒɒːjeze
جایگاه	d͡ʒɒːjɡɒːh
جای‌گزین	d͡ʒɒːjɡoziːn
جبر	d͡ʒæbɾ
جبرئیل	d͡ʒebɾæʔiːl
جبران	d͡ʒobɾɒːn
جبران شدن	d͡ʒobɾɒːnʃodæn
جبران کردن	d͡ʒobɾɒːnkæɾdæn
جبری	d͡ʒæbɾiː
جبریل	d͡ʒebɾiːl
جبرییل	d͡ʒebɾejiːl
جدا	d͡ʒeddæn
جدال	d͡ʒedɒːl
جدال کردن	d͡ʒedɒːlkæɾdæn
جداچاپ	d͡ʒodɒːt͡ʃɒːp
جده	d͡ʒedde
جدول تناوبی	d͡ʒædvæletænɒːvobiː
جدید	d͡ʒædiːd
جذام	d͡ʒozɒːm
جر	d͡ʒeɾ
جر زدن	d͡ʒeɾzædæn
جرأت	d͡ʒoɾʔæt
جرأت داشتن	d͡ʒoɾʔætdɒːʃtæn
جرأت کردن	d͡ʒoɾʔætkæɾdæn
جراحی	d͡ʒæɾɾɒːhiː
جراحی کردن	d͡ʒæɾɾɒːhiːkæɾdæn
جرقه	d͡ʒæɾæɢɢe,d͡ʒeɾæɢɢe
جرقه زدن	d͡ʒæɾæɢɢezædæn
جرم	d͡ʒoɾm,d͡ʒeɾm
جرم گرفتن	d͡ʒeɾmɡeɾeftæn
جرمن شپرد	d͡ʒæɾmænʃepæɾd
جرگه بزرگ	d͡ʒæɾɡæbozoɾɡ
جرگه‌سالاران	d͡ʒæɾɡesɒːlɒːɾɒːn
جرگه‌سالاری	d͡ʒæɾɡesɒːlɒːɾiː
جریب	d͡ʒæɾiːb
جز	d͡ʒoz
جزء	d͡ʒoz
جزجز	d͡ʒezd͡ʒez
جزجز زدن	d͡ʒezd͡ʒezzædæn
جزجز کردن	d͡ʒezd͡ʒezkæɾdæn
جزر	d͡ʒæzɾ
جزم	d͡ʒæzm
جزیره	d͡ʒæziːɾe
جزیره ایستر	d͡ʒæziːɾeiːsteɾ
جست	d͡ʒæst
جست زدن	d͡ʒæstzædæn
جستجو	d͡ʒosted͡ʒuːd͡ʒostod͡ʒuː
جستجو کردن	d͡ʒostod͡ʒuːkæɾdæn,d͡ʒosted͡ʒuːkæɾdæn
جستن	d͡ʒostæn
جسد	d͡ʒæsæd
جسم	d͡ʒesm
جشن	d͡ʒɒːʃn
جشن گرفتن	d͡ʒɒːʃnɡeɾeftæn
جشنواره	d͡ʒæʃnvɒːɾe
جعبه	d͡ʒæʔbe
جعبه نامه	d͡ʒæʔbejenɒːme
جعفری	d͡ʒæʔfæɾiː
جعلی	d͡ʒæʔliː
جغد	d͡ʒoɢd
جغرافیا	d͡ʒoɢɾɒːfiːjɒː
جفتک	d͡ʒoftæk
جفتک زدن	d͡ʒoftækzædæn
جلا	d͡ʒælɒː
جلال‌آباد	d͡ʒælɒːlɒːbɒːd
جلد	d͡ʒeld
جلق	d͡ʒælɢ
جلق زدن	d͡ʒælɢzædæn
جلو	d͡ʒeloʊ,d͡ʒolo,d͡ʒelo,d͡ʒeloʊ
جلو زدن	d͡ʒelozædæn
جلو گرفتن	d͡ʒeloʊɡeɾeftæn
جلیقه ی نجات	d͡ʒeliːɢejened͡ʒɒːt
جمجمه	d͡ʒomd͡ʒome
جمع	d͡ʒæmʔ
جمع زدن	d͡ʒæmʔzædæn
جمع کردن	d͡ʒæmʔkæɾdæn
جمعه	d͡ʒomʔe
جمله	d͡ʒomle
جمله‌شناسی	d͡ʒomleʃenɒːsiː
جمهوری	d͡ʒomhuːɾiː
جمهوری ارمنستان	d͡ʒomhuːɾiːjeæɾmænestɒːn
جمهوری اسلامی ایران	d͡ʒomhuːɾiːjeeslɒːmiːjeiːɾɒːn
جمهوری ترکیه	d͡ʒomhuːɾiːjetoɾkiːje
جمهوری عربی مصر	d͡ʒomhuːɾiːjeʔæɾæbiːjemesɾ
جمهوری چک	d͡ʒomhuːɾiːjet͡ʃek
جمهوری‌خواه	d͡ʒomhuːɾiːxɒːh
جن	d͡ʒen
جناب	d͡ʒenɒːb
جنازه	d͡ʒænɒːze,d͡ʒenɒːze
جناس	d͡ʒenɒːs
جنبش	d͡ʒonbeʃ
جنبش غیرمتعهد	d͡ʒonbeʃeædæmetæʔæhhod,d͡ʒonbeʃeɢejɾemoteʔæhhed
جنت	d͡ʒænnæt
جنده	d͡ʒende
جنده‌خانه	d͡ʒendexɒːne
جنس بلند کردن	ɡensbolændkæɾdæn
جنسی	d͡ʒínsiː,d͡ʒensiː
جنسیت	d͡ʒensiːjæt
جنسیت‌گرایی	d͡ʒensiːtɡæɾɒːjiː
جنوب	d͡ʒonuːb
جنوب شرقی	d͡ʒonuːbeʃæɾɢiː
جنوب غربی	d͡ʒonuːbeɢæɾbiː
جنوبگان	d͡ʒuːnuːbeɡɒːn
جنگ	d͡ʒænɡ
جنگ اسفلال طلبی	d͡ʒænɡeesteɢlɒːltælæbiː
جنگ جهانی دوّم	d͡ʒænɡed͡ʒæhɒːniːedovvom
جنگ جهانی یكم	d͡ʒænɡed͡ʒæhɒːniːejekom
جنگ سرد	d͡ʒænɡesæɾd
جنگل	d͡ʒænɡæl
جنگل زدن	d͡ʒænɡælzædæn
جنگ‌های صلیبی	d͡ʒænɡhɒːjesæliːbiː
جهاد	d͡ʒehɒːd
جهاز	d͡ʒæhɒːz
جهالت	d͡ʒ��hɒːlæt
جهالت زدن	d͡ʒæhɒːlætzædæn
جهان	d͡ʒæhɒːn
جهان عرب	d͡ʒæhɒːneʔæɾæb
جهانی‌سازی	d͡ʒæhɒːniːsɒːziː
جهت اطلاع	d͡ʒæhæteettelɒːʔ
جهد	d͡ʒæhd
جهد کردن	d͡ʒæhdkæɾdæn
جهل	d͡ʒæhl
جهل زدن	d͡ʒæhlzædæn
جهنم	d͡ʒæhænnæm
جهیدن	d͡ʒæhiːdæn
جو	d͡ʒævv,d͡ʒoʊ,d͡ʒuː
جواب	d͡ʒævɒːb
جواب دادن	d͡ʒævɒːbdɒːdæn,d͡ʒævɒːbdɒːdæn
جواب کردن	d͡ʒævɒːbkæɾdæn
جواب گرفتن	d͡ʒævɒːbɡeɾeftæn
جوان	d͡ʒævɒːn
جوانه	d͡ʒævɒːne
جوانه زدن	d͡ʒævɒːnezædæn
جوانی	d͡ʒævɒːniː
جوجه	d͡ʒuːd͡ʒe
جوجه‌تیغی	d͡ʒuːd͡ʒetiːɢiː
جوراب	d͡ʒuːɾɒːb
جورج	d͡ʒoɾd͡ʒ
جورج تائون	d͡ʒoɾd͡ʒtɒːʔuːn
جورج تاون	d͡ʒoɾd͡ʒtɒːuːn
جورجیا	d͡ʒuːɾd͡ʒiːjɒː
جوش	d͡ʒuːʃ
جوش آمدن	d͡ʒuːʃɒːmædæn
جوش آوردن	d͡ʒuːʃɒːvæɾdæn
جوش دادن	d͡ʒuːʃdɒːdæn
جوش زدن	d͡ʒuːʃzædæn
جولان	d͡ʒoʊlɒːn
جولان دادن	d͡ʒoʊlɒːndɒːdæn
جولیا	d͡ʒuːliːɒː
جوهر	d͡ʒoʊhæɾ
جوهر شوره	d͡ʒouːhæɾeʃuːɾe
جوهر نمک	d͡ʒouːhæɾenæmæk
جویدن	d͡ʒæviːdæn
جگر	d͡ʒeɡæɾ
جیب	d͡ʒiːb,d͡ʒejb
جیب زدن	d͡ʒiːbzædæn
جیبوتی	d͡ʒiːbuːtiː
جیحون	d͡ʒejhuːn
جیرجیرک	d͡ʒiːɾd͡ʒiːɾæk
جیش	d͡ʒiːʃ
جیغ	d͡ʒǐɢ,d͡ʒiːɢ
جیغ زدن	d͡ʒiːɢzædæn,d͡ʒiːɢzædæn,d͡ʒǐɢzædæn
جیغ کشیدن	d͡ʒiːɢkeʃiːdæn
جیم	d͡ʒiːm
جیمز	d͡ʒejmz
جیوه	d͡ʒiːve
جیپ	d͡ʒiːp
جیک	d͡ʒiːk
جیک زدن	d͡ʒiːkzædæn
جیگر	d͡ʒiːɡæɾ
حاجی	hɒːd͡ʒiː
حاد	hɒːd
حاشیه	hɒːʃiːje
حاشیه نشین	hɒːʃiːjeneʃiːn
حاضر	hɒːzeɾ
حافظه	hɒːfeze
حالا	hɒːlɒː
حالت نهادی	hɒːlætenæhɒːdiː
حاملگی	hɒːmeleɡiː
حاکم	hɒːkem
حباب	hebɒːb
حتما	hætmæn
حتی‌الامکان	hættælemkɒːn
حج	hæd͡ʒd͡ʒ
حجاب	hed͡ʒɒːb
حجم	hæd͡ʒm
حدس	hæds
حدس زدن	hædszædæn,hædszædæn
حدیث	hædiːs
حذر	hæzæɾ
حذر کردن	hæzæɾkæɾdæn
حرام	hæɾɒːm
حرص	heɾs
حرص زدن	heɾszædæn
حرف	hæɾf
حرف اضافه	hæɾfeezɒːfe
حرف ربط	hæɾfeɾæbt
حرف زدن	hæɾfzædæn,hæɾfzædæn
حرف ندا	hæɾfenedɒː
حرف هان	hæɾfehɒːn
حرف چینی	hæɾfet͡ʃiːniː
حرف گرفتن	hæɾfɡeɾeftæn
حركت	hæɾekæt
حركت دادن	hæɾekætdɒːdæn
حركت درآوردن	hæɾekætdæɾɒːvæɾdæn
حركت کردن	hæɾekætkæɾdæn
حریف	hæɾiːf
حریم	hæɾiːm
حزب	hezb
حزب‌الله	hezbollɒːh
حس	hes
حس کردن	heskæɾdæn
حساب	hesɒːb
حساب آمدن	hesɒːbɒːmædæn
حساب بردن	hesɒːbboɾdæn
حساب کردن	hesɒːbkæɾdæn
حسابدار	hesɒːbdɒːɾ
حسادت	hesɒːdæt
حسب حال	hæsbehɒːl
حسد	hæsæd
حسد بردن	hæsædboɾdæn
حسودی	hæsuːdiː
حسودی شدن	hæsuːdiːʃodæn
حسودی کردن	hæsuːdiːkæɾdæn
حشره	hæʃæɾe
حشره‌شناسی	hæʃæɾeʃenɒːsiː
حشفه	hæʃæfe
حشیش	hæŝiːŝ,hæʃiːʃ
حشیش زدن	hæʃiːʃzædæn
حشیش کشیدن	hæʃiːʃkeʃiːdæn
حصار	hesɒːɾ
حصار کشیدن	hesɒːɾkeʃiːdæn
حضور	hozuːɾ
حضور داشتن	hozuːɾdɒːʃtæn
حظ	hæz
حظ کردن	hæzkæɾdæn
حفظ	hefz
حفظ شدن	hefzʃodæn
حفظ کردن	hefzkæɾdæn
حق	hæɢɢ
حق زدن	hæɢɢzædæn
حقه	hoɢɢe
حقه خوردن	hoɢɢexoɾdæn
حقه زدن	hoɢɢezædæn
حقوق بشر	hoɢuːɢebæʃæɾ
حقیقت	hæɢiːɢæt
حل	hæl
حل شدن	hælʃodæn
حل کردن	hælkæɾdæn,hællkæɾdæn
حلال	hælɒːl
حلزون	hælæzuːn
حلقه	hælɢe
حلقه زدن	hælɢezædæn
حلقه کردن	hælɢekæɾdæn
حلقوی	hælɢæviː
حلوا	hɒːlvɒː
حماس	hæmɒːs
حماقت	hemɒːɢæt
حماقت زدن	hemɒːɢætzædæn
حمام	hæmmɒːm
حمام رفتن	hæmmɒːmɾæftæn
حمایت	hemɒːjæt
حمایت کردن	hemɒːjætkæɾdæn
حمل	hæml
حمل شدن	hæmlʃodæn
حمل کردن	hæmlkæɾdæn
حمله	hæmle
حمله آوردن	hæmleɒːvæɾdæn
حمله بردن	hæmleboɾdæn
حمله کردن	hæmlekæɾdæn
حنا	hænɒː,hennɒː
حنا زدن	hænɒːzædæn
حنجره	hænd͡ʒæɾe
حنوکا	hænuːkɒː
حواجه‌زاده	xɒːd͡ʒezɒːde
حواجه‌سرا	xɒːd͡ʒesæɾɒː
حوزه	houːze
حوله	hole
حومه شهر	huːmejeʃæhɾ
حک	hæk
حک شدن	hækʃodæn
حکایت	hekɒːjæt
حکایت کردن	hekɒːjætkæɾdæn
حکمت	hekmæt
حکمران	hokmɾɒːn
حکومت	hokuːmæt
حیدرآباد	hejdæɾɒːbɒːd
حیرت	hejɾæt
حیرت افتادن	hejɾætoftɒːdæn
حیرت کردن	hejɾætkæɾdæn
حیفا	hæiːfɒː
حیله	hiːle
حیله خوردن	hiːlexoɾdæn
حیله زدن	hiːlezædæn
حیوان	hejvɒːn
حیوانی	hejvɒːniː
خائن	xɒːʔen
خاتم کاری	xɒːtæmkɒːɾiː
خاتمه	xɒːteme
خاتمه دادن	xɒːtemedɒːdæn
خاتمه گرفتن	xɒːtemeɡeɾeftæn
خاتمه یافتن	xɒːtemejɒːftæn
خاج	xɒːd͡ʒ
خار	xɒːɾ
خارج	xɒːɾed͡ʒ
خارج شدن	xɒːɾed͡ʒʃodæn
خارجی	xɒːɾed͡ʒiː
خارطوم	xɒːɾtuːm
خارکوف	xɒːɾkov,xɒːɾkuːv
خارگیل	xɒːɾɡiːl
خاس	xɒːs
خاص	xɒːs
خاطر	xɒːteɾ
خاطر آوردن	xɒːteɾɒːvæɾdæn
خاطر داشتن	xɒːteɾdɒːʃtæn
خاطر نشان	xɒːteɾneʃɒːn
خاطر نشان کردن	xɒːteɾneʃɒːnkæɾdæn
خاطرخواه	xɒːteɾxɒːh
خاقان	xɒːɢɒːn
خالق	xɒːleɢ
خاله	xɒːle
خاله‌زاده	xɒːlezɒːde
خالو	xɒːluː
خالی	xɒːliː
خالی کردن	xɒːliːkæɾdæn
خال‌کوبی	xɒːlkuːbiː
خاموش	xɒːmuːʃ
خاموشی	xɒːmuːʃiː
خان	xɒːn
خانتیمانسییسک	xɒːntiːmɒːnsiːjsk
خاندان	xɒːndɒːn
خانم	xɒːnom
خانم‌ها و آقایان	xɒːnomhɒːvæɒːɢɒːjɒːn
خانه	xɒːne,xɒːnæ
خانواده	xɒːnevɒːde,xɒːnevɒːdæh
خاور	xɒːvæɾ
خاور دور	xɒːvæɾeduːɾ
خاورمیانه	xɒːvæɾemiːjɒːne
خاویار	xɒːvjɒːɾ
خاک	xɒːk
خاک سپردن	xɒːksepoɾdæn
خاک کردن	xɒːkkæɾdæn,xɒːkkæɾdæn
خاکزاد	xɒːkzɒːd
خاکستری	xɒːkestæɾiː
خاکی	xɒːkiː
خاکی کردن	xɒːkiːkæɾdæn
خایه	xɒːje
خبر	xæbæɾ
خبر دادن	xæbæɾdɒːdæn
خبر شدن	xæbæɾʃodæn
خبر کردن	xæbæɾkæɾdæn
خبط	xæbt
خبط کردن	xæbtkæɾdæn
ختم	xætm
ختم شدن	xætmʃodæn
ختنه	xætne
ختنه‌گاه	xætneɡɒːh
خجالت	xed͡ʒɒːlæt
خجالت کشیدن	xed͡ʒɒːlætkeʃiːdæn
خدا	xodɒː
خدا حافظ	xodɒːhɒːfez
خدا نگهدار	xodɒːneɡæhdɒːɾ
خداحافظی	xodɒːhɒːfeziː
خداحافظی کردن	xodɒːhɒːfeziːkæɾdæn
خداوند	xodɒːvænd
خدای پدر	xodɒːjepedæɾ
خدایگان	xodɒːjɡɒːn
خدمت	xedmæt
خدمت کردن	xedmætkæɾdæn,xedmætkæɾdæn
خر	xæɾ
خر و پف	xoɾopof
خر و پف کردن	xoɾopofkæɾdæn
خراب	xæɾɒːb
خراب کردن	xæɾɒːbkæɾdæn
خرابه	xæɾɒːbe
خرابکار	xæɾɒːbkɒːɾ
خراش	xæɾɒːʃ
خراش افتادن	xæɾɒːʃoftɒːdæn
خراش خوردن	xæɾɒːʃxoɾdæn
خراش دادن	xæɾɒːʃdɒːdæn
خراشیدن	xæɾɒːʃiːdæn
خراميدن	xæɾɒːmiːdæn
خربزه	xæɾboze
خرج	xæɾd͡ʒ
خرج دادن	xæɾd͡ʒdɒːdæn
خرج شدن	xæɾd͡ʒʃodæn
خرج کردن	xæɾd͡ʒkæɾdæn
خرخر	xoɾxoɾ
خرخر کردن	xoɾxoɾkæɾdæn
خرد	xeɾæd,xoɾd
خرد کردن	xoɾdkæɾdæn,xoɾdkæɾdæn
خرداد	xoɾdɒːd
خردل	xæɾdæl
خردمند	xeɾædmænd
خردمندی	xeɾædmændiː
خرده	xoɾde
خرده گرفتن	xoɾdeɡeɾeftæn
خرس	xeɾs
خرس پاندا	xeɾsepɒːndɒː
خرما	xoɾmɒː
خرمائی روشن	xoɾmɒːjiːjeɾoʃæn
خرمارطب	xoɾmɒːɾotæb
خرمالو	xoɾmɒːluː
خرمایی	xoɾmɒːjiː
خرمشهر	xoɾæmʃæhɾ
خرمن	xæɾmæn
خروج	xoɾuːd͡ʒ
خروس	xoɾuːs
خروشچف	xɾuːʃt͡ʃef
خروشیدن	xɾuːʃiːdæn
خرچنگ	xæɾt͡ʃænɡ
خرگوش	xæɾɡuːʃ
خرگوش كوهی	xæɾɡuːʃekuːhiː
خریت	xæɾiːjjæt
خریت زدن	xæɾiːjjætzædæn
خرید رفتن	xæɾiːdɾæftæn
خرید کردن	xæɾiːdkæɾdæn
خریدن	xæɾiːdæn
خزان	xæzɒːn
خزنده	xæzænde
خسارت	xesɒːɾæt
خسارت خوردن	xesɒːɾætxoɾdæn
خسارت زدن	xesɒːɾætzædæn
خسته	xæstæ,xæste
خشاب	xeʃɒːb
خشایارشا	xʃɒːjɒːɾʃɒː,xæʃɒːjɒːɾʃɒː
خشایارشاه	xʃɒːjɒːɾʃɒːh
خشت	xeʃt
خشم	xæʃm
خشم آمدن	xæʃmɒːmædæn
خشم آوردن	xæʃmɒːvæɾdæn
خشم گرفتن	xæʃmɡeɾeftæn
خشمگین	xæʃmɡiːn
خشک	xoʃk
خشک زدن	xoʃkzædæn
خشک‌سالی	xoʃksɒːliː
خصم	xæsm
خط	xæt
خط تیره	xættetiːɾe
خط خوردن	xætxoɾdæn
خط زدن	xætzædæn
خط فرمان	xættefæɾmɒːn
خط کشیدن	xætkeʃiːdæn
خطا	xætɒː
خطا کردن	xætɒːkæɾdæn
خطاب	xætɒːb
خطاب کردن	xætɒːbkæɾdæn
خطاط	xættɒːt
خطر	xætæɾ
خطرناک	xætæɾnɒːk
خطّ استوا	xætteostovɒː
خطکش	xætkeʃ
خط‌کش	xættkeʃ,xætkeʃ
خفاش	xefɒːʃ,xoffɒːʃ
خفتان	xæftɒːn
خلاصه	xolɒːse
خلاصه کردن	xolɒːsekæɾdæn
خلاف	xælɒːf
خلاف کردن	xælɒːfkæɾdæn
خلافت	xelɒːfet
خلع سلاح	xælʔeselɒːh
خلع سلاح کردن	xælʔeselɒːhkæɾdæn
خلیج	xæliːd͡ʒ
خلیج فارس	xæliːd͡ʒefɒːɾs
خلیفه	xæliːfe
خم	xæm
خم کردن	xæmkæɾdæn
خماندن	xæmɒːndæn
خمپاره	xompɒːɾe
خمپاره خوردن	xompɒːɾexoɾdæn
خمپاره زدن	xompɒːɾezædæn
خمیازه	xæmjɒːze
خمیازه کشیدن	xæmjɒːzekeʃiːdæn
خمیدن	xæmiːdæn
خنجر	xænd͡ʒæɾ
خنجر خوردن	xænd͡ʒæɾxoɾdæn
خنجر زدن	xænd͡ʒæɾzædæn
خنده	xænde
خنده زدن	xændezædæn
خنده کردن	xændekæɾdæn
خنده گرفتن	xændeɡeɾeftæn
خندیدن	xændiːdæn
خنگ	xenɡ
خنیا	xoniːjɒː
خو	xuː
خو گرفتن	xuːɡeɾeftæn
خواب	xɒːb
خواب دیدن	xɒːbdiːdæn,xwɒːbdiːdæn
خواب رفتن	xɒːbɾæftæn
خواب زدن	xɒːbzædæn
خوابیدن	xɒːbiːdæn,xwɒːbiːdæn
خواجه	xɒːd͡ʒe
خواجه‌ها	xɒːd͡ʒehɒː
خواجگان	xɒːd͡ʒeɡɒːn
خوارزم	xɒːɾæzm
خواست	xɒːst
خواستم	xɒːstæm
خواستن	xwɒːstæn,xvɒːstæn,xɒːstæn
خواستند	xɒːstænd
خواسته	xɒːste
خواسته است	xɒːsteæst
خواسته باشد	xɒːstebɒːʃæd
خواسته باشم	xɒːstebɒːʃæm
خواسته باشند	xɒːstebɒːʃænd
خواسته باشی	xɒːstebɒːʃiː
خواسته باشید	xɒːstebɒːʃiːd
خواسته باشیم	xɒːstebɒːʃiːm
خواسته بود	xɒːstebúd
خواسته بودم	xɒːstebúdæm
خواسته بودند	xɒːstebúdænd
خواسته بودی	xɒːstebúdiː
خواسته بودید	xɒːstebúdiːd
خواسته بودیم	xɒːstebúdiːm
خواسته‌ام	xɒːsteæm
خواسته‌اند	xɒːsteænd
خواسته‌ای	xɒːsteiː
خواسته‌اید	xɒːsteiːd
خواسته‌ایم	xɒːsteiːm
خواستگاری	xɒːsteɡɒːɾiː,xvɒːstɡɒːɾiː
خواستگاری کردن	xɒːsteɡɒːɾiːkæɾdæn
خواستی	xɒːstiː
خواستید	xɒːstiːd
خواستیم	xɒːstiːm
خواندن	xɒːndæn,xwɒːndæn
خواننده	xɒːnænde,xwɒːnænde
خواننده زن	xɒːnændejezæn
خواه	xɒːh
خواهد	xɒːhæd
خواهد خواست	xɒːhædxɒːst
خواهر	xɒːhæɾ,xwɒːhæɾ
خواهرخوانده	xwɒːhæɾxwɒːnde
خواهرزاده	xwɒːhæɾzɒːde
خواهرزن	xwɒːhæɾzæn
خواهرشوهر	xwɒːhæɾʃoʊhæɾ
خواهش	xɒːheʃ
خواهش می‌کنم	xwɒːheʃmiːkonæm,xɒːheʃmiːkonæm
خواهش کردن	xɒːheʃkæɾdæn,xɒːheʃkæɾdæn
خواهم	xɒːhæm
خواهم خواست	xɒːhæmxɒːst
خواهند	xɒːhænd
خواهند خواست	xɒːhændxɒːst
خواهنده	xɒːhænde
خواهی	xɒːhiː
خواهی خواست	xɒːhíxɒːst
خواهید	xɒːhiːd
خواهید خواست	xɒːhídxɒːst
خواهیم	xɒːhiːm
خواهیم خواست	xɒːhímxɒːst
خوب	xuːb
خود	xuːd,xod
خود آمدن	xodɒːmædæn
خود آوردن	xodɒːvæɾdæn
خودتراش	xodtæɾɒːʃ
خودداری	xoddɒːɾiː
خودداری کردن	xoddɒːɾiːkæɾdæn
خودرو	xodɾo,xodɾoʊ
خودشویی	xodʃuːjiː
خودمختاری	xodmoxtɒːɾiː
خودنمایی	xodnæmɒːiː
خودنمایی کردن	xodnæmɒːiːkæɾdæn
خودنویس	xodneviːs
خودکار	xodkɒːɾ
خودکشی	xodkoʃiː
خودکشی کردن	xodkoʃiːkæɾdæn
خور	xuːɾ
خوراک سگ	xoɾɒːksæɡ
خوراکی	xoɾɒːkiː
خوردن	xoɾdæn,zædæn
خورشید	xuːɾʃiːd,xoɾʃiːd
خورشیدفش	xuːɾʃiːdfæʃ
خوره	xoɾe
خوروران	xuːɾvæɾɒːn
خوش	xoŝ,xoʃ
خوش آمدی	xoʃɒːmædiː
خوش آمدید	xoʃɒːmædiːd
خوش اومدی	xoʃuːmædiː
خوش اومدین	xoʃuːmædiːn
خوش حال	xoʃhɒːll
خوشبختانه	xuːʃbæxtɒːne
خوشبختی	xoʃʔbàxtiː
خوشبو	xoʃbuː
خوشحال	xoʃhɒːl
خوشمزه	xoʃmæze,xuːʃmæze,xoʃmæzæ
خوشنویس	xoʃneviːs
خوشنویسی	xoʃneviːsiː
خوشه	xuːʃe,xuːʃæ
خوشگلی	xoʃɡeliː
خوش‌شانس	xoʃʃɒːns
خوكچه	xuːkt͡ʃe
خون	xuːn
خون آمدن	xuːnɒːmædæn
خوک	xuːk
خوک خاکی	xuːkexɒːkiː
خوک نر	xuːkenæɾ
خوکچه هندی	xuːkt͡ʃejehendiː
خویشان	xviːʃɒːn
خی	xiː
خیابان	xiːɒːbɒːn,xiːjɒːbɒːn
خیابان زدن	xiːɒːbɒːnzædæn
خیار	xiːjɒːɾ
خیارشور	xiːjɒːɾʃuːɾ
خیاره	xiːjɒːɾe
خیانت	xiːɒːnæt
خیانت کردن	xiːɒːnætkæɾdæn
خیانت‌کار	xiːjɒːnætkɒːɾ
خیر	xejɾ
خیز	xiːz
خیز زدن	xiːzzædæn
خیز گرفتن	xiːzɡeɾeftæn
خیزش	xiːzeŝ
خیس کردن	xiːskæɾdæn
خیساندن	xiːsɒːndæn
خیلی	xejliː,xeiːliː
خیلی زیاد	xejliːziːjɒːd
خیلی ممنون	xejliːmæmnuːn
خیمه	xejme
خین	xiːn
خیّاط	xæjjɒːt
دائرةالمعارف	dɒːʔeɾætolmæʔɒːɾef
دائی	dɒːʔiː
دات‌نت	dɒːtnet
داخل	dɒːxel
داخلی	dɒːxeliː
داد	dɒːd
داد رسیدن	dɒːdɾesiːdæn
داد زدن	dɒːdzædæn,dɒːdzædæn
داد کشیدن	dɒːdkeʃiːdæn
داداش	dɒːdɒːʃ
دادن	oftɒːdæn,dɒːdæn
داده‌ها	dɒːdehɒː
دادگاه	dɒːdɡɒːh
دادگری	dɒːdɡæɾiː
دار	dɒːɾ
دار زدن	dɒːɾzædæn,dɒːɾzædæn
دار کردن	dɒːɾkæɾdæn
دارایی	dɒːɾɒːjiː
داربست	dɒːɾbæst
داربست زدن	dɒːɾbæstzædæn
داربست کشیدن	dɒːɾbæstkeʃiːdæn
دارد می‌خواهد	dɒːɾædmíxɒːhæd
دارم می‌خواهم	dɒːɾæmmíxɒːhæm
دارمشتادیم	dɒːɾmeʃtɒːdiːom
دارند می‌خواهند	dɒːɾændmíxɒːhænd
دارو	dɒːɾuː
دارو کوب	dɒːɾuːkob
دارواش	dɒːɾvɒːʃ
داروخانه	dɒːɾuːxɒːne
داروساز	dɒːɾuːsɒːz
داروسازی	dɒːɾuːsɒːziː
دارکوب	dɒːɾkuːb
داری می‌خواهی	dɒːɾiːmíxɒːhiː
دارید می‌خواهید	dɒːɾiːdmíxɒːhiːd
داریم می‌خواهیم	dɒːɾiːmmíxɒːhiːm
داریوش	dɒːɾjuːʃ
داس	dɒːs
داس و چکش	dɒːsot͡ʃækoʃ
داستان	dɒːstɒːn
داستان کوتاه	dɒːstɒːnekuːtɒːh
داشت می‌خواست	dɒːʃtmíxɒːst
داشتم می‌خواستم	dɒːʃtæmmíxɒːstæm
داشتن	dɒːʃtæn
داشتند می‌خواستند	dɒːʃtændmíxɒːstænd
داشتی می‌خواستی	dɒːʃtiːmíxɒːstiː
داشتید می‌خواستید	dɒːʃtiːdmíxɒːstiːd
داشتیم می‌خواستیم	dɒːʃtiːmmíxɒːstiːm
داغ	dɒːɢ
داغ خوردن	dɒːɢxoɾdæn
داغ زدن	dɒːɢzædæn
داغ کردن	dɒːɢkæɾdæn
داغستان	dɒːɢestɒːn
دال	dɒːl
دال سیاه	dɒːlesiːjɒːh
داماد	dɒːmɒːd
دامن	dɒːmæn
دامن خوردن	dɒːmænxoɾdæn
دامن زدن	dɒːmænzædæn
دامپزشک	dɒːmpezeʃk
دانا	dɒːnɒː
دانایی	dɒːnɒːjiː
دانستن	dɒːnestæn
دانش	dɒːneʃ
دانشجو	dɒːneʃd͡ʒuː
دانشكده	dɒːneʃkæde
دانشمند	dɒːneʃmænd
دانشنامه	dɒːneʃnɒːme
دانشگاه	dɒːneʃɡɒːh
دانش‌آموز	dɒːneʃɒːmuːz
دانمارک	dɒːnmɒːɾk
دانمارکی	dɒːnmɒːɾkiː
دانوب	dɒːnuːb
دایرةالمعارف	dɒːjeɾætolmæʔɒːɾef
دایره	dɒːjeɾe,dɒːjiːɾe
دایره زدن	dɒːjeɾezædæn
دایره کشیدن	dɒːjeɾekeʃiːdæn
دایناسور	dɒːjnɒːsoɾ
دایی	dɒːjiː
دایی‌زاده	dɒːjiːzɒːde
دباغی	dæbbɒːɢiː
دبیر	dæbiːɾ
دخالت	dexɒːlæt
دخالت کردن	dexɒːlætkæɾdæn
دختر	doxtæɾ
دختر باز	doxtæɾebɒːz
دختر برادر	doxtæɾebæɾɒːdæɾ
دختر خانم	doxtæɾxɒːnom
دختر خواهر	doxtæɾexwɒːhæɾ
دخترخاله	doxtæɾxɒːle
دخترخوانده	doxtæɾxwɒːnde
دختردائی	doxtæɾdɒːʔiː
دختردایی	doxtæɾdɒːjiː
دخترعمه	doxtæɾʔæmme,doxtæɾæmme
دخترعمو	doxtæɾʔæmuː,doxtæɾæmuː
دخپسر	doxpesæɾ
دخیل	dæxiːl
در	dæɾ
در حال	dæɾhɒːle
در راه	dæɾɾɒːh
در زدن	dæɾzædæn,dæɾzædæn
در زمان	dæɾzæmɒːne
در سمت راست	dæɾsemetɾɒːst
در سمت چپ	dæɾsemett͡ʃæp
در غیر این صورت	dæɾɢejɾeiːnsuːɾæt
در منزل	dæɾmænzel
در میان	dæɾmiːjɒːne
درآمد	dæɾɒːmæd
درآمدن	dæɾɒːmædæn
درآوردن	dæɾɒːvæɾdæn
دراز	deɾɒːz
درازا	deɾɒːzɒː
درایه	dæɾɒːje
دراییدن	dæɾɒːjiːdæn
دربارۀ	dæɾbɒːɾeje
دربند کردن	dæɾbændkæɾdæn
دربی	deɾbiː
درجا	dæɾd͡ʒɒː
درجا زدن	dæɾd͡ʒɒːzædæn
درجه	dæɾæd͡ʒe
درخت	deɾæxt,dæɾæxt
درخت آزاد	deɾæxteɒːzɒːd
درخت نارنج	deɾæxtenɒːɾend͡ʒ
درخشان	dɾæxʃɒːn,deɾæxʃɒːn
درخواست دادن	dæɾxɒːstdɒːdæn
درخواستن	dæɾxɒːstæn
درد	dæɾd
درد آمدن	dæɾdɒːmædæn
درد آوردن	dæɾdɒːvæɾdæn
درد خوردن	dæɾdxoɾdæn
درد دل	dæɾdedel
درد دل کردن	kæɾdæn
درد کردن	dæɾdkæɾdæn
درد کشیدن	dæɾdkeʃiːdæn
درد گرفتن	dæɾdɡeɾeftæn
دردسر	dæɾdesæɾ
درز	dæɾz
درز کردن	dæɾzkæɾdæn
درز گرفتن	dæɾzɡeɾeftæn
درزی	dæɾziː
درس	dæɾs
درس خواندن	dæɾsxɒːndæn
درس دادن	dæɾsdɒːdæn,dæɾsdɒːdæn
درست	doɾost
درست کردن	doɾostkæɾdæn
درستکار	doɾostkɒːɾ
درستی	doɾostiː
درستی سنجی	doɾostiːsænd͡ʒiː
درصد	dæɾsæd
درمان	dæɾmɒːn
درمانگاه	dæɾmɒːnɡɒːhʔ
درنهایت	dæɾnæhɒːjæt
درنگ	deɾænɡ,dɾænɡ
درنگ كردن	dɾænɡkæɾdæn
درنگ کردن	deɾænɡkæɾdæn
دره	dæɾe,dæɾɾe
درود	doɾuːd
درودن	dɾuːdæn,doɾuːdæn
درودگر	doɾuːdɡæɾ
دروغ	doɾuːɢ
دروغ گفتن	doɾuːɢɡoftæn,doɾuːɢɡoftæn
درون	dæɾuːn
درونی	dæɾuːniː
درویدن	dɾæviːdæn
درویش	dæɾviːʃ
درک	dæɾk
درک کردن	dæɾkkæɾdæn
درگاه	dæɾɡɒːh
درگذشتن	dæɾɡozæʃtæn
درگر	doɾɡæɾ
درگوشی	dæɾeɡuːʃiː
دری	dæɾiː
دریا	dæɾjɒː
دریا زدن	dæɾjɒːzædæn
دریافت کردن	dæɾjɒːftkæɾdæn
دریاچه	dæɾjɒːt͡ʃe
دریاچه ارومیه	dæɾjɒːt͡ʃeeoɾuːmiːje
دریاچه خوارزم	dæɾjɒːt͡ʃeexoɾæzm
دریاچهٔ مازندران	dæɾjɒːt͡ʃejiːmɒːzændæɾɒːn
دریاچه‌های بزرگ	dæɾjɒːt͡ʃehɒːjebozoɾɡ
دریاکنار	dæɾjɒːkenɒːɾ
دریای خزر	dæɾjɒːjexæzæɾ
دریای سفید	dæɾjɒːjesæfiːd
دریای سیاه	dæɾjɒːjesiːjɒːh
دریای عرب	dæɾjɒːjeʔæɾæb
دریای مازندران	dæɾjɒːjemæzændæɾɒːn,dæɾjɒːjemɒːzændæɾɒːn
دریای ژاپن	dæɾjɒːjeʒɒːpon
دریغ	dæɾiːɢ
دریغ کردن	dæɾiːɢkæɾdæn
دزد	dozd
دزد زدن	dozdzædæn
دزدی	dozdiː
دزدی کردن	dozdiːkæɾdæn
دزدیدن	dozdiːdæn
دسامبر	desɒːmbɾ
دست	dæst
دست آمدن	dæstɒːmædæn
دست آوردن	dæstɒːvæɾdæn
دست اره	dæstæɾɾe
دست خوردن	dæstxoɾdæn
دست دادن	dæstdɒːdæn
دست زدن	dæstzædæn,dæstzædæn
دست نخورده	dɒːstnæxoɾde
دست و پا	dæstopɒː
دست و پا زدن	dæstopɒːzædæn
دست و پا کردن	dæstopɒːkæɾdæn
دست کشیدن	dæstkæʃiːdæn,dæstkeʃiːdæn
دست کم گرفتن	dæstekæmɡeɾeftæn
دستار	dæstɒːɾ
دستاورد	dæstɒːvæɾd
دستبرد	dæstboɾd
دستبرد زدن	dæstboɾdzædæn
دستبند	dæstbænd
دستبند خوردن	dæstbændxoɾdæn
دستبند زدن	dæstbændzædæn
دستره	dæstæɾe
دستشویی	dæstʃuːtiː
دستمال	dæstmɒːl
دستمال کشیدن	dæstmɒːlkeʃiːdæn
دسته	dæste,dæstæ
دسته پزندگان	dæstejepæɾændeɡɒːn
دستور	dæstuːɾ
دستور دادن	dæstuːɾdɒːdæn
دستور زبان	dæstuːɾezæbɒːn
دستور گرفتن	dæstuːɾɡeɾeftæn
دستکش	dæstkeʃ
دستگاه	dæstɡɒːh
دستگاه تناسلی	dæstɡɒːhetænɒːsoliː
دست‌خط	dæstxæt
دست‌مزد	dăstmozd
دست‌نوشته	dæstneveʃte
دست‌نویس	dæstneviːs
دست‌نویسی	dæstneviːsiː
دسر	deseɾ
دشت	dæʃt
دشت زدن	dæʃtzædæn
دشمن	doʃmæn
دشمنی	doʃmæniː
دشنام	doʃnɒːm
دشنام دادن	doʃnɒːmdɒːdæn
دشوار	doʃvɒːɾ
دعا	doʔɒː
دعا کردن	doʔɒːkæɾdæn,doʔɒːkæɾdæn
دعوا	dæʔvɒː
دعوا شدن	dæʔvɒːʃodæn
دعوا کردن	dæʔvɒːkæɾdæn
دعوت	dæʔvæt
دعوت داشتن	dæʔvætdɒːʃtæn
دعوت كردن	dævætkæɾdæn
دعوت کردن	dæʔvætkæɾdæn
دفاع	defɒːʔ
دفاع کردن	defɒːʔkæɾdæn
دفتر	dæftæɾ
دفترچه	dæftæɾt͡ʃe
دفن	dæfn
دفن کردن	dæfnkæɾdæn,dæfnkæɾdæn
دق	deɢ
دق آمدن	deɢɒːmædæn
دق آوردن	deɢɒːvæɾdæn
دق کردن	deɢkæɾdæn
دقیق	dæɢiːɢ
دقیقه	dæɢiːɢe
دكان نانوائی	dokɒːnnɒːnevɒːʔiː
دل	del
دل سوختن	delsuːxtæn
دلار	dolɒːɾ
دلارام	delɒːɾɒːm
دلبر	delbæɾ
دلداده	deldɒːde
دلدار	deldɒːɾ
دلدرد	deldæɾd
دلدرد زدن	deldæɾdzædæn
دلربا	delɾobɒː
دلشوره	delʃuːɾe
دلشوره گرفتن	delʃuːɾeɡeɾeftæn
دلفریب	delfæɾiːb
دلفین	dolfiːn
دلنواز	delnævɒːz
دلو	dæluː
دلپذیر	delpæziːɾ
دلکش	delkæʃ
دم	dæm,dom
دم زدن	dæmzædæn
دم گرفتن	dæmɡeɾeftæn
دمار	dæmɒːɾ
دماغ	dæmɒːɢ
دماغ گرفتن	dæmɒːɢɡeɾeftæn
دمبل	dæmbel
دمبل زدن	dæmbelzædæn
دمشق	demeʃɢ
دموکراتیک	demokɾɒːtiːk
دموکراسی	demuːkɾɒːsiː
دم‌جنبانک	domd͡ʒombɒːnæk
دنبال	donbɒːl
دنبال کردن	donbɒːlkæɾdæn,donbɒːlkæɾdæn
دنبال گشتن	donbɒːlɡæʃtæn,donbɒːlɡæʃtæn
دندان	dændɒːn
دندان زدن	dændɒːnzædæn
دندان پزشکی	dændɒːnpezeʃkiː
دندانساز	dændɒːnsɒːz
دندان‌پزشک	dændɒːnpezeʃk
دنده	dænde
دنگ	donɡ
دنیا	donjɒː
دنیا آمدن	donjɒːɒːmædæn
دنیا آوردن	donjɒːɒːvæɾdæn
ده	de,dæh
دهان	dæhɒːn
دهانه	dæhɒːne
دهانی	dæhɒːniː
دهدهی	dæhdæhiː
دهلی	dehliː
دهلی نو	dehliːnouː
دهم	dæhom
دهن	dæhæn
دهن  دهان	dæhæn
دهن  دهان خوردن	dæhænxoɾdæn
دهن  دهان زدن	dæhænzædæn
دهه	dæhe
دو	do
دو زار	dozɒːɾ
دو زار و ده شاهی	dozɒːɾodæhʃɒːhiː
دو زدن	dozædæn
دو زن داری	dôzændɒːɾiː
دوات	dævɒːt
دوازده	dævɒːzdæh
دوباره	dobɒːɾe
دوباره!	dobɒːɾe
دوبالان	dobɒːlɒːn
دوجنسه	dod͡ʒense
دوجین	dod͡ʒiːn
دوحه	duːhe
دوختن	duːxtæn
دود	duːd
دود زدن	duːdzædæn
دود کردن	duːdkæɾdæn
دودمانه	duːdmɒːne
دودوئی	dodoiː
دودویی	dodojiː
دور	doʊɾ,duːɾ,douːɾ
دور انداختن	duːɾændɒːxtæn
دور زدن	doʊɾzædæn,doʊɾzædæn
دور گرفتن	doʊɾɡeɾeftæn
دوران طلایی	doɾɒːntælæʔeiː
دوربین	duːɾbiːn
دوربین دیجیتال	duːɾbiːnediːd͡ʒiːtɒːl
دورنگار	doɾneɡɒːɾ
دورنگاریدن	duːɾneɡɒːɾiːdæn
دوره	douːɾe,doɾæ,doɾe
دورواژ	duːɾvɒːʒ
دورواژیدن	duːɾvɒːʒiːdæn
دوریان	duːɾiːɒːn
دوزخ	duːzæx
دوست	duːst
دوست داشتن	duːstdɒːʃtæn,duːstdɒːʃtæn
دوست مکاتبه‌ای	dostemokɒːtebeɒːjiː
دوستدار	duːstdɒːɾ
دوستی	duːstiː
دوستی کردن	duːstiːkæɾdæn
دوست‌دختر	duːstdoxtæɾ
دوست‌پسر	duːstpesæɾ
دوسره	dosæɾe
دوش	duːʃ
دوش گرفتن	duːʃɡeɾeftæn
دوشس	duːʃes
دوشنبه	doʃænbe,doʃæmbe
دوشیدن	duːʃiːdæn
دوشیزه	douːʃiːze,duːʃiːze
دولت	douːlæt,doʊlæt
دولت اسرائیل	douːlæteesɾɒːʔiːl
دوم	dovvom
دون ژوان	donʒovɒːn
دوناگری	devænɒːɡæɾiː
دونقطه	donoɢte
دوپیکر	dopejkæɾ
دوچرخه	dot͡ʃæɾxe
دوچرخه‌سوار	dot͡ʃæɾxesævɒːɾ
دوک	duːk
دویدن	dæviːdæn
دویست	deviːst
دينار	diːnɒːɾ
ديوانه	diːvɒːne
دژ	deʒ
دژخیم	doʒxiːm
دکان	dokɒːn,dokkɒːn
دکان زدن	dokkɒːnzædæn
دکتر	doktoɾ
دکتر داروساز	doktoɾedɒːɾuːsɒːz
دکتر زایمان	doktoɾezɒːjemɒːn
دکتر زنان	doktoɾezænɒːn
دکتر کودکان	doktoɾekuːdækɒːn
دکوراسیون	dekoɾɒːsjon
دگربار	deɡæɾbɒːɾ
دگرجنس‌گرایی	deɡæɾd͡ʒensɡæɾɒːjiː
دگرگونی	deɡæɾɡuːniː
دگمه	doɡmæ,doɡme
دی	dej
دیابت	diːjɒːbet
دیباچه	diːbɒːt͡ʃe
دید	diːd
دید زدن	diːdzædæn
دیدار کردن	diːdɒːɾkæɾdæn
دیدبانی دادن	diːdebɒːniːdɒːdæn
دیدن	diːdæn
دیده‌بان	diːdebɒːn
دیر	dejɾ,diːɾ
دیرتر	diːɾtæɾ
دیروز	diːɾuːz
دیروز صبح	diːɾuːzsobh
دیروز غروب	diːɾuːzɢoɾuːb
دیرکرد	diːɾkæɾd
دیرین	diːɾiːn
دیسال	diːsɒːl
دیسک سخت	diːskesæxt
دیشب	diːʃæb
دین	diːn
دیوار	diːvɒːɾ
دیوان	diːvɒːn
دیوانه	diːvɒːne
دیوانگی	diːvɒːneɡiː
دیوانگی زدن	diːvɒːneɡiːzædæn
دیپلماسی	diːplomɒːsiː
دیکتاتور	diːktɒːtoɾ
دیکتاتوری	diːktɒːtuːɾiː
دیگ	dîɡ,diːɡ
دیگ به دیگ می‌گه روت سیاه	diːɡbediːɡmiːɡeɾuːtsiːjɒːh
دیگر	diːɡæɾ
ذات	zɒːt
ذرت	dhoɾæt,zoɾɾæt
ذره‌بین	zæɾɾebiːn
ذهن	zehn
ذهنیت	zehniːjjæt
ذوق	zoʊɢ
ذوق زدن	zoʊɢzædæn
رآکتور هسته‌ای	ɾeɒːktoɾehæsteʔiː
رأی	ɾɒːʔiː
رئیس جمهور	ɾæʔiːsed͡ʒomhuːɾ
رابین‌هود	ɾɒːbjnhuːd
راجا	ɾɒːd͡ʒɒː
راجع به	ɾɒːd͡ʒeʔbe
راحت	ɾɒːhæt
راحت‌الحلقوم	ɾɒːhætelholɢuːm
راد	ɾɒːd
رادون	ɾɒːdon
راديوم	ɾɒːdiːjuːm
رادیو	ɾɒːdiːo
راز	ɾɒːz
رازآميز	ɾɒːzɒːmiːz
راست	ɾɒːst
راست‌گرا	ɾɒːstɡæɾɒː
راش	ɾɒːʃ
رافائل	ɾɒːfɒːʔel
رامن	ɾɒːmen
رامنی	ɾɒːmniː
رامی	ɾɒːmiː
رامی زدن	ɾɒːmiːzædæn
ران	ɾɒːn
راندن	ɾɒːndæn
راننده	ɾɒːnænde
راه	ɾɒːh
راه ابریشم	ɾɒːheæbɾiːʃæm
راه افتادن	ɾɒːhoftɒːdæn
راه انداختن	ɾɒːhændɒːxtæn
راه رسیدن	ɾɒːhɾesiːdæn
راه شاهی	ɾɒːheʃɒːhiː
راه شیری	ɾɒːheʃiːɾiː
راه یافتن	ɾɒːhjɒːftæn
راهب	ɾɒːheb
راهبرد	ɾɒːhboɾd
راهرو	ɾɒːhɾo
راه‌آهن	ɾɒːhɒːhæn
راولپندی	ɾɒːvɒːlpendiː
راک اند رول	ɾɒːkɒːndɾol
راگبی	ɾɒːɡbiː
رایانامه	ɾɒːjɒːnɒːme
رایانه	ɾɒːjɒːne
رایج	ɾɒːjed͡ʒ
رایگان	ɾɒːjɡɒːn
ربع	ɾobʔ
ربه‌کا	ɾebekɒː
رتیل	ɾotejl
رجم	ɾæd͡ʒm
رحم	ɾæhem,ɾæhm
رحم آمدن	ɾæhmɒːmædæn
رحم آوردن	ɾæhmɒːvæɾdæn
رحم کردن	ɾæhmkæɾdæn
رحم گرفتن	ɾæhmɡeɾeftæn
رحمت	ɾæhmæt
رحمت آوردن	ɾæhmætɒːvæɾdæn
رحمت کردن	ɾæhmætkæɾdæn
رخ	ɾox
رختخواب	ɾæxtexɒːb
رخسار	ɾoxsɒːɾ
رد	ɾæd
رد شدن	ɾædʃodæn
رد و بدل	ɾædobædæl
رد و بدل شدن	ɾædobædælʃodæn
رد و بدل کردن	ɾædobædælkæɾdæn
رد کردن	ɾædkæɾdæn
رده بندی	ɾædebændiː
رده‌بندی	ɾædebændiː
رزرو کردن	ɾezeɾvkæɾdæn
رزیدن	ɾæziːdæn
رساندن	ɾesɒːndæn
رسانه	ɾesɒːne,ɾæsɒːne
رسانه گروهی	ɾesɒːneʔjeɡoɾuːhiːʔ,ɾæsɒːneʔjeɡoɾuːhiːʔ
رسانه‌های گروهی	ɾæsɒːnehɒːjeɡoɾuːhiː
رستاخیز	ɾæstɒːxiːz
رستاخیز شدن	ɾæstɒːxiːzŝodæn
رستوران	ɾestoɾɒːn
رستگاری	ɾæstɡɒːɾiː
رسم	ɾæsm
رسم کردن	ɾæsmkæɾdæn
رسیدن	ɾæsiːdæn,ɾesiːdæn,ræsiːdæːn
رسیدگی	ɾesiːdeɡiː
رسیدگی کردن	ɾesiːdeɡiːkæɾdæn
رشته	ɾeʃte
رشک	ɾæʃk
رشک ورزیدن	ɾæʃkvæɾziːdæn
رضایت	ɾezɒːjæt
رضایت دادن	ɾezɒːjætdɒːdæn
رعد	ɾæʔd
رعد زدن	ɾæʔdzædæn
رغبت	ɾeɢbæt
رغبت کردن	ɾeɢbætkæɾdæn
رف	ɾæf
رفتن	ɾæftæn,ɾoftæn
رفیق	ɾæfiːɢ
رقاص	ɾæɢɢɒːs
رقص	ɾæɢs
رقص باله	ɾæɢsebɒːle
رقص عربی	ɾæɢsʔæɾæbiː
رقص کردن	ɾæɢskæɾdæn
رقصیدن	ɾæɢsiːdæn
رقم	ɾæɢæm
رقّاص	ɾæɢɢɒːs
رقیب	ɾæɢiːb
رم	ɾom,ɾæm
رم دادن	ɾæmdɒːdæn
رم کردن	ɾæmkæɾdæn
رمان	ɾomɒːn
رمزنگاری	ɾæmzneɡɒːɾiː
رمزگذاری	ɾæmzɡozɒːɾiː
رمضان	ɾæmæzɒːn
رنج	ɾænd͡ʒ
رنج بردن	ɾænd͡ʒboɾdæn
رنج دادن	ɾænd͡ʒdɒːdæn
رنج کشیدن	ɾænd͡ʒkeʃiːdæn
رنده	ɾænde
رنسانس	ɾonesɒːns
رنگ	ɾænɡ
رنگ زدن	ɾænɡzædæn
رنگ زیتونی	ɾænɡzæiːtuːniː
رنگ صورتی	ɾænɡsuːɾætiː
رنگ کردن	ɾænɡkæɾdæn,ɾænɡkæɾdæn
رنگارنگ	ɾænɡɒːɾænɡ
رنگین	ɾænɡiːn
رنگین‌کمان	ɾænɡiːnkæmɒːn
رها	ɾæhɒː
رها کردن	ɾæhɒːkæɾdæn
رهبر	ɾæhbæɾ
رهبر ارکستر	ɾæhbæɾeoɾkestɾ
رهبر جامعه اسلامی	ɾæhbæɾed͡ʒɒːmeʔejeeslæmiː
رو به راه	ɾuːbeɾɒːh
رو پوشانی	ɾuːpuːʃɒːniː
رواج	ɾævɒːd͡ʒ
رواج دادن	ɾævɒːd͡ʒdɒːdæn
رواج یافتن	ɾævɒːd͡ʒjɒːftæn
روادید	ɾævɒːdiːd
روان	ɾævɒːn
روان شناس	ɾævɒːnʃenɒːs
روان پزشک	ɾævɒːnʔpezeʃkʔ
روانکاو	ɾævɒːnʔkɒːv
روان‌شناس	ɾævɒːnʃenɒːs
روان‌شناسی	ɾævɒːnʃenɒːsiː
روان‌نویس	ɾævɒːnneviːs
روايت	ɾævɒːjæt
روايت کردن	ɾævɒːjætkæɾdæn
روایت	ɾævɒːjæt
روایت شدن	ɾævɒːjætʃodæn
روباه	ɾuːbɒːh
روبل	ɾuːbl
روبنده	ɾuːbænde
روتیل	ɾuːtiːl
روح	ɾuːh
رود	ɾuːd
رودخانه	ɾuːdxɒːne
رودخونه	ɾuːdxuːne
رودست	ɾuːdæst
رودست خوردن	ɾuːdæstxoɾdæn
رودست زدن	ɾuːdæstzædæn
روده	ɾuːde
روز	ɾuːz
روز بخیر	ɾuːzbexejɾ
روز شکرگزاری	ɾuːzeʃokɾɡozɒːɾiː
روز پیروزی	ɾuːzepiːɾuːziː
روزانه	ɾuːzɒːne
روزنامه	ɾuːznɒːme
روزنامه‌نگار	ɾuːznɒːmeneɡɒːɾ
روزنامه‌نگاری	ɾuːznɒːmeneɡɒːɾiː
روزه	ɾozæ,ɾuːze
روزه گرفتن	ɾuːzeɡeɾeftæn
روزی از روزها	ɾuːziːæzɾuːzhɒː
روزی روزگاری	ɾuːziːɾuːzeɡɒːɾiː
روس	ɾuːs
روستا	ɾuːstɒː
روستایی	ɾuːstɒːjiː,ɾuːstɒːʔiː
روسری	ɾuːsæɾiː
روسپی‌خانه	ɾuːspiːxɒːne
روسپی‌گری	ɾuːspiːɡæɾiː
روسی	ɾuːsiː
روسیه	ɾuːsiːje
روسیه سفید	ɾuːsiːjejesefiːd
روش	ɾæveʃ
روش علمی	ɾæveʃeelmiː
روشن	ɾoʊʃæn,ɾouːʃæn,ɾoŝæn,ɾoʃæn
روشن کردن	ɾoʊʃænkæɾdæn
روشنا	ɾoʊʃænɒː
روشنک	ɾoʊʃænæk
روشنگری	ɾoʃænɡæɾiː
روغن	ɾoʊɢæn,ɾuːɢæn
روغن زدن	ɾoʊɢænzædæn
رولت روسی	ɾuːletɾuːsiː
روم	ɾuːm
رومانی	ɾuːmɒːniː
رومانیایی	ɾuːmɒːniːjɒːjiː
رومانیکا	ɾuːmɒːniːkɒː
رومنی	ɾuːmniː
رومی	ɾuːmiː
روندن	ɾuːndæn
رونوشت	ɾuːneveʃt
رونویسی	ɾuːneviːsiː
روی	ɾuːj
روی سخته	ɾuːjsæxte
رویارویی	ɾuːjɒːɾuːʔiː
رویه	ɾuːjæ
رژ لب	ɾoʒelæb
رژیم	ɾeʒiːm
رکاب	ɾekɒːb
رکاب زدن	ɾekɒːbzædæn
رکسانه	ɾoksɒːne
رکيک	ɾækiːk
رگ	ɾæɡ
رگ زدن	ɾæɡzædæn
ریاضی	ɾiːjɒːziː
ریال	ɾiːɒːl
ریتم	ɾiːtm
ریختن	ɾiːxtæn
ریدن	ɾiːdæn
ریز	ɾiːz
ریزبین	ɾiːzbiːn
ریش	ɾiːʃ
ریش زدن	ɾiːʃzædæn
ریشه	ɾiːʃæ,ɾiːʃe
ریشه زدن	ɾiːʃezædæn
ریشه‌شناسی	ɾiːʃeʃenɒːsiː
ریمل	ɾiːmel
ریمل زدن	ɾiːmelzædæn
ریه	ɾiːje
ریچارد	ɾiːt͡ʃɒːɾd
ریگ	ɾiːɡ
زئوس	zeuːs
زائر	zɒːʔeɾ
زادگاه	zɒːdɡɒːh
زار	zɒːɾ
زار زدن	zɒːɾzædæn
زاری	zɒːɾiː
زاری کردن	zɒːɾiːkæɾdæn
زازاکی	zɒːzɒːkiː
زاغ	zɒːɢ
زالتسبورگ	zɒːlsbuːɾɡ
زالو	zɒːluː
زانو	zɒːnuː
زانو زدن	zɒːnuːzædæn
زاگرب	zɒːɡɾeb
زاگرس	zɒːɡɾos
زاییدن	zɒːjiːdæn
زبان	zæbɒːn
زبان آبخازی	zæbɒːnɒːbxɒːziː
زبان آفریکانز	zæbæneɒːfɾiːkɒːnz
زبان آفریکانس	zæbɒːneɒːfɾiːkɒːns
زبان آمدن	zæbɒːnɒːmædæn
زبان آوردن	zæbɒːnɒːvæɾdæn
زبان انگلیسی	zæbɒːneenɡeliːsiː
زبان اودی	zæbɒːnuːdiː
زبان برمه‌ای	zæbɒːnebeɾmeʔɒːjiː
زبان بلوچی	zæmɒːnebæluːt͡ʃiː
زبان تاجیکی	zæbɒːnetɒːd͡ʒiːkiː
زبان تامیل	zæbɒːnetɒːmiːl
زبان خارجی	zæbɒːnexɒːɾed͡ʒiː
زبان خمر	zæbɒːnexæmeɾ
زبان دیوهی	zæbɒːndiːvehiː
زبان روسی	zæbɒːneɾuːsiː
زبان زدن	zæbɒːnzædæn
زبان سانسکریت	zæbɒːnesɒːnskɾiːt
زبان طبیعی	zæmɒːnetæbiːʔiː
زبان فارسی	zæbɒːnefɒːɾsiː
زبان قرقیزی	zæbɒːneɢiːɾɢiːziː
زبان قزاقی	zæbɒːneɢæzɒːɢiː
زبان لاتین	zæbɒːnelɒːtiːn
زبان مادری	zæbɒːnemɒːdæɾiː
زبان ماشین	zæbɒːnemæʃiːn
زبان مالایی	zæbɒːnemɒːlɒːjiː
زبان میانجی	zæbɒːnemiːjɒːnd͡ʒiː
زبان پالائی	zæbɒːnepɒːlɒːʔiː
زبان چینی	zæbɒːnet͡ʃiːniː
زبان ژاپنی	zæbɒːneʒɒːponiː
زبان کانارا	zæbɒːnkænæɾæ
زبان کشیدن	zæbɒːnkeʃiːdæn
زبانه	zæbɒːne
زبانه زدن	zæbɒːnezædæn
زبانه کشیدن	zæbɒːnekeʃiːdæn
زبان‌ برنامه‌نویسی	zæbɒːnebæɾnɒːmeneviːsiː
زبان‌شناس	zæbɒːnʃenæs
زبان‌شناسی	zæbɒːnʃenɒːsiː
زبر	zæbæɾ,zebæɾ
زبردستی	zebæɾdæstiː
زتا	zetɒː
زجر	zæd͡ʒɾ
زجر دادن	zæd͡ʒɾdɒːdæn
زجر کشیدن	zæd͡ʒɾkeʃiːdæn
زحل	zohæl
زحمت	zæhmæt
زحمت افتادن	zæhmætoftɒːdæn
زحمت کشیدن	zæhmætkeʃiːdæn
زخم	zæxm
زخم خوردن	zæxmxoɾdæn
زخم زبان	zæxmezæbɒːn
زخم زبان زدن	zæxmezæbɒːnzædæn
زخم زدن	zæxmzædæn
زخمه	zæxme
زخمی	zæxmiː
زدن	zædæn
زدودن	zoduːdæn
زر	zeɾ,zæɾ
زر زدن	zeɾzædæn
زرافه	zæɾɾɒːfe
زرتشتی	zæɾtoʃtiː
زرد	zæɾd
زرد معتدل	zæɾdemoʔtædel
زرد چوبه	zæɾdt͡ʃuːbe
زرد چوبه زدن	zæɾdt͡ʃuːbezædæn
زردآلو	zæɾdɒːluː
زردچوبه	zæɾdt͡ʃuːbe
زرشک	zeɾeʃk
زرشکی	zeɾeʃkiː
زرّافه	zæɾɾɒːfe
زرین	zæɾɾiːn,zæɾiːn
زشت	zeʃt
زعفران	zæʔfeɾɒːn
زعفرانی	zæʔfeɾɒːniː
زغن	zæɢæn
زق	zeɢ
زق زدن	zeɢzædæn
زل	zol
زل زدن	zolzædæn
زلاند جدید	zelɒːnded͡ʒædiːd
زلاند نو	zelɒːndenouː
زلزله	zelzele
زلزله‌شناسی	zelzeleʃenɒːsiː
زلکوا	zelkovɒː
زمان	zæmɒːn
زمانی که	zæmɒːniːke
زمرد	zomoɾɾod
زمردی	zomoɾɾodiː
زمزمه	zemzeme
زمزمه کردن	zemzemekæɾdæn
زمستان	zemestɒːn
زمین	zæmiːn
زمین خوردن	zæmiːnxoɾdæn
زمین زدن	zæmiːnzædæn
زمینی‌سازی	zæmiːniːsɒːziː
زمین‌شناسی	zæmiːnʃiːnɒːsiː,zæmiːnʃenɒːsiː
زمین‌لرزه	zæmiːnelæɾze
زن	zæn
زن دادن	zændɒːdæn
زن کثیف	zænkæsîf
زن کردن	zænkæɾdæn
زن گرفتن	zænɡeɾeftæn
زناشويي	zænɒːʃuːeiː
زنانگی	zænɒːneɡiː
زنبق	zæmbæɢ
زنبور	zænbuːɾ
زنبور زدن	zænbuːɾzædæn
زنبور عسل	zænbuːɾeʔæsæl,zænbuːɾeæsæl
زنبورک	zænbuːɾæk
زنجبیل	zænd͡ʒebiːl
زنجیر	zænd͡ʒiːɾ
زنجیر زدن	zænd͡ʒiːɾzædæn
زنجیر کردن	zænd͡ʒiːɾkæɾdæn
زندانی	zendɒːní
زندانی کردن	zendɒːniːkæɾdæn
زنده	zendæ,zende
زندگی	zendeɡiː,zendæɡiː
زندگی کردن	zendeɡiːkæɾdæn,zendeɡiːkæɾdæn
زنگ	zænɡ
زنگ خوردن	zænɡxoɾdæn
زنگ زدن	zænɡzædæn,zænɡzædæn
زنگبار	zænɡebɒːɾ
زنگی	zænɡiː
زنی	zæniː
زنی گرفتن	zæniːɡeɾeftæn
زن‌بابا	zænbɒːbɒː
زن‌دایی	zændɒːjiː
زن‌عمو	zænæmuː
زهر	zæhɾ
زهرخنده	zæhɾxænde
زهرشناسی	zæhɾʃenɒːsiː
زوال عقل	zævɒːleʔæɢl
زود	zuːd
زور	zoʊɾ,zuːɾ
زوزه	zuːze
زوزه زدن	zuːzezædæn
زوزه کشیدن	zuːzekeʃiːdæn
زکام	zokɒːm
زیاد	ziːjɒːd
زیادروی	ziːɒːdeɾæviː
زیادروی کردن	ziːɒːdeɾæviːkæɾdæn
زیان	ziːjɒːn
زیانشانه‌شناسی	ziːɒːneʃæneʃenɒːs
زیبا	ziːbɒː
زیتونی	zejtuːniː
زید	zejd
زیر	ziːɾ
زیر سیگاری	ziːɾsiːɡɒːɾiː
زیر پوشی زن	ziːɾpuːʃiːzæn
زیرآبی	ziːɾɒːbiː
زیرآبی زدن	ziːɾɒːbiːzædæn
زیرا	ziːɾɒː
زیربغل	ziːɾbæɢæl
زیردریایی	ziːɾdæɾjɒːjiː
زیرزمین	ziːɾzæmiːn
زیرشیروانی	ziːɾeʃiːɾvɒːniː
زیرصفحه	ziːɾsæfhe
زیره‌ی سبز	ziːɾejesæbz
زیره‌ی سیاه	ziːɾejesiːjɒːh
زیرک	ziːɾæk
زیست	ziːst
زیستن	ziːstæn
زیست‌شناسی	ziːstʃenɒːsiː
زیست‌شیمی	ziːstʃiːmiː
زین	ziːn
زینت	ziːnæt
زینت دادن	ziːnætdɒːdæn
زیگ	ziːɡ
سؤال	soʔɒːl
سئول	seʔuːl
سائیگون	sɒːiːɡon
ساتراپ	sɒːtɾɒːp
ساتور	sɒːtuːɾ
ساحره	sɒːhæɾe
ساحل	sɒːhel
ساختمان	sɒːxtemɒːn
ساختمون	sɒːxtemuːn
ساختن	sɒːxtæn
ساختگی	sɒːxteɡiː
سادگی	sɒːdeɡiː
سادگی زدن	sɒːdeɡiːzædæn
سارا	sɒːɾɒː
سارایوو	sɒːɾɒːjevo
ساروج	sɒːɾuːd͡ʒ
ساری	sɒːɾiː
ساز	sɒːz
ساز زدن	sɒːzzædæn
سازدهنی	sɒːzdæhæniː
سازدهنی زدن	sɒːzdæhæniːzædæn
سازش	sɒːzeʃ
سازمان	sɒːzmɒːn
سازمان ملل متّحد	sɒːzmɒːnemelælemottæhed
سازه	sɒːze,sɒːzæ
سازواره	sɒːzvɒːɾe
ساس	sɒːs
ساعت	sɒːæt,sɒːʔæt
ساعت یک	sɒːʔætjek
ساعت یک و ربع	sɒːʔætjekoɾobʔ
ساعت یک و نیم	sɒːʔætjekoniːm
ساعد	sɒːed
ساق	sɒːɢ
ساكت	sɒːket
سال	sɒːl
سال آینده	sɒːleɒːjænde
سال نو	sɒːlnouː
سال نوری	sɒːlenuːɾiː
سالار	sɒːlɒːɾ
سالم	sɒːlem
سالن	sɒːlon
سامانه	sɒːmɒːne
سامانه خورشیدی	sɒːmɒːnexuːɾʃiːdiː
سامانی	sɒːmɒːniː
ساموآ	sɒːmoɒː
سان فرانسیسکو	sɒːnfɾɒːnsiːsko
سانتریفوژ	sɒːntɾiːfuːʒ
سانتو دومینگو	sɒːntodomiːnɡo
ساندویچ	sɒːndeviːt͡ʃ
ساوانا	sɒːvɒːnɒː
ساک زدن	sɒːkzædæn
ساکت شدن	sɒːketʃodæn
ساکسوفون	sɒːksofon
ساکورا	sɒːkuːɾɒː
سایت	sɒːjt
سایت زدن	sɒːjtzædæn
سایه	sɒːje
سایوز	sɒːjuːz
سایگون	sɒːjɡon
سبد	sæbæd
سبز	sæbz
سبزآبی	sæbzæbiː
سبزه	sæbze
سبزی	sæbziː
سبزینه	sebziːne
سبقت	sebɢæt
سبقت گرفتن	sebɢætɡeɾeftæn
سبک	sæbok
سبیل	sebiːl
ست	set
ستاد	setɒːd
ستادن	setɒːdæn
ستاره	setɒːɾe
ستاره داوود	setɒːɾejedævuːd
ستاره دریایی	siːtɒːɾejedæɾjɒːjiː
ستاره سینما	setɒːɾejesiːnæmɒː,setɒːɾejesiːnæmɒː
ستاره‌شناس	setɒːɾeʃenɒːs
ستاره‌ی دریایی	setɒːɾejedæɾjɒːjiː
ستارک	sejɒːɾæk
ستایش	setɒːjeʃ
ستخوان	sotxɒːn
ستوان	sotvɒːn
ستون	sotuːn
سخت	sæxt
سخت‌پوست	sæxtpuːst
سخن	soxæn
سخن گفتن	soxænɡoftæn
سخنرانی	soxænɾɒːniː
سد	sæd
سد زدن	sædzædæn
سد کشیدن	sædkeʃiːdæn
سداب	sodɒːb
سده	sæde
سر	sæɾ,seɾ,soɾ
سر خوردن	soɾxoɾdæn
سر دادن	soɾdɒːdæn
سر درآوردن	sæɾdæɾɒːvæɾdæn
سر رفتن	sæɾɾæftæn
سر زدن	sæɾzædæn
سر سخت	sæɾsæxt
سر کشیدن	sæɾkeʃiːdæn
سر کیر	sæɾekiːɾ
سر گرفتن	sæɾɡeɾeftæn
سرآشپز	sæɾɒːʃpæz
سراب	sæɾɒːb
سراسر	sæɾɒːsæɾ
سراغ	soɾɒːɢ
سراغ داشتن	soɾɒːɢdɒːʃtæn
سراغ گرفتن	soɾɒːɢɡeɾeftæn
سرانجام	sæɾænd͡ʒɒːm
سرایوو	sæɾɒːjevo
سرب	soɾb
سرباز	sæɾbɒːz
سرباز نیزه‌دار	sæɾbɒːzenejzedɒːɾ
سرجوخه	sæɾd͡ʒuːxe
سرخ	soɾx
سرخابی سیر	soɾxɒːbiːsiːɾ
سرخس	sæɾæxs
سرخواجه	sæɾxɒːd͡ʒe
سرخک	soɾxæk
سرد	sæɾd
سرداب	sæɾdɒːb
سردابه	sæɾdɒːbe
سردبیر	sæɾdæbiːɾ
سردرد	sæɾdæɾd
سرده	sæɾde
سرزمین	sæɾzæmiːn
سرسرا	sæɾsæɾɒː
سرشاخه	sæɾʃɒːxe
سرشیر	sæɾʃiːɾ
سرطان	sæɾætɒːn
سرعت	soɾʔæt
سرعت نور	soɾʔætenuːɾ
سرعت گری	soɾʔɒːtɡɒːɾiː
سرفه	soɾfe
سرفه افتادن	soɾfeoftɒːdæn
سرفه انداختن	soɾfeændɒːxtæn
سرفه کردن	soɾfekæɾdæn,soɾfekæɾdæn
سرفه گرفتن	soɾfeɡeɾeftæn
سرفیدن	soɾfiːdæn
سرم	seɾom
سرم زدن	seɾomzædæn
سرما	sæɾmɒː
سرما خوردن	sæɾmɒːxoɾdæn
سرما زدن	sæɾmɒːzædæn
سرماخوردگی	sæɾmɒːxoɾdeɡiː
سرماخوردگی زدن	sæɾmɒːxoɾdeɡiːzædæn
سرمایه‌گذاری	sæɾmɒːjeɡozɒːɾiː
سرمایه‌گذاری کردن	sæɾmɒːjeɡozɒːɾiːkæɾdæn
سرمه	soɾme
سرمه‌ای	soɾmejiː
سرنا	soɾnɒː
سرنای	soɾnɒːj
سرنیزه	sæɾnejze
سرهنگ	sæɾhænɡ
سرو	sæɾv
سرود ملی	suːɾuːdemelliː
سرودن	soɾuːdæn
سرور	soɾuːɾ,sæɾvæɾ
سرویس	seɾviːs
سرویس زدن	seɾviːszædæn
سرچشمه	sæɾt͡ʃæʃmæ
سرک	sæɾæk
سرک کشیدن	sæɾækkeʃiːdæn
سرکرده	sæɾkæɾde
سرکش	sæɾkeʃ
سرکه	seɾke
سرکوفت	sæɾkuːft
سرکوفت خوردن	sæɾkuːftxoɾdæn
سرکوفت زدن	sæɾkuːftzædæn
سرگرمی	sæɾɡæɾmiː
سریر	sæɾiːɾ
سریم	seɾiːom
سری‌لانکا	sɾiːlɒːnkɒː
سزیم	seziːom
سس	sos
سطح	sætæh
سعی	sæʔj
سعی داشتن	sæʔjdɒːʃtæn
سعی کردن	sæʔjkæɾdæn
سفارت	sefɒːɾæt
سفارتخانه	sefɒːɾætxɒːne
سفارش	sefɒːɾeʃ
سفارش دادن	sefɒːɾeʃdɒːdæn,sefɒːɾeʃdɒːdæn
سفارش کردن	sefɒːɾeʃkæɾdæn
سفت	seft
سفتر	seftæːɾ
سفر	sæfæɾ
سفر به خير	sæfæɾbexeiːɾ
سفر خوش	sæfæɾxoʃ
سفر کردن	sæfæɾkæɾdæn,sæfæɾkæɾdæn
سفید	sefiːd
سفیدار	sæfiːdɒːɾ,sefiːdɒːɾ
سفیر	sefiːɾ
سقرلات	sæɢeɾlɒːt
سقط	seɢt
سقط کردن	seɢtkæɾdæn
سقف	sæɢf
سقلمه	soɢolme
سقلمه زدن	soɢolmezædæn
سقوط	soɢuːt
سقوط کردن	soɢuːtkæɾdæn
سقیط	sæɢiːt
سكوت	sokuːt
سكوت کردن	sokuːtkæɾdæn
سل	sell
سلاح	selɒːh
سلاح هسته‌ای	selɒːhehæsteʔiː
سلام	sælɒːm
سلام دادن	sælɒːmdɒːdæn
سلام دنیا	sælɒːmdonjɒː
سلام علیکم	sælɒːmoælejkom
سلامت	sælɒːmæt
سلطان	soltɒːn
سلطنت	sæltænæt
سلما	sælmɒː
سمارا	sɒːmɒːɾɒː
سمارت‌ فون	smɒːɾtfon
سماق	somɒːɢ
سماور	sæmɒːvæɾ
سمرقند	sæmæɾɢænd
سمفونی	semfuːniː,siːmfuːniː
سمور	sæmuːɾ
سن	senn
سن پترزبورگ	sænpeteɾzbuːɾɡ
سنا	senɒː
سنباده	sombɒːde
سنباده خوردن	sombɒːdexoɾdæn
سنباده زدن	sombɒːdezædæn
سنباده کشیدن	sombɒːdekeʃiːdæn
سنبل	sombol
سنت	sonnæt
سنجاب	sænd͡ʒɒːb
سنجاق	sænd͡ʒɒːɢ
سنجاق زدن	sænd͡ʒɒːɢzædæn
سنجاقک	sænd͡ʒɒːɢæk
سنجش	sænd͡ʒeʃ
سنجه	sænd͡ʒe
سند	sænæd,send
سندی	sendiː
سندیکا	sendiːkɒː
سنقر	sonɢoɾ
سنگ	sænɡ
سنگ آهک	sænɡɒːhæk
سنگ جادو	sænɡed͡ʒɒːduː
سنگ رشید	sænɡeɾæʃiːd
سنگ زدن	sænɡzædæn
سنگال	seneɡɒːl
سنگاپور	senɡɒːpuːɾ
سنگر	sænɡæɾ
سنگسار	sænɡsɒːɾ
سنگین	sænɡiːn
سنگینی	sænɡiːniː
سه	se
سه نفری	senæfæɾiː
سهل	sæhl
سه‌تار	setɒːɾ
سه‌شنبه	seʃænbe
سه‌نقطه	senoɢte
سه‌چهارم‌خط	set͡ʃæhɒːɾomxæt
سه‌گوش	seɡuːʃ
سوئد	suːʔed
سوئز	suːez
سوئیس	suːʔiːs
سواحیلی	swɒːhiːliː
سواری کردن	sævɒːɾiːkæɾdæn
سوت	suːt
سوت زدن	suːtzædæn
سوت کشیدن	suːtkeʃiːdæn
سوختن	suːxtæn
سود	suːd
سود سهام	suːdesæhɒːm
سودان	suːdɒːn
سودان جنوبی	suːdɒːned͡ʒænuːbiː
سودمند	suːdmænd
سورابایا	suːɾɒːbɒːjɒː
سوراخ	suːɾɒːx
سوراخ کس	suːɾɒːxekos
سوراخ کون	suːɾɒːxekuːn
سورانی	soɾɒːniː
سورنای	suːɾnɒːj
سوره	suːɾe
سورپرایز	suːɾpeɾɒːjz
سورینام	suːɾiːnɒːm
سوریه	suːɾiːje
سوزن	suːzæn
سوزن ته‌گرد	suːzænetæhɡeɾd
سوزن زدن	suːzænzædæn
سوزن منگنه	suːzænemænɡæne
سوزوکی	suːzuːkiː
سوسمار	suːsmɒːɾ
سوسن	souːsæn
سوسو	suːsuː
سوسو زدن	suːsuːzædæn
سوسک	suːsk
سوسیالیست	sosiːjɒːliːst
سوسیالیستی	sosiːjɒːliːstiː
سوسیالیسم	sosjɒːliːsm
سوسیس	sosiːs
سوفیه	sofiːje
سوم	som
سومالی	suːmɒːliː
سونامی	suːnɒːmiː
سوهان	soʊhɒːn
سوهان زدن	sohɒːnzædæn
سوهان کردن	sohɒːnkæɾdæn
سوپ	suːp
سوپرمارکت	suːpeɾmɒːɾket
سوچی	sot͡ʃiː
سویا	sojɒː
سویس	suːviːs
سياه	siːɒːh,siːjɒːh
سيمگون	siːmɡuːn
سپاس	sepɒːs
سپاسگزار	sepɒːsɡozɒːɾ
سپاسگزارم	sepɒːsɡozɒːɾæm
سپاسگزاری	sepɒːsɡozɒːɾiː
سپتامبر	septɒːmbɾ
سپر	sepæɾ
سپردن	sepoɾdæn
سپرز	sepoɾz
سپری شدن	sepæɾiːʃodæn
سپس	sepæs
سپهر	sepehɾ
سپوتنیک	spuːtniːk
سپید	sepiːd
سپیدار	sæpiːdɒːɾ,sepiːdɒːɾ
سکس دهنی	seksedæhæniː
سکس مقعدی	seksemæɢʔædiː
سکندر کبیر	eskændæɾkæbiːɾ
سکه	sekke
سکوت	sokuːt
سکون	sokuːn
سگ	sæɡ
سگ آبی	sæɡeɒːbiː
سگدو	sæɡdo
سگدو زدن	sæɡdozædæn
سی	siː
سیا	siːjɒː
سیاتل	sejɒːtæl
سیاره	sejɒːɾe
سیاست	siːjɒːsæt
سیاست‌مدار	siːjɒːsætmædɒːɾ
سیام	sjɒːm
سیاه	siːjɒːh
سیاه خروس	siːjɒːhexoɾuːs
سیاهه	siːɒːhe
سیاه‌زخم	siːjɒːhzæxm
سیاه‌سرفه	siːjɒːhsoɾfe
سیاه‌چاله	siːjɒːht͡ʃɒːle
سیاه‌چاله فضایی	siːjɒːht͡ʃɒːlefæzɒːjiː
سیاه‌کاج	siːɒːhkɒːd͡ʒ
سیب	siːb
سیبریه	siːbeɾiːje
سیب‌زمینی	siːbzæmiːniː
سیب‌زمینی سرخ‌کرده	siːbzæmiːniːjesoɾxkæɾde
سیخ	siːx
سیخ زدن	siːxzædæn
سیخ کردن	siːxkæɾdæn
سیخ کشیدن	siːxkeʃiːdæn
سیخ‌زن	siːxzæn
سید	sejjed
سیر	siːɾ
سیر کوب	sîɾkob
سیرابی	siːɾɒːbiː
سیرک	siːɾk
سیریلیک	siːɾiːliːk
سیزده	siːzdæh
سیستم	siːstem
سیسیل	siːsiːl
سیسیلی	siːsiːliː
سیصد	siːsæd
سیل	sæiːl
سیلی	siːliː
سیلی خوردن	siːliːxoɾdæn
سیلی زدن	siːliːzædæn
سیم	siːm
سیما	siːmɒː
سیمان	siːmɒːn
سیمرغ	siːmoɾɢ
سیمین	siːmiːn
سینما	siːnemɒː
سینه	siːne
سینه زدن	siːnezædæn
سینی	siːniː
سیکتیوکار	siːktiːvkɒːɾ
سیگارت	siːɡɒːɾet
سیگار‌فروش	siːɡɒːɾfoɾuːʃ
سیگما	siːɡmɒː
سی‌دی	siːdiː
شاتل فضایی	ʃɒːtelefæzɒːjiː
شاتوت	ʃɒːtuːt
شاخ	ʃɒːx
شاخ آفریقا	ʃɒːxeæfɾiːɢɒː
شاخ زدن	ʃɒːxzædæn
شاخاب	ʃɒːxɒːb
شاخاب پارس	ʃɒːxɒːbepɒːɾs
شاخص	ʃɒːxes
شاخه	ʃɒːxe
شاد	ŝɒːd
شادکام	ʃɒːdkɒːm
شادی	ʃɒːdiː
شاذ	ʃɒːzz
شاش	ʃɒːʃ
شاشیدن	ʃɒːʃiːdæn
شال	ʃɒːl
شالوده	ʃɒːluːdæ
شالوم	ʃɒːlom,ʃɒːluːm
شالیزار	ʃɒːliːzɒːɾ
شام	ʃɒːm
شامل کردن	ʃɒːmelkæɾdæn
شامه	ʃɒːmme
شامپاین	ʃɒːmpɒːiːn
شامپو	ʃɒːmpuː,ʃæmpuː
شامپو زدن	ʃæmpuːzædæn
شامپو کردن	ʃæmpuːkæɾdæn
شامگاه	ʃɒːmɡɒːh
شانزده	ʃɒːnzdæh
شانه	ʃɒːne
شانه زدن	ʃɒːnezædæn
شانه کردن	ʃɒːnekæɾdæn,ʃɒːnekæɾdæn
شانه کشیدن	ʃɒːnekeʃiːdæn
شانگهای	ʃɒːnɡhɒːiː
شاه	ʃɒːh
شاه مات	ʃɒːhmɒːt
شاهد	ʃɒːhed
شاهدخت	ʃɒːhdoxt
شاهزاده	ʃɒːhzɒːde
شاهزاده‌خانم	ʃɒːhzɒːdexɒːnom
شاهنشاهی	ʃɒːhænʃɒːhiː
شاهنشاهی ایران	ʃɒːhænʃɒːhiːjeiːɾɒːn
شاهوار	ʃɒːhvɒːɾ
شاهکار	ʃɒːhkɒːɾ
شاهین	ʃɒːhiːn
شاه‌اثر	ʃɒːhæsæɾ
شاه‌بلوط	ʃɒːhbæluːt
شاه‌توت	ʃɒːhtuːt
شاه‌دانه	ʃɒːhdɒːne
شاید	ʃɒːjæd
شایع	ʃɒːjeʔ
شب	ʃæb
شبان	ʃobɒːn,ʃæbɒːn
شبانه	ʃæbɒːne
شبح	ʃæbæh
شبنم	ʃæbnæm
شبنم زدن	ʃæbnæmzædæn
شبه‌جزیره	ʃebed͡ʒæziːɾe
شبکیه	ʃæbækiːje
شبیخون	ʃæbiːxuːn
شبیخون زدن	ʃæbiːxuːnzædæn
شبیه	ʃæbiːh
شتر	ʃotoɾ
شتر بیکوهان	ʃotoɾebiːkohɒːn
شترمرغ	ʃotoɾmoɾɢ,ʃotoɾmoɾɢ
شترگاوپلنگ	ʃotoɾɡɒːvpælænɡ
شتک	ʃætæk
شتک زدن	ʃætækzædæn
شجاع	ʃod͡ʒɒːʔ
شجر	ʃæd͡ʒæɾ
شخص	ʃæxs
شخم	ʃoxm
شخم خوردن	ʃoxmxoɾdæn
شخم زدن	ʃoxmzædæn
شخم کردن	ʃoxmkæɾdæn
شدت	ʃeddæt
شدت گرفتن	ʃeddætɡeɾeftæn
شدن	ʃodæn
شراب	ʃæɾɒːb
شرابی	ʃæɾɒːbiː
شربت	ʃæɾbæt
شرط	ʃæɾt
شرق	ʃæɾɢ
شرق تیمور	ʃæɾɢetiːmoɾ
شرقی	ʃæɾɢiː
شرم	ʃæɾm
شروع	ʃoɾuːʔ
شروع کردن	ʃoɾuːʔkæɾdæn,ʃoɾuːʔkæɾdæn
شرکت	ʃeɾkæt
شرکت هواپیمایی	ʃeɾkætehævɒːpejmɒːjiː
شرکت کردن	ʃeɾkætkæɾdæn
شریک	ʃæɾiːk
شست	ʃæst
شستشو	ʃosteʃuː
شستشو دادن	ʃosteʃuːdɒːdæn
شستن	ʃostæn
شستی	ŝæstiː
شش	ʃoʃ,ʃeʃ
ششصد	ʃeʃsæd
ششم	ʃeʃom
شصت	ʃæst
شصت و نه	ʃæstonoh
شطرنج	ʃætɾænd͡ʒ
شطرنج زدن	ʃætɾænd͡ʒzædæn
شعاع	ʃoʔɒːʔ
شعر	ʃʔeɾ
شعله	ʃoʔle,ʃo’le
شعله زدن	ʃo’lezædæn
شعله کشیدن	ʃo’lekeʃiːdæn
شغال	ʃoɢɒːl
شغل	ʃoɢl
شفا	ʃæfɒː
شفا دادن	ʃæfɒːdɒːdæn
شفتالو	ʃæftɒːluː
شق کردن	ʃæɢkæɾdæn
شل	ʃæl
شل زدن	ʃælzædæn
شلاق	ʃællɒːɢ
شلاق خوردن	ʃællɒːɢxoɾdæn
شلاق زدن	ʃællɒːɢzædæn
شلغم	ʃælɢæm
شلوار	ʃælvɒːɾ
شلوغ	ʃoluːɢ
شلیل	ʃæliːl
شلیل.شبرنگ	ʃæliːl.ʃæbɾænɡ
شلیک	ʃeliːk
شلیک کردن	ʃelliːkkæɾdæn,ʃeliːkkæɾdæn
شم ارا	ʃomɒːɾɒː
شما	ʃomɒː
شما را	ʃomɒːɾɒː
شمار	ʃomɒːɾ
شمار آمدن	ʃomɒːɾɒːmædæn
شمار آوردن	ʃomɒːɾɒːvæɾdæn
شمارشگر	ʃomɒːɾeʃɡæɾ
شماره	ʃomɒːɾe
شماره تلفن	ʃomɒːɾejetelefon
شماره گرفتن	ʃomɒːɾeɡeɾeftæn
شماره‌گذاری	ʃomɒːɾeɡozɒːɾiː
شماره‌گذاری شدن	ʃomɒːɾeɡozɒːɾiːʃodæn
شماره‌گذاری کردن	ʃomɒːɾeɡozɒːɾiːkæɾdæn
شمال	ʃomɒːl,ʃæmɒːl,ʃemɒːl
شمال شرقی	ʃæmɒːleʃæɾɢiː,ʃomɒːleʃæɾɢiː
شمال غربی	ʃomɒːleɢæɾbiː,ʃæmɒːleɢæɾbiː
شمالگان	ʃomæleɡɒːn
شمردن	ʃemoɾdæn,ʃomoɾdæn
شمس	ʃæms
شمشیر	ʃæmʃiːɾ
شمشیرزن	ʃæmʃiːɾzæn
شمشیرماهی	ʃæmʃiːɾmɒːhiː
شمع	ʃæmʔ
شمعدان	ʃæmʔædɒːn
شمپانزه	ʃæmpɒːnze
شن	ʃen
شنا کردن	ʃenɒːkæɾdæn
شناخت	ʃenɒːxt
شناختن	ʃenɒːxtæn
شناریدن	ʃenɒːɾiːdæn
شناس	ʃenɒːs
شناسایی	ʃenɒːsɒːjiː
شناوری کردن	ʃenɒːvæɾiːkæɾdæn
شناویدن	ʃenɒːviːdæn
شناگر	ʃenɒːɡæɾ
شنبلیله	ʃænbeliːle
شنبه	ʃænbe
شنگرف	ʃænɡæɾf
شنیدن	ʃeniːdæn
شن‌کش	ʃenkeʃ
شهادت	ʃæhɒːdæt
شهادت دادن	ʃæhɒːdætdɒːdæn
شهامت	ʃæhɒːmæt
شهباز	ʃæhbɒːz
شهبانو	ʃæhbɒːnuː
شهد	ʃæhd
شهر	ʃæhɾ
شهر فرنگ	ʃæhɾefæɾænɡ
شهر مراکش	ʃæhɾmæɾɒːkeʃ
شهرآورد	ʃæhɾɒːvæɾd
شهرت	ʃæhɾæt
شهردار	ʃæhɾdɒːɾ
شهرزاد	ʃæhɾzɒːd
شهرک	ʃæhɾæk
شهری	ʃæhɾiː
شهریور	ʃæhɾiːvæɾ
شهسوار	ʃæhsævɒːɾ
شهمات	ʃɒːhmɒːt
شهمات کردن	ʃæhmɒːtkæɾdæn
شهنگانه	ʃæhænɡɒːne
شهوتی	ʃæhvætiː
شهید	ʃæhiːd
شو	ʃuː
شوارزنگر	ʃvɒːɾzeneɡeɾ
شوالیه	ʃovɒːliːje
شوالیه كردن	ʃovɒːljekæɾdæn
شوان	ʃævɒːn,ʃovɒːn
شوت	ʃuːt
شوت زدن	ʃuːtzædæn
شوخی	ʃuːxiː
شوخی کردن	ʃuːxiːkæɾdæn
شورش	ʃuːɾeʃ
شورش کردن	ʃuːɾeʃkæɾdæn
شورشی	ʃuːɾeʃiː
شورش‌ها	ʃuːɾeʃhɒː
شوروی	ʃuːɾæviː
شوریدن	ʃuːɾiːdæn
شوش	ʃuːʃ
شوفان	ʃuːfɒːn
شوم	ʃuːm
شوهر	شوهر,ʃoʊhæɾ
شوهر دادن	ʃohæɾdɒːdæn
شوهر کردن	ʃohæɾkæɾdæn
شوهرخاله	ʃoʊhæɾxɒːle
شوهرعمه	ʃoʊhæɾæmme
شوونیسم	ʃouːvæniːsm
شوپرک	ʃoʊpæɾæk
شوکولات	ʃuːkuːlɒːt
شوی	ʃuːj
شوید	ʃeviːd
شپش	ʃepeʃ
شک	ʃæk
شک کردن	ʃækkæɾdæn
شکار	ʃekɒːɾ
شکار کردن	ʃekɒːɾkæɾdæn
شکارچی	ʃekɒːɾt͡ʃiː
شکر	ʃækæɾ,ʃækkæɾ,ʃekæɾ,ʃokɾ
شکر کردن	ʃokɾkæɾdæn
شکرک	ʃekæɾæk
شکرک زدن	ʃekæɾækzædæn
شکری	ʃekæɾiː
شکست دادن	ʃekæstdɒːdæn
شکستن	ʃekæstæn
شکفتن	ʃekoftæn
شکل	ʃækl
شکلات داغ	ʃokolɒːtedɒːɢ
شکلاتی	ʃokolɒːtiː
شکلک	ʃeklæk
شکم	ʃekæm
شکم دریدن	ʃekæmdæɾiːdæn
شکمبند	ʃekæmbænd
شکمبه	ʃekæmbe
شکنجه	ʃekænd͡ʒe
شکنجه دادن	ʃekænd͡ʒedɒːdæn
شکوفه	ʃokuːfe
شکوفه زدن	ʃokuːfezædæn
شکوفه کردن	ʃokuːfekæɾdæn
شکوه	ʃokuːh
شگرد	ʃeɡeɾd
شگرد زدن	ʃeɡeɾdzædæn
شگرف	ʃeɡæɾf
شگفت	ʃeɡæft
شی	ʃiː
شیء	ʃejʔ
شیار	ʃiːɒːɾ
شیار زدن	ʃiːɒːɾzædæn
شیخ	ʃejx
شیر	ʃiːɾ
شیر دادن	ʃiːɾdɒːdæn
شیر کوهی	ʃiːɾekuːhiː
شیراز	ʃiːɾɒːz
شیرجه	ʃiːɾd͡ʒe
شیرجه زدن	ʃiːɾd͡ʒezædæn
شیردال	ʃiːɾdɒːl
شیردل	ʃiːɾdel
شیرفروش	ʃiːɾfoɾuːʃ
شیرگاه	ʃiːɾɡɒːh
شیری	ʃiːɾiː
شیرین	ʃiːɾiːn
شیرین کردن	ʃiːɾiːnkæɾdæn
شیشه	ʃiːʃe
شیطان	ʃejtɒːn
شیطان بزرگ	ʃejtɒːnebozoɾɡ
شیعه	ʃiːʔe
شیعی	ʃiːʔiː
شیفتگی	ʃiːftæɡiː,ʃiːfteɡiː
شیلر	ʃiːleɾ
شیلی	ʃiːliː
شیمی	ʃiːmiː
شیمی هسته‌ای	ʃiːmiːjehæsteʔiː
شیمیل	ʃiːmejl
شیهه	ʃejhe
شیهه زدن	ʃejhezædæn
شیهه کشیدن	ʃejhekeʃiːdæn
شیون	ʃiːvæn
شیون زدن	ʃiːvænzædæn
شیون کردن	ʃiːvænkæɾdæn
شیون کشیدن	ʃiːvænkeʃiːdæn
شیوه	ʃiːve
شیپور	ʃejpuːɾ
شیپور زدن	ʃejpuːɾzædæn
شیکاگو	ʃiːkɒːɡo
صابون	sɒːbuːn
صابون زدن	sɒːbuːnzædæn
صاحبخانه	sɒːhebxɒːne
صاریغ	sɒːɾiːɢ
صاعقه	sɒːeɢe,sɒːʔeɢe
صافی	sɒːfiː
صبح	sobh
صبح بخیر	sobhbexejɾ
صبح زود	sobhezuːd
صبحانه	sobhɒːne
صبر	sæbɾ
صبر کردن	sæbɾkæɾdæn,sæbɾkæɾdæn
صبور	sæbuːɾ
صحبت	sohbæt
صحبت کردن	sohbætkæɾdæn,sohbætkæɾdæn
صحت	sehæt
صحرا	sæhɾɒː
صحرای غربی	sæhɒːɾæɢæɾbiː
صحنه	sæhne
صحنه رقص	sæhnejeɾæɢs
صحیح	sæhiːh
صد	sæd
صدا	sedɒː
صدا دادن	sedɒːdɒːdæn
صدا زدن	sedɒːzædæn,sedɒːzædæn
صدا کردن	sedɒːkæɾdæn
صدام	sæddɒːm
صدف	sædæf
صدمه	sædæme
صدمه خوردن	sædæmexoɾdæn
صدمه دیدن	sædæmediːdæn
صدمه زدن	sædæmezædæn
صدپا	sædpɒː
صربستان	seɾbestɒːn
صربستان و مونته‌نگرو	ṣeɾbestɒːnuːmuːnteneɡɾuː
صربستانی	seɾbiːstɒːniː,sæɾbiːstɒːniː
صربی	seɾbiː,sæɾbiː
صرع	sæɾ
صعب	sæʔb
صف	sæf
صف کشیدن	sæfkeʃiːdæn
صفت	sefæt
صفت برتر	sefætebæɾtæɾ
صفت برترین	sefætebæɾtæɾiːn
صفحه	sæfhe
صفحه آبی مرگ	sæfhejeɒːbiːjemæɾɡ
صفحه اصلی	sæfhejeæsliː
صفحه خانگی	sæfhejexɒːneɡiː
صفحه کلید	sæfhekeliːd
صفر	sefɾ
صقلیه	seɢliːje
صلح	solh
صلح کردن	solhkæɾdæn
صلیب	sæliːb
صلیب سرخ	sæliːbesoɾx
صندل	sændæl
صندلی	sændæliː
صندلی راحتی‏	sændæliːɾɒːhætiː
صندوق	sænduːɢ
صندوق پست	sonduːɢepost
صهیونیسم	sæhjuːniːsm
صورت	suːɾæt
صورت دادن	suːɾætdɒːdæn
صورت گرفتن	suːɾætɡeɾeftæn
صورتی	soɾætiː,suːɾætiː
صوری	suːɾiː
صوفیا	sofiːjɒː
صوفیه	sofiːje
صید	sæiːd
صید کردن	sæiːdkæɾdæn
صیقل زدن	sejɢælzædæn
ضجه	zæd͡ʒd͡ʒe
ضجه زدن	zæd͡ʒd͡ʒezædæn
ضجه کردن	zæd͡ʒd͡ʒekæɾdæn
ضجه کشیدن	zæd͡ʒd͡ʒekeʃiːdæn
ضخیم	zæxiːm
ضرب	zæɾb
ضرب گرفتن	zæɾbɡeɾeftæn
ضربت	zæɾbæt
ضربت خوردن	zæɾbætxoɾdæn
ضربت زدن	zæɾbætzædæn
ضربدر	zæɾbdæɾ
ضربدر زدن	zæɾbdæɾzædæn
ضربه	zæɾbe
ضربه خوردن	zæɾbexoɾdæn
ضربه زدن	zæɾbezædæn
ضرر	zæɾæɾ
ضرر خوردن	zæɾæɾxoɾdæn
ضرر زدن	zæɾæɾzædæn
ضرر کردن	zæɾæɾkæɾdæn
ضرورت	zæɾuːɾæt
ضروری	zæɾuːɾiː
ضعیف	zæʔiːf
ضمانت	zemɒːnæt
ضمنی	zemniː
ضمه	zæmme
ضمیر	zæmiːɾ
ضمیمه	zæmiːme
طاس	tɒːs
طاعون	tɒːʔuːn
طالبی	tɒːlebiː
طاووس	tɒːvuːs
طاووس هندی	tɒːvuːsehendiː
طب	tebb
طب سوزنی	tebbesuːzæniː
طبق معمول	tebɢemæʔmuːl
طبقه	tæbæɢe
طبقه کارگر	tæbæɢejekɒːɾɡæɾ
طبل	tæbl
طبیب	tæbiːb
طبیعت	tæbiːjʔæt
طبیعتاّ	tæbiːætæn
طحال	tæhɒːl
طرابلس	tæɾɒːbolos
طراح	tæɾɒːh
طراحی	tæɾɾɒːhiː
طرح	tæɾh
طرح زدن	tæɾhzædæn
طرح کشیدن	tæɾhkeʃiːdæn
طرز فکر	tæɾzefekɾ
طرف	tæɾæf
طرف گرفتن	tæɾæfɡeɾeftæn
طرفدار	tæɾæfdɒːɾ
طریقه	tæɾiːɢe
طعم	tæʔm
طعنه	tæʔne
طعنه زدن	tæʔnezædæn
طغیان	toɢjɒːn
طغیان کردن	toɢjɒːnkæɾdæn
طفره	tæfɾe
طفره رفتن	tæfɾeɾæftæn
طفل	tefl
طلا	tælɒː
طلاق	tælɒːɢ
طلایی	tælɒːjiː
طلب کردن	tælæbkæɾdæn
طلوع	toluːʔ
طلوع کردن	toluːʔkæɾdæn
طناب	tænɒːb
طهران	tehɾɒːn
طوطی	tuːtiː
طوفان	tuːfɒːn
طوفان ریگ	tuːfɒːneɾiːɡ
طول	tuːl
طول موج	tuːlemoʊd͡ʒ
طولانی	tuːlɒːniː
طومار	tuːmɒːɾ
طیاره	tejjɒːɾe
ظالم	zɒːlem
ظرف	zæɾf
ظفر	zæfæɾ
ظهر	zohɾ
ظهر بخیر	zohɾbexejɾ
ظهور	zohuːɾ
ظهور کردن	zohuːɾkæɾdæn
عائله	ʔɒːʔiːle
عابر بانک	ʔɒːbeɾbɒːnk
عاج	ʔɒːd͡ʒ
عادت	ɒːdæt,ʔɒːdæt
عادت دادن	ɒːdætdɒːdæn
عادت کردن	ɒːdætkæɾdæn
عادت گرفتن	ɒːdætɡeɾeftæn
عادی	ʔɒːdiː
عاريه	ɒːɾiːje
عاریت	ɒːɾjæt
عاریت گرفتن	ɒːɾjætɡeɾeftæn
عاریه	ɒːɾje
عاریه گرفتن	ɒːɾjeɡeɾeftæn
عاشق	ʔɒːʃeɢ
عاشق بودن	ʔɒːʃeɢbuːdæn
عاشق شدن	ɒːʃeɢʃodæn
عافیت باشه	ɒːfiːjætbɒːʃe
عالم	ʔɒːlæm,ʔɒːlem
عالی	ʔɒːliː
عبادت کردن	ʔebɒːdætkæɾdæn
عبارت باقاعده	ʔebɒːɾætebɒːɢɒːʔede
عبرانی	ebɾɒːniː
عبری	ebɾiː
عجان	ʔed͡ʒɒːn
عجله	æd͡ʒæle
عجله کار شیطان است	æd͡ʒælekɒːɾeʃejtɒːnæst
عجله کردن	æd͡ʒælekæɾdæn
عجیب	ʔæd͡ʒiːb
عجیب و غریب	ʔæd͡ʒiːboɢæɾiːb,ʔæd͡ʒiːboɢæɾiːb
عدد	ʔædæd
عدد صحیح	ædædesæhiːh
عدس	ʔædæs,ædæs
عدسی	ædæsiː,æddæsiː
عدل	ædl
عذاب	æzɒːb
عذاب آمدن	æzɒːbɒːmædæn
عذاب دادن	æzɒːbdɒːdæn
عذاب کشیدن	æzɒːbkeʃiːdæn
عذرخواهی	ozɾxɒːhiː
عذرخواهی کردن	ozɾxɒːhiːkæɾdæn
عر	æɾ
عر زدن	æɾzædæn
عر کشیدن	æɾkeʃiːdæn
عراق	ʔeɾɒːɢ
عراقی	ʔeɾɒːɢiː
عرب	ʔæɾæb
عربده	æɾbæde
عربده زدن	æɾbædezædæn
عربده کشیدن	æɾbædekeʃiːdæn
عربستان	æɾæbestɒːn
عربستان سعودی	ʔæɾebiːstɒːnesæʔuːdiː
عربی	æɾæbiː,ʔæɾæbiː
عربی مصری	ʔæɾæbiːmesɾiː
عرش	ʔæɾʃ
عرف	oɾf
عرفانی	eɾfɒːniː
عرق	ʔæɾæɢ,æɾæɢ
عرق ریختن	æɾæɢɾiːxtæn
عرق کردن	æɾæɢkæɾdæn
عروس	æɾuːs
عروس دریایی	oɾuːsdæɾjɒːjiː
عروسک	ʔæɾuːsæk
عروسی	æɾuːsiː,ʔæɾuːsiː
عروسی کردن	æɾuːsiːkæɾdæn
عروسی گرفتن	æɾuːsiːɡeɾeftæn
عزا	æzɒː
عزا گرفتن	æzɒːɡeɾeftæn
عزم	ʔæsm,æzm
عزم داشتن	æzmdɒːʃtæn
عزیز	æziːz,ʔæziːz
عسل	æsæl
عشق	ʔeʃɢ
عشق داشتن	ʔeʃɢdɒːʃtæn
عشق‌آباد	eʃɢɒːbɒːd
عشق‌بازی	eʃɢbɒːziː
عصا	æsɒː
عصا زدن	æsɒːzædæn
عصب	ʔæsæb,æsæb
عصبانی	æsæbɒːniː
عصبانیت	æsæbɒːnjjiːæt
عصبانیت زدن	æsæbɒːniːjjætzædæn
عصر	æsɾ
عصر بخیر	æsɾbexejɾ
عصر هسته‌ای	æsɾehæsteʔiː
عصرانه	æsɾɒːne
عضله	ʔæzole
عطر	ætɾ
عطر زدن	ætɾzædæn
عطسه	ætse
عطسه زدن	ætsezædæn
عطسه کردن	ætsekæɾdæn
عطسه گرفتن	ætseɡeɾeftæn
عظیم	æziːm
عفو	æf
عفو خوردن	æfxoɾdæn
عفو کردن	æfkæɾdæn
عق	oɢ,oɢɢ
عق زدن	oɢzædæn
عق گرفتن	oɢɢɡeɾeftæn
عقاب	ʔoɢɒːb,oɢɒːb
عقاب طلایی	oɢɒːbetælɒːjiː
عقب	ʔæɢb,æɢæb
عقب افتادن	æɢæboftɒːdæn
عقب زدن	æɢæbzædæn
عقب نشینی	æɢæbniːʃiːniː
عقد	æɢd
عقد درآمدن	æɢddæɾɒːmædæn
عقد شدن	æɢdʃodæn
عقد کردن	æɢdkæɾdæn
عقرب	ʔæɢɾæb,æɢɾæb
عقرب زدن	æɢɾæbzædæn
عقل	æɢæl
عقیده	æɢiːde
عقیق سلیمانی	æɢiːɢesolejmɒːniː
علاقه	ælɒːɢe
علاقه داشتن	ælɒːɢedɒːʃtæn
علامت	ælɒːmæt
علامت تعجیب	ʔælɒːmætetæʔd͡ʒiːb
علامت جمع	ʔælɒːmæted͡ʒæmʔ
علامت خوردن	ælɒːmætxoɾdæn
علامت زدن	ælɒːmætzædæn
علامت مساوی	ʔælɒːmætemosɒːviː
علامت منها	ʔælɒːmætemenhɒː
علف	ælæf
علم	ʔælæm,ʔelm
علم اخلاق	ʔelmeæxlɒːɢ
علم معانی	ʔelmmæʔɒːniː
علمی	elmiː
علی بابا	ʔæliːbɒːbɒː
عمان	ommɒːn
عمدی	ʔæmdiː
عمرة	ʻæmɾæt
عمل	æmæl
عمل آمدن	æmælɒːmædæn
عمه	ʔæmme,æmme
عمه‌زاده	æmmezɒːde
عمو	æmuː,ʔæmuː
عموزاده	æmuːzɒːde
عمیق	ʔæmiːɢ
عنان	ænɒːn
عنان زدن	ænɒːnzædæn
عنبر	ʔænbæɾ
عنبیه	ʔenæbiːje
عنوان	onvɒːn,ʔenovɒːn
عنوان کردن	onvɒːnkæɾdæn
عنکبوت	ænkæbuːt,ʔænkæbuːt
عهده	ohde
عهده داشتن	ohdedɒːʃtæn
عوض	ævæz
عوض شدن	ævæzʃodæn
عوض کردن	ævæzkæɾdæn
عيد فطر	ejdefetɾ
عکاس	ʔækkɒːs
عکاسی	ækkɒːsiː
عکس	æks
عکس گرفتن	æksɡeɾeftæn
عیبجویی کردن	ʔejbd͡ʒuːjiːkæɾdæn
عید قربان	eiːdeɢoɾbɒːn
عید پاک	ejdepɒːk
عیسی	ʔiːsɒː
عیسی مسیح	ʔiːsɒːmæsiːh
عیلام	iːlɒːm
عینک	eiːnæk,ejnæk
عینک آفتابی	eiːnækɒːftɒːbiː
عینک زدن	ejnækzædæn
غار	ɢɒːɾ
غارت	ɢɒːɾæt
غارت کردن	ɢɒːɾætkæɾdæn
غاز	ɢɒːz
غایی	ɢɒːjiː
غده	ɢodde
غذا	ɢæzɒː
غر	ɢoɾ
غر زدن	ɢoɾzædæn
غر غر	ɢoɾɢoɾ
غر غر کردن	ɢoɾɢoɾkæɾdæn
غراب	ɢoɾɒːb
غرب	ɢæɾb
غربی	ɢæɾbiː
غرش	ɢoɾɾeʃ
غروب	ɢoɾuːb
غروب کردن	ɢoɾuːbkæɾdæn
غرور	ɢoɾuːɾ
غریبه	ɢæɾiːbe
غریزه	ɢæɾiːze
غزال	ɢæzɒːl
غزال آفریقائی	ɢæzɒːleɒːfɾiːɢɒːʔiː
غزال افریقا	ɢæzɒːleɒːfɾiːɢɒː
غزه	ɢæze
غسل	ɢosl
غسل کردن	ɢoslkæɾdæn
غش	ɢæʃ
غش غش	ɢæʃɢæʃ
غش غش زدن	ɢæʃɢæʃzædæn
غش غش کردن	ɢæʃɢæʃkæɾdæn
غش و ضعف	ɢæʃozæʔf
غش و ضعف زدن	ɢæʃozæʔfzædæn
غش کردن	ɢæʃkæɾdæn
غصه	ɢosse
غصه خوردن	ɢossexoɾdæn
غلبه	ɢælæbe
غلبه کردن	ɢælæbekæɾdæn
غلت	ɢælt
غلت خوردن	ɢæltxoɾdæn
غلت زدن	ɢæltzædæn
غلط	ɢælæt
غلیان	ɢæljɒːn
غم	ɢæm
غم خوردن	ɢæmxoɾdæn
غمگین	ɢæmɡiːn
غنودن	ɢonuːdæn
غنوصی	ɢnuːsiː
غنچه	ɢont͡ʃæ,ɢont͡ʃe
غنچه دادن	ɢont͡ʃedɒːdæn,ɢont͡ʃedɒːdæn,ɢont͡ʃædɒːdæn
غنی	ɢæniː
غوطه	ɢuːte
غوطه زدن	ɢuːtezædæn
غوغا	ɢævɢɒː,ɢouːɢɒː
غول	ɢuːl
غيرانتفاعي	ɢeiːɾeentefæʔiː
غیب	ɢejb
غیب زدن	ɢejbzædæn
غیبت	ɢejbæt
غیبت کردن	ɢejbætkæɾdæn
غیر مجاز کردن	ɢejɾemod͡ʒɒːzkæɾdæn
غیرالکلی	ɢejɾeælkoliː
فاحشه	fɒːheʃe
فاحشه‌خانه	fɒːheʃexɒːne
فاخته	fɒːxtæ
فارس	fɒːɾs
فارسی	fɒːɾsiː
فارسی تاجیکی	fɒːɾsiːjetɒːd͡ʒiːkiː
فارسی دری	fɒːɾsiːjedæɾiː
فارماکولوژی	fɒːɾmɒːkoloʒiː
فاز	fɒːz
فاس	fɒːs
فاشیسم	fɒːʃiːsæm
فاصله	fɒːsele
فاصله مجازی	fɒːselejemæd͡ʒɒːziː
فاصله نشکن	fɒːselejenæʃkæn
فامیل	fɒːmiːl
فانوس	fɒːnuːs
فانوس دریایی	fɒːnuːsedæɾjɒːjiː
فاکس	fɒːks
فاکس زدن	fækszædæn
فاکس کردن	fækskæɾdæn
فایده	fɒːjede
فتادن	fetɒːdæn
فتحه	fæthe
فحش	fohʃ
فحش دادن	fohʃdɒːdæn
فدراسیون	fedeɾɒːsjuːn
فدراسیون روسیه	fedeɾɒːsjuːneɾuːsiːje
فر	feɾ
فر خوردن	feɾxoɾdæn
فر زدن	feɾzædæn
فرآیند	fæɾɒːjænd
فرا	fæɾɒː
فرات	foɾɒːt
فراخواندن	fæɾɒːxvɒːndæn
فراداده	fæɾɒːdɒːde
فرار	fæɾɒːɾ
فرار کردن	fæɾɒːɾkæɾdæn
فراری	feɾɒːɾiː
فراز	fæɾɒːz
فراكهكشانی	fæɾɒːkæhkeʃɒːniː
فراموش کردن	fæɾɒːmuːʃkæɾdæn
فراموشکاری	fæɾɒːmuːʃkɒːɾiː
فراموشکاری زدن	fæɾɒːmuːʃkɒːɾiːzædæn
فراموشی	fæɾɒːmuːʃiː
فراموشی زدن	fæɾɒːmuːʃiːzædæn
فرانسه	fɾɒːnse
فرانسوی	fæɾɒːnsæviː
فرانسویان	fæɾɒːnsæviːjɒːn
فرانسیم	feɾɒːnsiːjom
فراگیر	fæɾɒːɡiːɾ
فربود	fæɾbuːd
فرج	fæɾd͡ʒ
فرجام	fæɾd͡ʒɒːm
فردا	fæɾdɒː
فردا بعد از ظهر	fæɾdɒːbæʔdæzzohɾ
فردا شب	fæɾdɒːʃæb
فردا صبح	fæɾdɒːsobh
فردا غروب	fæɾdɒːɢoɾuːb
فردریش	feɾedɾiːʃ
فردریک	feɾedɾiːk
فردوس	feɾdoʊs
فرز	feɾz
فرزان	fæɾzɒːn
فرزند	fæɾzænd
فرزین	fæɾziːn
فرستادن	feɾestɒːdæn
فرسودن	fæɾsuːdæn
فرش	fæɾʃ
فرش کردن	fæɾʃkæɾdæn,fæɾʃkæɾdæn
فرشته	feɾeʃte
فرصت	foɾsæt
فرض کردن	fæɾzkæɾdæn
فرضی	fæɾziː
فرضیه	fæɾziːje
فرعون	fæɾʔæwn
فرق	fæɾɢ
فرمان	fæɾmɒːn
فرماندار	fæɾmɒːndɒːɾ
فرمانده کل قوا	fæɾmɒːndejekolleɢovɒː
فرمانروایی	fæɾmɒːnɾævɒːjiː
فرمودن	fæɾmuːdæn
فرمول	foɾmuːl
فرمیون	feɾmiːjon
فرنشین	fæɾneʃiːn
فرهنگ	fæɾhænɡ
فرهنگستان	fæɾhænɡestɒːn
فرهنگ‌نویسی	fæɾhænɡnæviːsiː
فروختن	foɾuːxtæn
فرودگاه	foɾuːdɡɒːh
فروردین	fæɾvæɾdiːn
فروزان	fɾuːzɒːn
فروسرخ	foɾuːsoɾx
فروغ	fɾuːĝ
فرومون	feɾuːmuːn
فریاد	fæɾjɒːd
فریاد آمدن	fæɾjɒːdɒːmædæn
فریاد زدن	fæɾjɒːdzædæn,fæɾjɒːdzædæn
فریاد کردن	fæɾjɒːdkæɾdæn
فریاد کشیدن	fæɾjɒːdkeʃiːdæn
فریبا	fæɾiːbɒː
فریبکار	fæɾiːbkɒːɾ
فریزی	feɾiːziː
فساد	fæsɒːd,fesɒːd
فسرده	fesoɾde
فسفر	fosfoɾ
فشار	feʃæɾ
فشار دادن	feʃɒːɾdɒːdæn,feʃæɾdɒːdæn
فصح	feʃ
فصل	fæsl
فضا	fæzɒː
فضازمان	fæzɒːzæmɒːn
فضانورد	fæzɒːnævæɾd
فضاپیما	fæzɒːpeiːmɒː
فضای بیرونی	fæzɒːjebiːɾuːniː
فضایی	fæzɒːjiː
فعالیت	fæʔɒːliːjæt
فعل	feʔl
فغان	fæɢɒːn
فقر	fæɢɾ
فقط	fæɢæt
فقیر	fæɢiːɾ
فلاطون	flɒːtuːn
فلافل	fælɒːfel
فلز	felez
فلسطین	felestiːn
فلسفه اخلاق	fælsæfejeæxlɒːɢ
فلفل	felfel
فلفل دلمه‌ای	felfeledolmeiː
فلفل قرمز	felfelɢeɾmez,felfeleɢeɾmez
فلوئور	feloʔoɾ,foluːʔoɾ,fluːʔoɾ
فلوت	fluːt
فلوریدا	feloɾiːdɒː
فمینیسم	femiːniːsm
فن	fæn
فن الکتریکی	fænelektɾiːkiː
فناوری	fænnɒːvæɾiː
فنجان	fend͡ʒɒːn
فندق	fændoɢ
فندک	fændæk
فنلاند	fænlɒːnd
فنلاندی	fænlɒːndiː
فهرست	fehɾest
فهرست محتویات	fehɾestemohtæviːjɒːt
فهرست پی‌گیری‌ها	fehɾestepejɡiːɾiːhɒː
فهرست کردن	fehɾestkæɾdæn
فهمیدم	fæhmiːdæm
فهمیدن	fæhmiːdæn
فهمیدید	fæhmiːdiːd
فواره	fævvɒːɾe
فواره زدن	fævvɒːɾezædæn
فوت	foʊt,fuːt
فوت کردن	foʊtkæɾdæn,fuːtkæɾdæn
فوتبال	fuːtbɒːl
فوتبالیست	fuːtbɒːliːst
فوتون	foton
فوتوکپی	fotokopiː
فورا	fævɾæn
فوران	fævæɾɒːn
فوران زدن	fævæɾɒːnzædæn
فوران کردن	fævæɾɒːnkæɾdæn
فوریه	fevɾiːje
فولاد	fuːlɒːd
فيليپ	fiːliːp
فک	fæk
فکر	fekɾ
فکر افتادن	fekɾoftɒːdæn
فکر رفتن	fekɾɾæftæn
فکر کردن	fekɾkæɾdæn,fekɾkæɾdæn
فکس کردن	fækskæɾdæn
فی	fiː
فیت	fiːt
فیجی	fiːd͡ʒiː
فیروزه	fiːɾuːze
فیروزه‌ای	fiːɾuːzejiː
فیزیک	fiːziːk
فیزیک اتمی	fiːziːkeætomiː
فیزیک هسته‌ای	fiːziːkehæsteʔiː
فیس بوک	fesbuːk
فیصل‌آباد	fejsælɒːbɒːd
فیل	fiːl
فیلم	fiːlm
فیلم ترسناک	fiːlmetæɾsnɒːk
فیلیپین	fiːliːpiːn
فینال	fiːnɒːl
فیکساتور	fiːksɒːtoɾ
فیکساتور زدن	fiːksɒːtoɾzædæn
قاب	ɢɒːb
قاب کردن	ɢɒːbkæɾdæn
قابل نداشت	ɢɒːbelnædɒːʃt
قاتل	ɢɒːtel
قار	ɢɒːɾ
قار زدن	ɢɒːɾzædæn
قاره	ɢɒːɾe
قارچ	ɢɒːɾt͡ʃ
قاشق	ɢɒːʃeɢ,ɢɒːʃoɢ
قاصدک	ɢɒːsedæk
قاضی	ɢɒːziː
قالی	ɢɒːliː
قالیچه	ɢɒːliːt͡ʃe
قالیچه پرنده	ɢɒːliːt͡ʃejepæɾænde
قانقاریا	ɢɒːnɢɒːɾjɒː
قانون	ɢɒːnuːn
قانون زدن	ɢɒːnuːnzædæn
قاهره	ɢɒːheɾe
قاپ	ɢɒːp
قاپ زدن	ɢɒːpzædæn
قاچ	ɢɒːt͡ʃ
قاچ خوردن	ɢɒːt͡ʃxoɾdæn
قاچ زدن	ɢɒːt͡ʃzædæn
قاچ کردن	ɢɒːt͡ʃkæɾdæn
قایق	ɢɒːjeɢ
قایق اژدها	ɢɒːjeɢeʒdehæ
قبا	ɢæbɒː
قبر	ɢæbɾ
قبرستان	ɢæbɾestɒːn
قبل	ɢæbl
قبلا	ɢæblæn
قبله	ɢeble
قبول	ɢæbuːl
قبول کردن	ɢæbuːlkæɾdæn,ɢæbuːlkæɾdæn
قتل	ɢætl
قحبه‌خانه	ɢæhbexɒːne
قد	ɢæd
قد کشیدن	ɢædkeʃiːdæn
قدرت	ɢodɾæt
قدس	ɢods
قدس شریف	ɢodseʃæɾiːf
قدم	ɢædæm
قدم زدن	ɢædæmzædæn,ɢædæmzædæn
قدیمی	ɢædiːmiː
قرآن	ɢoɾʔɒːn
قرار	ɢæɾɒːɾ
قرار زدن	ɢæɾɒːɾzædæn
قرارداد	ɢæɾɒːɾdɒːd
قرارداد زدن	ɢæɾɒːɾdɒːdzædæn
قرارملاقات	ɢæɾɒːɾemolɒːɢɒːt
قرارملاقات گرفتن	emolɒːɢɒːtɡeɾeftæn
قربانی	ɢoɾbɒːniː
قربانی کردن	ɢoɾbɒːniːkæɾdæn
قرص	ɢoɾse
قرض	ɢæɾz
قرقاول	ɢæɾɢɒːvol
قرقیزستان	ɢeɾɢiːzestɒːn
قرقیزی	ɢiːɾɢiːziː
قرمز	ɢeɾmez
قرمزی	ɢeɾmeziː
قرن	ɢæɾn
قرنیه	ɢæɾniːje
قره‌باغ	ɢæɾebɒːɢ
قره‌باغ کوهستانی	ɢæɾebɒːɢekuːhestɒːniː
قزاق	ɢæzzɒːɢ
قزاقستان	ɢæzzɒːɢestɒːn
قزاقی	ɢæzɒːɢiː
قسم	ɢæsæm
قسم خوردن	ɢæsæmxoɾdæn
قسمت	ɢesmæt
قشلاق	ɢeʃlɒːɢ
قشنگ	ɢæʃænɡ
قصاب	ɢæssɒːb
قصد	ɢæsd
قصد داشتن	ɢæsddɒːʃtæn
قصد کردن	ɢæsdkæɾdæn
قطار	ɢetɒːɾ
قطب جنوب	ɢotbed͡ʒonuːb
قطب شمال	ɢotbeʃomɒːl
قطب‌نما	ɢotbnæmɒː
قطر	ɢætæɾ
قطره	ɢætɾe
قفس	ɢæfæs
قفسه کتاب	ɢæfæsejeketɒːb
قفقاز	ɢæfɢɒːz
قفقاز جنوبی	ɢæfɢɒːzed͡ʒonuːbiː
قفقاز شمالی	ɢæfɢɒːzeʃæmɒːliː
قفقازی	ɢæfɢɒːziː
قفل	ɢofl
قفل زدن	ɢoflzædæn
قفل کردن	ɢoflkæɾdæn,ɢoflkæɾdæn
ققنس	ɢæɢnos
قل	ɢol
قل خوردن	ɢolxoɾdæn
قل زدن	ɢolzædæn
قل قل	ɢolɢol
قل قل زدن	ɢolɢolzædæn
قلاب	ɢollɒːb
قلاب ماهيگيري	ɢollɒːbmɒːhiːɡiːɾiː
قلب	ɢælb
قلبی	ɢælbiː
قلعه	ɢælʔe
قلقلک	ɢelɢelæk
قلقلک دادن	ɢelɢelækdɒːdæn
قلم	ɢælæm
قلم زدن	ɢælæmzædæn
قلمه	ɢælæme
قلمه خوردن	ɢælæmexoɾdæn
قلمه زدن	ɢælæmezædæn
قلمه کردن	ɢælæmekæɾdæn
قله	ɢolle
قلیا	ɢæliːɒː
قلیان	ɢæljɒːn
قلیون	ɢæljuːn
قم	ɢom
قمار	ɢomɒːɾ
قمار زدن	ɢomɒːɾzædæn
قناری	ɢænɒːɾiː
قناس	ɢenɒːs
قند	ɢænd
قندوز	ɢonduːz
قهر	ɢæhɾ
قهر کردن	ɢæhɾkæɾdæn
قهرمان	ɢæhɾemɒːn
قهقهه	ɢæhɢæhe
قهقهه زدن	ɢæhɢæhezædæn
قهوه	ɢæhve
قهوه سیاه	ɢæhvesiːjɒːh
قهوهای شدن	ɢæhveʔiːʃodæn
قهوه‌ای	ɢæhveiː,ɢæhveʔiː,ɢæhvejiː
قهوه‌خانه	ɢæhvexɒːne
قو	ɢuː
قواخ	ɢævɒːx
قورباغه	ɢuːɾbɒːɢe
قورت	ɢuːɾt
قورت دادن	ɢuːɾtdɒːdæn
قوزک	ɢuːzæk
قوزک پا	ɢuːzækepɒː
قوس	ɢoʊs
قوس زدن	ɢoʊszædæn
قوس و قزح	ɢoʊsoɢæzæh
قوطى	ɢuːtiː
قول	ɢol,ɢoʊl
قول زدن	ɢoʊlzædæn,ɢolzædæn
قول گرفتن	ɢoʊlɡeɾeftæn
قوم	ɢoʊm
قومیت	ɢoʊmiːjjæt
قوچ	ɢuːt͡ʃ
قوی	ɢæviː
قوی سیاه	ɢuːjesiːjɒːh
قياس	ɢiːɒːs
قياس کردن	ɢiːɒːskæɾdæn
قیافه	ɢiːɒːfe
قید	ɢejd
قید زدن	ɢejdzædæn
قیصر	ɢejsæɾ
قیف	ɢiːf
قیماغ	ɢejmɒːɢ
قیماق	ɢejmɒːɢ
قیمت	ɢejmæt
قیمق	ɢejmæɢ
قیچی	ɢejt͡ʃiː
قیچی زدن	ɢejt͡ʃiːzædæn
قیچی کردن	ɢejt͡ʃiːkæɾdæn
كالبد	kɒːlbod
كانا	kɒːnɒː
كبریت	kebɾiːt
كبریت زدن	kebɾiːtzædæn
كبریت کشیدن	kebɾiːtkeʃiːdæn
كروآت	kɾoɒːt
كم‌گوش	kæmɡuːʃ
كه	ke
كو كلوكس كلان	kuːkluːksklɒːn
كپور	kæpuːɾ
كیف	kejf
كیف دادن	kejfdɒːdæn
كیف کردن	kejfkæɾdæn
لائوس	lɒːʔos
لاتویایی	lɒːtviːjɒːjiː
لاتین	lɒːtiːn
لاجورد	lɒːd͡ʒvæɾd
لاجوردی	lɒːd͡ʒevæɾdiː
لادا	lɒːdɒː
لازم	lɒːzem
لاس	lɒːs
لاس زدن	lɒːszædæn
لاستیک	lɒːstiːk
لاف	lɒːf
لاف زدن	lɒːfzædæn
لال	lɒːl
لالمونی	lɒːlmuːniː
لالمونی گرفتن	lɒːlmuːniːɡeɾeftæn
لاله	lɒːle
لاندا	lɒːndɒː
لانه	lɒːne
لاک	lɒːk
لاک زدن	lɒːkzædæn
لاکشمی	lɒːkʃmiː
لاک‌پشت	lɒːkpoʃt
لب	læb
لب زدن	læbzædæn
لب گرفتن	læbɡeɾeftæn
لباس	lebɒːs
لباس شنا	lebɒːseʃenɒː
لبخند	læbxænd
لبخند زدن	læbxændzædæn
لبنان	lobnɒːn
لبی	læbiː
لب‌های بزرگ	læbhɒːjebozoɾɡ
لب‌های کوچک	læbhɒːjekuːt͡ʃek
لتونی	letuːniː
لثه	lese,læse
لج	læd͡ʒ
لج کردن	læd͡ʒkæɾdæn
لجاجت	led͡ʒɒːd͡ʒæt
لجاجت کردن	led͡ʒɒːd͡ʒætkæɾdæn
لجام	led͡ʒɒːm
لجام زدن	leɡɒːmzædæn
لجن	læd͡ʒæn
لجن زدن	læd͡ʒænzædæn
لحظه	læhze
لذت	lezzæt
لذت بردن	lezzætboɾdæn
لذیذ	læziːz
لرز	læɾz
لرز گرفتن	læɾzɡeɾeftæn
لرزش	læɾzeʃ
لرزیدن	læɾziːdæn
لش	læʃ
لطفا	lotfæn
لطمه	lætme
لطمه خوردن	lætmexoɾdæn
لطمه زدن	lætmezædæn
لعنتی	læʔnætiː
لغت‌نامه	loɢætnɒːme
لق	læɢ
لق خوردن	læɢxoɾdæn
لق زدن	læɢzædæn
لقب	læɢæb
لقب گرفتن	læɢæbɡeɾeftæn
لقمه	loɢme
لقمه گرفتن	loɢmeɡeɾeftæn
لمباندن	lombɒːndæn
لمس	læms
لمس کردن	læmskæɾdæn
لندن	lændæn
لندن بزرگ	lændænebozoɾɡ
لنز	lenz
لنز گذاشتن	lenzɡozɒːʃtæn
لنگ	lænɡ
لنگ زدن	lænɡzædæn
لنگرگاه	lænɡæɾɡɒːh
له له	læhlæh
له له زدن	læhlæhzædæn
لهجه	læhd͡ʒe
لهستان	læhestɒːn
لهستانی	lehestɒːniː
لو	loʊ
لو دادن	loʊdɒːdæn
لو رفتن	loʊɾæftæn
لواش	lævɒːʃ
لوبیا	luːbiːjɒː
لوت	luːt
لوتوس	lotuːs
لوزون	luːzon
لوله‌کش	luːlekeʃ
لوور	luːvɾ
لوکزامبورگ	luːkzɒːmbuːɾɡ
لپ	lop,lopp
لژیون	leʒiːon
لک	læk
لک شدن	lækʃodæn
لکنت	loknæt
لکنت افتادن	loknætoftɒːdæn
لکهٔ زرد	lækkejezæɾd
لک‌لک	læklæk
لگام	leɡɒːm
لگام زدن	led͡ʒɒːmzædæn
لگد	læɡæd
لگد خوردن	læɡædxoɾdæn
لگد زدن	læɡædzædæn
لگد کردن	læɡædkæɾdæn
لگو	leɡuː,leɡo
لیبی	liːbiː
لیبیدو	liːbiːdo,liːbiːduː
لیتر	liːtɾ
لیتوانی	liːtvɒːniː
لیتوانیایی	liːtvɒːniːjɒːjiː
لیختن‌اشتاین	liːxteneʃtɒːjn
لیز	liːz
لیس	liːs
لیس زدن	liːszædæn
لیسبون	liːsbon
لیسیدن	liːsiːdæn
لیف	liːf
لیف زدن	liːfzædæn
لیف کشیدن	liːfkeʃiːdæn
لیمو	liːmuː
لیموترش	liːmuːtoɾʃ
لیمون	liːmuːn
لیمویی	liːmuːjiː
لینکلن	liːnkoln
لیوان	liːvɒːn
لیورپول	liːvæɾpuːl
مؤدب	moʔæddæb
مؤذن	moʔæzzen
مؤلف	moʔællef
ما	mɒː
مائوئیسم	mɒːʔuːʔiːsm
مائوری	mɒːʔoɾiː
مات	mɒːt
مات زدن	mɒːtzædæn
مات کردن	mɒːtkæɾdæn
ماتروشکا	mɒːtɾuːʃkɒː
ماتم	mɒːtæm
ماتم گرفتن	mɒːtæmɡeɾeftæn
ماتیک	mɒːtiːk
ماتیک زدن	mɒːtiːkzædæn
ماجورو	mɒːd͡ʒoɾo
مادام	mɒːdɒːm
مادر	mɒːdæɾ
مادر جنده	mɒːdæɾd͡ʒende
مادراندر	mɒːdæɾændæɾ
مادربزرگ	mɒːdæɾbozoɾɡ
مادرجد	mɒːdæɾd͡ʒædd
مادرخوانده	mɒːdæɾxwɒːnde
مادرزن	mɒːdæɾzæn
مادرشوهر	mɒːdæɾʃoʊhæɾ
ماده تاریک	mɒːddejetɒːɾiːk
ماده‌خوک	mɒːdexuːk
ماده‌گاو	mɒːdeɡɒːv
مادّه	mɒːdde
مار	mɒːɾ
مار زدن	mɒːɾzædæn
ماراتی	mæɾɒːtiː
مارخوار	mɒːɾxɒːɾ
مارخور	mɒːɾxoɾ
مارس	mɒːɾs
مارماهی	mɒːɾmɒːhiː
مارمولک	mɒːɾmuːlæk,mɒːɾmolæk
مارى	mɒːɾiː
مارچوبه	mɒːɾt͡ʃuːbe
مارک	mɒːɾk
مارکس	mɒːɾks
مارگارین	mɒːɾɡɒːɾiːn
ماریجوانا	mɒːɾiːxuːɒːnɒː
مازندران	mɒːzændæɾɒːn
ماساژ	mɒːsɒːʒ
ماسا�� دادن	mɒːsɒːʒdɒːdæn
ماست	mɒːst
ماسه	mɒːse
ماسه بادی	mɒːssebɒːdiː
ماسک	mɒːsk
ماسک زدن	mɒːskzædæn
ماشين برقي	mɒːʃiːnebæɾɢiː
ماشین	mɒːʃiːn
ماشین حساب	mɒːʃiːnehesɒːb
ماشین زدن	mɒːʃiːnzædæn
ماشین پارک	mɒːʃiːnepɒːɾk
ماشین‌حساب	mɒːʃiːnhesɒːb
ماضی	mɒːziː
مالاریا	mɒːlɒːɾjɒː
مالایی	mɒːlɒːjiː
مالت	mɒːlt
مالدار	mɒːldɒːɾ
مالدیو	mɒːldiːv
مالزی	mɒːleziː
مالزیایی	mɒːleziːjɒːjiː
مالش	mɒːleʃ
مالش دادن	mɒːleʃdɒːdæn
مالی	mɒːliː
مالیات	mɒːliːjɒːt
مامان	mɒːmɒːn
ماموت	mɒːmuːt
ماموریت	mæʔmuːɾiːæt
ماموریت گرفتن	mæʔmuːɾiːætɡeɾeftæn
ماندارین	mɒːndɒːɾiːn
ماندن	mɒːndæn
ماندگاری	mɒːndeɡɒːɾiː
مانند	mɒːnænd
مانگا	mɒːnɡɒː
ماه	mɒːh
ماه آینده	mɒːheɒːjænde
ماه گذشته	mɒːheɡozæʃte
ماهی	mɒːhiː
ماهی تابه	mɒːhiːtɒːbe
ماهی قرمز	mɒːhiːjeɢeɾmez
ماهی مرکب	mɒːhiːjemæɾkæb
ماهیچه	mɒːhiːt͡ʃe
ماهی‌فروش	mɒːhiːfoɾuːʃ
ماچ	mɒːt͡ʃ
ماچ کردن	mɒːt͡ʃkæɾdæn,mɒːt͡ʃkæɾdæn
ماچین	mɒːt͡ʃiːn
ماژیک	mɒːʒiːk
ماک	mɒːk
ماکائو	mɒːkɒːo
ماکارونی	mɒːkɒːɾoniː
ماگادان	mɒːɡɒːdɒːn
ماگاس	mɒːɡɒːs
ماگنیتوگورسک	mɒːɡniːtuːɡuːɾsk
مایا	mɒːjɒː
مایع	mɒːjeʔ
مایونز	mɒːjonez
مایکروسافت	mɒːjkɾosoft
مایکوپ	mɒːjkuːp
مبارزه	mobɒːɾeze
مبارزه کردن	mobɒːɾezekæɾdæn
مبارک باشه	mobɒːɾækbɒːʃe
مبالغه	mobɒːleɢe
مبالغه کردن	mobɒːleɢekæɾdæn
مباهات	mobɒːhɒːt
مباهات کردن	mobɒːhɒːtkæɾdæn
مبتذل	mobtæzæl
مبل	mobl
مبلمان	moblemɒːn
مبهم	mobhæm
متأسف‌ام	motæʔsefæm
متا	metɒː
متاسفانه	motæʔæssefɒːne
متحد	mottæhed
متد	metod
متر	metɾ
مترادف	motæɾɒːdef
مترجم	motæɾd͡ʒem
متریک	metɾiːk
متشکرم	moteʃækeɾæm
متغیر	moteɢejjeɾ
متغیر عضو	moteɢejjeɾeozv
متن	mætn
متن ادبی	mætneædæbiː
مته	mæte
متوجه شدید	motevæd͡ʒd͡ʒeʃodiːd
متی	mætiː
مثال	mesɒːl
مثال زدن	mesɒːlzædæn
مثانه	mæssɒːne
مثل	mesle
مثلا	mæsælæn
مثلث	mosælæs
مثلثات	mosælæsɒːt
مجار	mæd͡ʒɒːɾ
مجارستان	mæd͡ʒɒːɾestɒːn
مجارستانی	mæd͡ʒɒːɾestɒːniː
مجاری	mæd͡ʒɒːɾiː
مجازات	mod͡ʒɒːzɒːt
مجازات شدن	mod͡ʒɒːzɒːtʃodæn
مجازات کردن	mod͡ʒɒːzɒːtkæɾdæn
مجازی	mæd͡ʒɒːziː
مجانی	mæd͡ʒd͡ʒɒːniː
مجاهد	mod͡ʒɒːhed
مجاور	mod͡ʒɒːveɾ
مجروح	mæd͡ʒɾuːh
مجلس	mæd͡ʒles
مجله	mæd͡ʒælle
مجنون	mæd͡ʒnuːn
مجهول	mæd͡ʒhuːl
مجوسی	mæd͡ʒuːsiː
محاصره	mohɒːseɾe
محاصره شدن	mohɒːseɾeʃodæn
محاصره کردن	mohɒːseɾekæɾdæn
محاصره گرفتن	mohɒːseɾeɡeɾeftæn
محاکمه	mohɒːkeme
محاکمه کردن	mohɒːkemekæɾdæn
محبوب	mæhbuːb
محتوا	mohtævɒː
محراب	mehɾɒːb
محصول	mæhsuːl
محل	mæhæll,‎mæhæll
محله	mæhælle
محلی	mæhælliː
محمد	mohæmmæd
محو	mæhv
محو کردن	mæhvkæɾdæn
محک	mæhæk
محک خوردن	mæhækxoɾdæn
محک زدن	mæhækzædæn
محک کردن	mæhækkæɾdæn
محکمه	mæhkæme
مخاطب	moxɒːtæb
مخالف	moxɒːlef
مخالفت	moxɒːlefæt
مخالفت کردن	moxɒːlefætkæɾdæn
مخاچ‌قلعه	mæxɒːt͡ʃɢælʔe
مخده	mæxæddæh
مخصوصا	mæxsuːsæn
مخفي	mæxfiː
مخفی	mæxfiː
مد	mod
مداد	medɒːd
مداد رنگی	medɒːdeɾænɡiː
مداد شمعی	medɒːdeʃæmʔiː
مداد نوکی	medɒːdenokiː
مدال	medɒːl
مدال طلا	medɒːletælɒː
مدت	moddæt
مدخل	mædxæl
مدد	mædæd
مدد گرفتن	mædædɡeɾeftæn
مدرسه	mædɾese
مدفوع	mædfuːʔ
مدور	modævvæɾ
مدیر	modiːɾ
مذبح	mæzbæh
مذهب	mæzhæb
مذهب بودا	mæzhæbebuːdɒː
مذی	mæziː
مرا	mæɾɒː
مراعات	moɾɒːʔɒːt
مراعات کردن	moɾɒːʔɒːtkæɾdæn
مراکش	mæɾɒːkeʃ
مراکشی	mæɾɒːkeʃiː
مربع	moɾæbæ
مرجان	mæɾd͡ʒɒːn
مرحله	mæɾhæle
مرخصی	moɾæxxæsiː
مرخصی گرفتن	moɾæxxæsiːɡeɾeftæn
مرد	mæɾd
مرداد	moɾdɒːd
مردانه	mæɾdɒːnæ,mæɾdɒːne
مردانگی	mæɾdɒːneɡiː
مردم	mæɾdom
مردمسالاری	mæɾdomsɒːlɒːɾiː
مردمک	mæɾdomæk
مردم‌سالاری	mæɾdomsɒːlɒːɾiː
مردم‌شناسی	mæɾdomʃenɒːsiː
مردن	moɾdæn
مردن زدن	moɾdænzædæn
مرده	moɾde
مردگی	moɾdeɡiː
مرسی	meɾsiː
مرض	mæɾæz
مرض قند	mæɾæzeɢænd
مرغ	moɾɢ
مرغ خانگی	moɾɢexɒːneɡiː
مرغ مگس‌خوار	moɾɢemæɡæsxɒːɾ
مرغابی	moɾɢɒːbiː
مرغابی جره	moɾɢɒːbiːjed͡ʒæɾɾe
مركزي	mæɾkæziː
مرمر	mæɾmæɾ
مرموز	mæɾmuːz
مرو	mæɾv
مروارید	mæɾvɒːɾiːd
مرور	moɾuːɾ
مرور کردن	moɾuːɾkæɾdæn
مرورگر	moɾuːɾɡæɾ
مريض	mæɾiːz
مرکب	moɾækkæb
مرکز	mæɾkæz
مرگ	mæɾɡ
مریخ	meɾɾiːx
مریخی	meɾɾiːxiː
مریض	mæɾiːz
مریم	mæɾjæm
مریم مقدس	mæɾjæmemoɢæddæs
مزار شریف	mæzɒːɾeʃæɾiːf
مزد	mozd
مزرعه	mæzɾæʔe
مزمور	mæzmuːɾ
مس	mes
مسئله	mæsæle
مسابقه	mosɒːbeɢe
مسابقه دادن	mosɒːbeɢedɒːdæn
مسافر	mosɒːfeɾ
مسافرت کردن	mosɒːfeɾætkæɾdæn
مسافرخانهچی	mosæfeɾxɒːneht͡ʃiː
مست	mæst
مست تلو تلو خوردن سست	sostmæst
مستاجر	mostɒːʔd͡ʒeɾ
مستقل	mostæɢel
مستند	mostænæd
مستندات	mostænædɒːt
مستی	mæstiː
مستی زدن	mæstiːzædæn
مسجد	mæsd͡ʒed
مسلخ	mæslæx
مسلسل	mosælsæl
مسلسل گاتلینگ	mosælsælɡɒːtliːnɡ
مسلمان	mosælmɒːn
مسلمانی	mosælmɒːniː
مسلمون	mosælmuːn
مسواک	mesvɒːk
مسواک زدن	mesvɒːkzædæn
مسواک کردن	mesvɒːkkæɾdæn
مسکه	mæske
مسکو	moskuː
مسی	mesiː
مسیح	mæsiːh
مسیحی	mæsiːhiː
مسیحیت	mæsiːhiːjæt
مسین	mesiːn
مش	meʃ
مش زدن	meʃzædæn
مش کردن	meʃkæɾdæn
مشابه	moʃɒːbe
مشام	mæʃɒːm
مشام زدن	mæʃɒːmzædæn
مشاهده	moʃɒːhede
مشاهده کردن	moʃɒːhedekæɾdæn
مشت	moʃt
مشت خوردن	moʃtxoɾdæn
مشت زدن	moʃtzædæn
مشتاق بودن	moʃtɒːɢbuːdæn
مشتری	moʃtæɾiː
مشتق	moʃtæɢ
مشتق گرفتن	moʃtæɢɡeɾeftæn
مشرق	mæʃɾeɢ
مشروب	mæʃɾuːb
مشغول	mæʃɢuːl
مشق	mæʃɢ
مشنگ	mæʃænɡ
مشهد	mæʃhæd
مشک	moʃk
مشکل	moʃkel
مشکی	meʃkiː
مشیمیه	mæʃiːmiːje
مصاحبه	mosɒːhebe
مصاحبه کردن	mosɒːhebekæɾdæn
مصادره	mosɒːdeɾe
مصر	mesɾ
مصرف کننده	mæsɾæfekonænde
مضراب	mezɾɒːb
مطاله	motɒːle
مطاله کردن	motɒːlekæɾdæn
مطب	mætæb
مطب زدن	mætæbzædæn
مطبوعات	mætbuːʔɒːt
مطمئن	motmæʔenn,motmæʔen
مظلومیت	mæzluːmiːæt
مظلومیت زدن	mæzluːmiːætzædæn
معادله	moʔɒːdele
معاشرت	moʔɒːʃeɾæt
معاشرت کردن	moʔɒːʃeɾætkæɾdæn
معاصر	moʔɒːseɾ
معالجه	moʔɒːled͡ʒe
معالجه شدن	moʔɒːled͡ʒeʃodæn
معالجه کردن	moʔɒːled͡ʒekæɾdæn
معامله	moʔɒːmele
معامله زدن	moʔɒːmelezædæn
معاهده	moʔɒːhæde
معاینه	moʔɒːjene
معاینه کردن	moʔɒːjenekæɾdæn
معتاد	motɒːd
معتبر	moʔtæbæɾ
معجزه	moʔd͡ʒeze
معجزه‌آسا	moʔd͡ʒezeɒːsɒː
معدنی	mæʔdæniː
معده	meʔde
معذرت می‌خواهم	mæʔzeɾætmiːxɒːhæm
معرفت	mæʔɾefæt
معرفی	moʔæɾɾefiː
معرفی شدن	moʔæɾɾefiːʃodæn
معرفی کردن	moʔæɾɾefiːkæɾdæn
معشوق	mæʔʃuːɢ
معشوقه	mæʔʃuːɢe
معلق	mællæɢ,moʔællæɢ
معلق زدن	mællæɢzædæn
معلم	moʔællem
معلوم	mæʔluːm
معلّم	moællem
معمار	meʔmɒːɾ
معماری	meʔmɒːɾiː
معمول	mæʔmuːl
معمولا	mæʔmuːlæn
معمولی	mæʔmuːliː
معنی	mæʔniː
معنی کردن	mæʔniːkæɾdæn
معنی‌شناسی	mæʔniːʃenɒːsiː
معیار	meʔjɒːɾ
مغ	moɢ
مغاره	mæɢɒːɾe
مغازه	mæɢɒːze
مغازه زدن	mæɢɒːzezædæn
مغرب	mæɢɾeb
مغرب عربی	mæɢɾebʔæɾæbiː
مغرور	mæɢɾuːɾ
مغز	mæɢz
مغولستان	moɢolestɒːn
مغولی	moɢuːliː
مفت	moft
مفتی	moftiː
مفصل	mæfsæl
مفعول	mæfʔuːl
مفقود	mæfɢuːd
مفهوم	mæfhuːm
مفید	mofiːd
مقاله	mæɢɒːle
مقام	mæɢɒːm
مقایسه	moɢɒːjese
مقایسه کردن	moɢɒːjesekæɾdæn
مقدار	meɢdɒːɾ
مقدار زیاد	meɢdɒːɾeziːjɒːd
مقدس	moɢæddæs
مقدمه	moɢæddæme
مقدونی	mæɢduːniː
مقدونیه	mæɢduːniːje
مقعد	mæɢʔæd
مقعدی	mæɢʔædiː
مقیاس ریشتر	meɢjɒːsɾiːʃteɾ
ملاحظه	molɒːheze
ملاحظه فرمودن	molɒːhezekæɾdæn
ملافه	mælɒːfe
ملاقات	molɒːɢɒːt
ملاقات کردن	molɒːɢɒːtkæɾdæn
ملال آور	mælɒːlɒːvæɾ
ملخ	mælæx
ملخ زدن	mælæxzædæn
ملیت	melliːjjæt
ممنوع	memnuː
ممنوع است	memnuːæst
ممنون	mæmnuːn
ممنونم	mæmnúnæm
ممکن	momken
من	mæn
منار	menɒːɾ
مناره	menɒːɾe
منبع	mænbæ
منت	mennæt
منتظر شدن	montæzeɾʃodæn
منداغان	mændɒːɢɒːn
منزل	mænzel
منزل داشتن	mænzeldɒːʃtæn
منزلت	mænzelæt
منشار	menʃɒːɾ
منشی	monʃiː
منطق	mænteɢ
منظره	mænzæɾe
منظومه شمسی	mænzuːmeʃæmsiː
منقرض	monɢæɾez
منچوری	mænt͡ʃuːɾiː
منگنز	mænɡènèz
منگنه	mænɡæne
منگنه زدن	mænɡænezædæn
منگنه کردن	mænɡænekæɾdæn
منی	mæniː,moniː
مه	mə,mɒːh,mæh,me
مه تنک	meetonok
مهاجر	mohɒːd͡ʒeɾ
مهاجرت	mohɒːd͡ʒeɾæt
مهار	mæhɒːɾ
مهار زدن	mæhɒːɾzædæn
مهار کردن	mæhɒːɾkæɾdæn
مهاچین	mæhɒːt͡ʃiːn
مهبانگ	mæhbɒːnɡ
مهبل	mæhbæl
مهتاب	mæhtɒːb
مهتر	mæhtæɾ,mehtæɾ
مهر	mohɾ,mehɾ
مهر خوردن	mohɾxoɾdæn
مهر زدن	mohɾzædæn
مهر ورزیدن	mehɾvæɾziːdæn
مهر کردن	mohɾkæɾdæn
مهرابه	mehɾɒːbe
مهربان	mehæɾbɒːn,mehɾæbɒːn
مهربانی	mehɾæbɒːniː
مهره‌دار	mohɾedɒːɾ
مهم	mohem
مهمان	mehmɒːn
مهمانسرا	mehmɒːnsæɾɒː
مهمانی	mehmɒːniː
مهمانی منزل مبارکی	mehmɒːniːjemænzelemobɒːɾækiː
مهندس	mohændes
مهندسی	mohændesiː
مو	mo,muː
مو زدن	muːzædæn
موافق بودن	movɒːfeɢbuːdæn
موبایل	mobɒːjl,mobɒːiːl
موت	mouːt
موتور	اسم
موتورسیکلت	motoɾsiːklet
موتورولا	motoɾolɒː
موتورگازی	motoɾɡɒːziː
موج	moʊd͡ʒ
موج زدن	moʊd͡ʒzædæn
مور	muːɾ
مورمانسک	muːɾmɒːnsk
مورچه	muːɾt͡ʃe
موریانه	muːɾiːjɒːne
موز	moʊz,mouːz
موزامبیک	muːzɒːmbiːk
موزه	muːze
موزیک	muːziːk
موس	moʊs,muːs
موسم	mæuːsæm
موسولینی	muːsuːliːniː
موسی	muːsɒː
موسیقی	muːsiːɢiː
موش	muːʃ
موش شبگرد	muːʃeʃæbɡæɾd
موشواره	muːʃvɒːɾæ
موشک	muːʃæk
موشک خوردن	muːʃækxoɾdæn
موشک زدن	muːʃækzædæn
موشکافی کردن	muːŝekɒːfiːkæɾdæn
موشی	muːʃiː
موش‌مردگی	muːʃmoɾdeɡiː
موش‌مردگی زدن	muːʃmoɾdeɡiːzædæn
موضوع	moʊzuː
موعظه	moʔeze
موعظه کردن	moʔezekæɾdæn
موفق باشی	movæffæɢbɒːʃiː
موفق باشید	movæffæɢbɒːʃiːd
مولداوی	muːldɒːviː
مولکول	molekuːl
موم	muːm
موم عسل	muːmæsæl
مومیا	muːmjɒː
مونته‌نگرو	monteneɡɾuː
مونیخ	muːniːx
موژیک	muːʒiːk
موی زهار	muːjezæhɒːɾ
ميانه	miːjɒːne,miːjɒːnæ
مياني	miːjɒːniː
ميليارد	miːljɒːɾd
مچ	mot͡ʃ
مچ دست	mot͡ʃedæst
مچ پا	mot͡ʃepɒː
مچ گرفتن	mot͡ʃɡeɾeftæn
مژه	moʒe
مژه زدن	moʒezædæn
مک	mek
مک زدن	mekzædæn
مکاتبه	mokɒːtebe
مکاتبه داشتن	mokɒːbebedɒːʃtæn
مکادونی	mækɒːduːniː
مکادونیه	mækɒːduːniːje
مکان	mækɒːn
مکانیک	mekɒːniːk
مکانیک کوانتوم	mekɒːniːkekvɒːntuːm
مکان‌ها	mækɒːnhɒː
مکزیک	mekziːk
مکعب	mokæʔæb
مکعب روبیک	mokæʔæbeɾuːbiːk
مکه	mække
مکیدن	mækiːdæn
مک‌دونالدز	mækdonɒːldz
مگر	mæɡæɾ
مگس	mæɡæs
مگس انگبین	mæɡæsænɡæbiːn
می	mej
می بینمت	miːbiːnæmet
می زدن	mejzædæn
میان	miːjɒːn,miːɒːn
میان گذاشتن	miːɒːnɡozɒːʃtæn
میانبر	miːɒːnboɾ
میانبر زدن	miːɒːnboɾzædæn
میاندوراه	miːjɒːndoɾɒːh
میانمار	mjɒːnmɒːɾ
میانه	miːjɒːne
میتوکندری	miːtokondɾiː
میخ	miːx
میخ زدن	miːxzædæn
میخی	miːxiː
میدان	mejdɒːn
میدان سرخ	mejdɒːnesoɾx
میر	miːɾ
میز	miːz
میزان	miːzɒːn,mîzɒːn
میش	miːʃ
میل	mejl
میل زدن	mejlzædæn
میل کردن	mejlkæɾdæn
میلک شیک	miːlkʃejk
میلیون	miːljuːn,miːljon
میمون	mejmuːn
مین	miːn
مینسک	miːnsk
مینو	miːnuː
میهن	miːhæn
میو	miːjuː
میوآن	mjuːɒːn
میوه	miːve
میکائیل	miːkɒːʔiːl
میکال	miːkɒːl
میکاییل	miːkɒːjiːl
میکرب	miːkɾob
میگو	mejɡuː
می‌خواست	míxɒːst
می‌خواستم	míxɒːstæm
می‌خواستند	míxɒːstænd
می‌خواستی	míxɒːstiː
می‌خواستید	míxɒːstiːd
می‌خواستیم	míxɒːstiːm
می‌خواهد	míxɒːhæd
می‌خواهم	míxɒːhæm
می‌خواهند	míxɒːhænd
می‌خواهی	míxɒːhiː
می‌خواهید	míxɒːhiːd
می‌خواهیم	míxɒːhiːm
م‍ﮩ‍ر	mohoɾ
نئره	næɾe
نئونازی	neʔuːnɒːziː
ناامید	næomiːd
ناب	nɒːb
نابرادری	nɒːbæɾɒːdæɾiː
نابه هنگام	nɒːbehænɡɒːm
نابود کردن	nɒːbuːdkæɾdæn
نابودی	nɒːbuːdiː
نابکار	nɒːbekɒːɾ
نابینا	nɒːbiːnɒː
نابینایی	nɒːbiːnɒːjiː
ناتاراجا	nɒːtɒːɾɒːd͡ʒɒː
ناتنی	nɒːtæniː
ناتو	nɒːto
ناجور	nɒːd͡ʒuːɾ
ناخدا	nɒːxodæ
ناخن	nɒːxon
ناخن زدن	nɒːxonzædæn
ناخن کشیدن	nɒːxonzædæn
ناخنک	nɒːxonæk
ناخنک 	nɒːxonæk
ناخنک  زدن	nɒːxonækzædæn
ناخنک کردن	nɒːxonækkæɾdæn
ناخواهری	nɒːxwɒːhæɾiː
ناخوشایند	nɒːxuːʃɒːjænd
ناخوشی	nɒːxuːʃiː,nɒːxoʃiː
ناخوشی زدن	nɒːxoʃiːzædæn
نادانی	nɒːdɒːniː
نادانی زدن	nɒːdɒːniːzædæn
نادختری	nɒːdoxtæɾiː
نادر	nɒːdeɾ
نادیا	nɒːdiːjɒː
نارسا گویی	nɒːɾæsɒːɡuːjiː
نارنج	nɒːɾend͡ʒ,nɒːɾænd͡ʒ
نارنجک	nɒːɾend͡ʒæk
نارنجی	nɒːɾænd͡ʒiː,nɒːɾend͡ʒiː
نارنجی سیر	nɒːɾend͡ʒiːsiːɾ
نارنگ	nɒːɾenɡ,nɒːɾænɡ
نارنگی	nɒːɾenɡiː
نارو	nɒːɾo
نارو خوردن	nɒːɾoxoɾdæn
نارو زدن	nɒːɾozædæn
نارگیل	nɒːɾɡiːl
نارگیله	nɒːɾɡiːle
ناز	nɒːz
نازنین	nɒːzæniːn
نازک	nɒːzek
نازی	nɒːziː
نازیسم	nɒːziːsæm
ناسا	nɒːsɒː
ناسازگار	nɒːsɒːzɡɒːɾ
ناسازگاری	nɒːsɒːzɡɒːɾiː
ناشایست	nɒːʃɒːjest
ناشتا	nɒːʃtɒː
ناشنوا	nɒːʃenævɒː
ناف	nɒːf
نافرمان	nɒːfæɾmɒːn
نافرمانی	nɒːfæɾmɒːniː
ناقص	nɒːɢes
ناكار	nɒːkɒːɾ
ناله	nɒːle,nɒːlæ
ناله زدن	nɒːlezædæn
ناله کردن	nɒːlekæɾdæn
ناله کشیدن	nɒːlekeʃiːdæn
نالیدن	nɒːliːdæn
نام	nɒːm
نام خانوادگی	nɒːmexɒːnevɒːdeɡiː
نامادری	nɒːmɒːdæɾiː
نامبردن	nɒːmboɾdæn
نامزد	nɒːmzæd
نامزدن	nɒːmzædæn
نامه	nɒːme
نامه به افسسیان	næmhbhæfssɒːn
نامْور	nɒːmvæɾ
نامک	nɒːmæk
نامیدن	nɒːmiːdæn
نام‌آوا	nɒːmɒːvɒː
نام‌واژه	nɒːmvɒːʒe
نان	nɒːn
نان تست	nɒːnetost
نانوا	nɒːnvɒː
نانوائی	nɒːnvɒːʔiː,nɒːnevɒːʔiː
نانوایی	nɒːnvɒːjiː
ناهار	nɒːhɒːɾ
ناهمگون	nɒːhæmɡuːn
ناهید	nɒːhiːd
ناو	nɒːv
ناواهو	nɒːvɒːho
ناپدری	nɒːpedæɾiː
ناپسری	nɒːpesæɾiː
ناکارامد	nɒːkɒːɾɒːmæd
ناکافی	nɒːkɒːfiː
ناگازاکی	næɡæzɒːkiː
ناگهان	nɒːɡæhɒːn
نای	nɒːj
نایاب	nɒːjɒːb
نایلون	nɒːjlon
نایپیداو	nɒːjpiːdɒːv
نبرد	næbæɾd
نبض	næbz
نبض گرفتن	næbzɡeɾeftæn
نبیره	næbiːɾe
نتیجه	nætiːd͡ʒe
نجات	ned͡ʒɒːt
نجات دادن	ned͡ʒɒːtdɒːdæn
نجم	næd͡ʒm
نجّار	næd͡ʒd͡ʒɒːɾ
نجیب	næd͡ʒiːb
نحو	næhv
نخجوان	næxd͡ʒevɒːn
نخست	noxost
نخست وزیر	noxostvæziːɾ
نخستین	noxostiːn
نخود	noxod
نخیر	næxejɾ
ندا	nedɒː
ندیده	nædiːde
نر	næɾ
نراد	næɾɒːd
نرد	næɾd
نردبان	næɾdebɒːn,næɾdobɒːn,næɾdæbɒːn
نرم	næɾm
نرمهٔ گوش	næɾmejeɡuːʃ
نرم‌افزار	næɾmæfzɒːɾ
نرم‌تن	næɾmtæn
نروژ	noɾveʒ
نرگس	næɾɡes
نزد	næzd
نزدیک	næzdiːk
نزدیک شدن	næzdiːkŝodæn
نزدیکان	næzdiːkɒːn
نسبت	nesbæt
نسبت دادن	nesbætdɒːdæn
نسبی	nesbiː
نستعلیق	næstæʔliːɢ
نسخه خطی	nosxejexættiː
نسل	næsl
نسک	næsk
نشان	neŝɒːn,neʃɒːn
نشان دادن	neʃɒːndædɒːn,neʃɒːndɒːdæn,neʃɒːndɒːdæn
نشان زرین	neʃɒːnezæɾiːn
نشانه	neʃɒːneneʃɒːn
نشانه گرفتن	neʃɒːneɡeɾeftæn
نشانه‌شناسی	neʃɒːneʃenɒːsiː
نشانه‌های سجاوندی	neʃɒːnehɒːjesæd͡ʒɒːvændiː
نشانه‌گذاری	neʃɒːneɡozɒːɾiː
نشانه‌گذاری شدن	neʃɒːneɡozɒːɾiːʃodæn
نشانه‌گذاری کردن	neʃɒːneɡozɒːɾiːkæɾdæn
نشریه	næʃɾiːje
نشریه زدن	næʃɾiːjezædæn
نشست	neʃæst
نشستن	neʃæstæn
نشیمن	neʃiːmæn
نشین	neʃiːn
نصب	næsb
نصب شدن	næsbʃodæn
نصب کردن	næsbkæɾdæn,næsbkæɾdæn
نصف	nesf
نصیحت	næsiːhæt
نطفه	notfæ
نطق	notɢ
نطق کردن	notɢkæɾdæn
نظاره	nezɒːɾe
نظاره کردن	nezɒːɾekæɾdæn
نظر	næzæɾ
نظر خوردن	næzæɾxoɾdæn
نظر داشتن	næzæɾdɒːʃtæn
نظر زدن	næzæɾzædæn
نظر کردن	næzæɾkæɾdæn
نظر گرفتن	næzæɾɡeɾeftæn
نظم	næzm
نظم دادن	næzmdɒːdæn
نعره	næ’ɾe
نعره زدن	næ’ɾezædæn
نعره کشیدن	næ’ɾekeʃiːdæn
نعل	næʔl
نعل اسب	næʔleæsb
نعل کردن	næʔlkæɾdæn
نعلبند	nælbænd
نعلچیک	næʔlt͡ʃiːk
نعناع	næʔnɒːʔ
نعوظ	noʻuːz
نفت	næft
نفر	næfæɾ
نفرت	næfɾæt
نفرت داشتن	nefɾætdɒːʃtæn
نفرین	nefɾiːn
نفرین ابدی	nefɾiːneæbædiː
نفرین کردن	nefɾiːnkæɾdæn
نفس	næfæs,næfs
نفس زدن	næfæszædæn
نفس نفس	næfæsnæfæs
نفس نفس زدن	næfæsnæfæszædæn
نفس کشیدن	næfæskeʃiːdæn
نفهمی	næfæhmiː
نفهمی زدن	næfæhmiːzædæn
نفوس بد	nofuːsebæd
نفوس بد زدن	nofuːsebædzædæn
نق	neɢ
نق زدن	neɢzædæn,neɢzædæn
نقاب	neɢɒːb
نقاب زدن	neɢɒːbzædæn
نقاد	næɢɒːd
نقاش	næɢɢɒːʃ
نقاشی	næɢɢɒːʃiː
نقاشی شدن	næɢɢɒːʃiːʃodæn
نقاشی کردن	næɢɢɒːʃiːkæɾdæn
نقاله	næɢɢɒːle
نقب	næɢb
نقب زدن	næɢbzædæn
نقد	næɢd
نقره	noɢɾe
نقره فام	noɢɾefæm
نقره‌ای	noɢɾeʔiː,noɢɾejiː
نقره‌فام	noɢɾefɒːm
نقش	næɢʃ
نقش زدن	næɢʃzædæn
نقش کشیدن	næɢʃkeʃiːdæn
نقشه	næɢʃe
نقشه کشیدن	næɢʃekeʃiːdæn
نقصان	noɢsɒːn
نقصان گرفتن	noɢsɒːnɡeɾeftæn
نقصان یافتن	noɢsɒːnjɒːftæn
نقطه	noɢte
نقطه لاگرانژی	noɢtejelɒːɡɾɒːnʒiː
نقطه‌ویرگول	noɢteviːɾɡuːl
نقطه‌ی ذوب	noɢtejezob
نقل	noɢl,næɢl
نقل کردن	næɢlkæɾdæn
نقلی	næɢliː
نقّاش	næɢɢɒːʃ
نم	næm
نم زدن	næmzædæn
نم کردن	næmkæɾdæn
نم کشیدن	næmkeʃiːdæn
نماد	næmɒːd
نماز	næmɒːz
نماز خواندن	næmɒːzxɒːndæn
نمایاندن	næmɒːjɒːndæn
نمایش	næmɒːjeʃ
نمایشگاه	næmɒːjeʃɡɒːh
نمایه	næmɒːje
نمودار	nemuːdɒːɾ
نمودن	nemuːdæn
نمونه	nemuːne,nomuːne
نمک	næmæk
نمک زدن	næmækzædæn
نمکین	næmækiːn
ننگ	nænɡ
ننگ زدن	nænɡzædæn
نه	noh,næh,næ
نه هزار	nohhæzɒːɾ
نهان	nehɒːn
نهانی	nehɒːniː
نهایتا	næhɒːjætæn
نهر	næhɾ
نهسد	nohsæd
نهصد	nohsæd
نهم	nohom
نهنگ	næhænɡ
نهیب	næhiːb
نهیب زدن	næhiːbzædæn
نو	noʊ,nouː,nuː
نواختر	nouːæxtæɾ
نوازش	nævɒːzeʃ
نوازش دادن	nævɒːzeʃdɒːdæn
نوازش کردن	nævɒːzeʃkæɾdæn
نوامبر	novɒːmbɾ
نوتلا	nuːtelɒː
نود	nævæd
نور	nuːɾ
نورنبرگ	nuːɾænbeɾɡ
نوروز	nouːɾuːz
نوزاد	nouːzɒːd
نوزده	nuːzdæh
نوش جان	nuːʃed͡ʒɒːn
نوشابه	nuːʃɒːbæ,nuːʃɒːbe
نوشابه زدن	nuːʃæbezædæn
نوشتن	neveʃtæn,næveʃtæn
نوشته	neveʃte
نوشیدن	nuːʃiːdæn
نوشیدنی	nuːʃiːdæniː
نوشیدنی الکلی	nuːʃiːdæniːjeælkoliː
نوع	noʊ,noʊʔ
نون	nuːn
نوه	næve
نوک	nok
نوک زدن	nokzædæn
نوک پستان	nokepestɒːn
نوکر	nouːkæɾ
نوکیا	nuːkiːjɒː
نوک‌اردکی	nokoɾdækiː
نوگل	noʊɡol
نویسنده	neviːsænde
نویسه	neviːsæ
نویسه‌گردانی	neviːseɡæɾdɒːniː
نوین	noviːn
نيز	niːz
نپال	nepɒːl
نژاد	neʒɒːd
نژاد برتر	neʒɒːdebæɾtæɾ
نژاد پرستی	neʒɒːdpæɾæstiː
نژادپرستی	neʒɒːdpæɾæstiː
نژادی	neʒɒːdiː
نکاح	nekɒːh
نکن	nækon
نگار	neɡɒːɾ
نگاره	neɡɒːɾæ,neɡɒːɾe
نگاه	neɡɒːh
نگاه انداختن	neɡɒːhændɒːxtæn
نگاه داشتن	neɡɒːhdɒːʃtæn
نگاه دزدانه	neɡɒːhedozdɒːnæ
نگاه کردن	neɡɒːhkæɾdæn,neɡɒːhkæɾdæn
نگاه‌کردن	neɡɒːhkæɾdæn
نگران	neɡæɾɒːn
نگره	neɡæɾe
نگریستن	neɡæɾiːstæn
نگه داشتن	neɡæhdɒːʃtæn
نگهبان	neɡæhbɒːn
نگهداری	neɡæhdɒːɾiː
نگهداری کردن	neɡæhdɒːɾiːkæɾdæn
نی	nej
نی زدن	nejzædæn
نیاز	niːjɒːz
نیاهندواروپایی	niːjɒːhendooɾuːpɒːjiː
نیاهندواروپایی‌زبان	niːjɒːhendooɾuːpɒːjiːzæbɒːn
نیاهندوایرانی	niːjɒːhendoiːɾɒːniː
نیاهندو‌اروپایی	niːjɒːhendooɾuːpɒːjiː
نیایش	niːjɒːjeʃ
نیتریک اسید	niːtɾiːkæsiːd
نیجر	niːd͡ʒeɾ
نیجریه	niːd͡ʒeɾiːje
نیرنگ	nejɾænɡ
نیرنگ زدن	nejɾænɡzædæn
نیرنگباز	nejɾænɡbɒːz
نیروگاه	niːɾuːɡɒːh
نیروی برانگیزنده	niːɾuːjebæɾɒːnɡiːzænde
نیروی دریایی	niːɾuːjedæɾjɒːjiː
نیروی هوائی	niːɾuːjehævɒːjiː
نیز	niːz
نیزه	nejze
نیزه‌دار	nejzedɒːɾ
نیس	niːs
نیش	niːʃ
نیش زدن	niːʃzædæn
نیش و کنایه	niːʃokenɒːje
نیش و کنایه زدن	niːʃokenɒːjezædæn
نیشتر	niːʃtæɾ
نیشتر زدن	niːʃtæɾzædæn
نیشخند	niːʃxænd
نیشخند زدن	niːʃxændzædæn
نیشکر	nejʃækæɾ
نیشگون	niːʃɡuːn
نیشگون گرفتن	niːʃɡuːnɡeɾeftæn
نیل	niːl
نیلوفر آبی	niːluːfæɾeɒːbiː
نیلی	niːliː
نیم	niːm
نیمروز	niːmɾuːz
نیمسال تحصیلی	niːmsɒːltæhsiːliː
نیمه‌عمر	niːmeʔomɾ
نیمکت	niːmkæt
نیم‌خط	niːmxæt
نینجوتسو	niːnd͡ʒuːtsuː
نینوا	nejnævɒː
نیوزیلند	niːjuːziːlend
نیویورک	njuːjuːɾk
نیک	niːk
نیکاراگوئه	niːkɒːɾɒːɡuːʔe
نیکل	niːkel
ها	hɒː
هابیل	hɒːbiːl
هات داگ	hɒːtdɒːɡ
هادرون	hɒːdɾon
هادسون	hɒːdsuːn
هارد راک	hɒːɾdɾɒːk
هاردکور	hɒːɾdkoɾ
هاسی	hɒːsej
هاشور	hɒːʃuːɾ
هاشور خوردن	hɒːʃuːɾxoɾdæn
هاشور زدن	hɒːʃuːɾzædæn
هالتر	hɒːlteɾ
هالتر زدن	hɒːlteɾzædæn
هاله	hɒːle
هالو	hɒːluː
هالووین	hɒːlouːviːn
هالیوود	hɒːliːvuːd
هامین	hɒːmiːn
هانوی	hɒːnuːj
هاوائ	hævɒːiː
هاوانا	hɒːvɒːnɒː
هاکی	hɒːkiː
هاید پارک	hɒːjdpɒːɾk
هاینه	hɒːjne
هتل	hotel
هجده	hed͡ʒdæh
هجوم	hod͡ʒuːm
هجوم آوردن	hod͡ʒuːmɒːvæɾdæn
هخامنشی	hæxɒːmæneʃiː
هخامنشیان	hæxɒːmæneʃiːɒːn
هدایت	hedɒːjæt
هدایت شدن	hedɒːjætʃodæn
هدایت کردن	hedɒːjætkæɾdæn
هدف	hædæf
هدهد	hodhod
هدیه	hedje,hædiːje,hediːje
هدیه کردن	hedjekæɾdæn
هر	hæɾ
هر از گاهی	hæɾæzɡɒːhiː
هر دو	hæɾdo
هر چند وقت یک بار	hæɾt͡ʃændvæɢtjekbɒːɾ
هر چیز	hæmet͡ʃiːz
هرات	heɾɒːt
هرازدان	heɾɒːzdɒːn
هراس	hæɾɒːs
هردو	hæɾdo
هرزه	hæɾzæ
هرزه‌نگاری	hæɾzeneɡɒːɾiː
هرم بزرگ جیزه	hæɾæmbozoɾɡd͡ʒîze
هرچند	hæɾt͡ʃænd
هرچه زودتر	hæɾt͡ʃezuːdtæɾ
هرگز	hæɾɡez
هریوا	hæɾejvɒː
هزار	hezɒːɾ
هزاردستان	hæzɒːɾdæstɒːn
هزاره	hezɒːɾe
هزاره‌ی سوم	hezɒːɾejesevvom
هزارپا	hezɒːɾpɒː
هست	hæst
هستم	hæstæm
هسته	hæste,hæstæ
هسته‌ای	hæsteʔiː
هستی	hæstiː,hæsiː
هستی‌گرایی	hæstiːɡeɾɒːjiː
هسپانیه	hespɒːniːje
هش	hæʃ
هشت	hæʃt
هشتاد	hæʃtɒːd
هشتسد	hæʃtsæd
هشتصد	hæʃtsæd
هشتم	hæʃtom
هشت‌پا	hæʃtpɒː
هشیاری	hoʃjɒːɾiː
هفت	hæft
هفتاد	hæftɒːd
هفتصد	hæftsæd
هفتم	hæftom
هفته	hæfte
هفته‌ی آینده	hæftejeɒːjænde
هفته‌ی گذشته	hæftejeɡozæʃte
هفده	hefdæh,hefdæʔ
هل	hel
هل دادن	holdɒːdæn
هلال احمر	helɒːleæhmæɾ
هلال حاصلخیز	helɒːlehɒːselxiːz
هلند	holænd
هلندی	holændiː
هلندی‌ها	holændiːhɒː
هلنی	heleniː
هله‌لویا	hæleluːjɒː
هله‌هوله	hælehuːle
هلو	holuː
هلیکوپتر	heliːkuːpteɾ
هم	hæm
هم خوردن	hæmxoɾdæn
هم زدن	hæmzædæn
هما	homɒː
همانی	hæmɒːniː
هماهنگ	hæmɒːhænɡ
هماورد	hæmɒːvæɾd
همايش	hæmɒːjeʃ
همایش	hæmɒːjeʃ
همبرگر	hæmbeɾɡeɾ
همبستر	hæmbæstæɾ
همجنس‌گرا	hæmd͡ʒensɡæɾɒː
همخوابگی	hæmxɒːbeɡj
همدستی	hæmdæstiː
همدستی در جرم	hæmdæstiːdæɾd͡ʒoɾm
همدستی کردن	hæmdæstiːkæɾdæn
همرقص	hæmɾæɢs
همروزگار	hæmɾuːzeɡɒːɾ
همزاد	hæmzɒːd
همزه	hæmze
همساخته	hæmsɒːxtæ
همسان درمانی	hæmsɒːndæɾmɒːniː
همسایه	hæmsɒːje,hæmsɒːjæ
همسر	hæmsæɾ
همسنجی	hæmsænd͡ʒiː
هملت	hæmlet
همنوا	hæmnævɒː
همنوع‌خواری	hæmnouːʔxɒːɾiː
همنژادان	hæmnæʒɒːdɒːn
همه	hæme
همه‌چیز	hæmet͡ʃiːz
هموندان	hæmvændɒːn
همچنین	hæmt͡ʃeniːn
همکار	hæmkɒːɾ
همکاری	hæmkɒːɾiː
همکاری کردن	hæmkɒːɾiːkæɾdæn
همکلاس	hæmkelɒːs
همگام	hæmɡɒːm
همگام‌سازی	hæmɡɒːmsɒːziː
همیستار	hæmiːstɒːɾ
همیشه	hæmiːʃe
همین	hæmiːn
هم​بستر شدن	hæmbæstæɾʃodæn
هم‌جنس‌گرایی	hæmd͡ʒensɡæɾɒːjiː
هم‌معنی	hæmmæʔniː
هنباز	hænbɒːz
هند	hend
هندایرانی	hendiːɾɒːniː
هندسه	hendese
هندسه اقليدسی	hendeseoɢliːdsiː
هندو	henduː
هندوانه	hendevɒːne
هندوایرانی	hendoiːɾɒːniː
هندوستان	henduːstɒːn
هندوستانی	henduːstɒːniː
هندوکش	henduːkuːʃ
هندو‌اروپایی	hendooɾuːpejiː
هندی	hendiː
هنر	honæɾ
هنر رزمی	honæɾeɾæzmiː
هنرمند	honæɾmænd
هنرپیشه	honæɾpiːʃe
هنوز	hænuːz
هنگ کنگ	honɡkonɡ
هنگامی که	hænɡɒːmiːke
هنگ‌کنگ	honɡkonɡ
هوا	hævɒː
هوا دادن	hævɒːdɒːdæn
هوادار	hævɒːdɒːɾ
هوار	hævɒːɾ
هوار زدن	hævɒːɾzædæn
هوار کشیدن	hævɒːɾkeʃiːdæn,hævɒːɾkeʃiːdæn
هواپيما	hævɒːpejmɒː
هواپیما	hævɒːpejmɒː
هورمون	huːɾmuːn
هوس	hævæs
هوس کردن	hævæskæɾdæn
هوش	huːʃ
هوشمند	huːʃmænd,huːŝmænd
هول	hoʊl
هول زدن	hoʊlzædæn
هولی	holiː
هوموفوبیا	huːmuːfuːbiːjɒː
هوو	hævuː
هویج	hæviːd͡ʒ
هپاتیت	hiːpɒːtiːt
هکر	hækeɾ
هیجان	hæjæd͡ʒɒːn,hiːd͡ʒɒːn
هیجان آمدن	hæjæd͡ʒɒːnɒːmædæn
هیجان آوردن	hæjæd͡ʒɒːnɒːvæɾdæn
هیجده	hiːd͡ʒdæh
هیدرولیک	hiːdɾoliːk
هیدرولیکی	hiːdɾoliːkiː
هیدروژن	hiːdɾod͡ʒen
هیدروژن پراکسید	hiːdɾoʒenpeɾɒːksiːd
هیدروکلریک اسید	hiːdɾokoloɾiːkæsiːd
هیره	hiːɾe
هیزم	hiːzom
هیل	hiːl
هیلاری	hiːlɒːɾiː
هیمه	hiːmæ
هیچ	hiːt͡ʃ
هیچ وقت	hiːt͡ʃvæɢt
هیچ گرداندن	hiːt͡ʃɡæɾdɒːndæn
هیچ‌چیز	hiːt͡ʃt͡ʃiːz
هیچ‌کس	hiːt͡ʃkæs
و	o,væ
وات	vɒːt
واتیکان	vɒːtiːkɒːn
واج	vɒːd͡ʒ
واحد نجومی	vɒːhednod͡ʒuːmiː
واحه	vɒːhe
وادی	vɒːdiː
وارسی	vɒːɾesiː
وارسی کردن	vɒːɾesiːkæɾdæn
واروژان	vɒːɾuːʒɒːn
واشنگتن	vɒːʃenɡton
وافن اس‌اس	vɒːfeneses
واقعی	vɒːɢeiː
وال	vɒːl
والده	vɒːlede
والدین	vɒːledejn
والیبال	vɒːliːbɒːl
وام‌واژه	vɒːmvɒːʒe
وان	vɒːn
واو	vɒːv
واژن	vɒːʒæn
واژه	vɒːʒe
واژهشناسی	vɒːʒeʃenæsiː
واژه‌نامه	vɒːʒenɒːme
واژگان	vɒːʒeɡɒːn
واکس	vɒːks
واکس زدن	vɒːkszædæn
واکسن	vɒːksæn
واکسن زدن	vɒːksænzædæn
واکسن کردن	vɒːksænkæɾdæn
واکنشگاه هسته‌ای	vɒːkoneʃɡɒːhehæsteʔiː
واگن	vɒːɡon
وایفای	vɒːjfɒːj
وب نوشت	vebneveʃt
وبلاگ	veblɒːɡ
وبلاگ زدن	veblɒːɡzædæn
وب‌گاه	vebɡɒːh
وجد	væd͡ʒd
وجد آمدن	væd͡ʒdɒːmædæn
وجد آوردن	væd͡ʒdɒːvæɾdæn
وجود	vod͡ʒuːd
وجود آمدن	vod͡ʒuːdɒːmædæn
وجود آوردن	vod͡ʒuːdɒːvæɾdæn
وجود داشتن	vod͡ʒuːddɒːʃtæn
وحشت	væhʃæt
وحشت کردن	væhʃætkæɾdæn
وحشی	væhʃiː
وداع	vedɒːʔ
وداع کردن	vedɒːʔkæɾdæn
ودکا	vodkɒː
ور	veɾ
ور زدن	veɾzædæn
ورزا	væɾzɒː
ورزش	væɾzeʃ
ورزشگاه	væɾzeʃɡɒːh
ورشو	væɾʃouː
ورق 	væɾæɢ
ورق  خوردن	væɾæɢxoɾdæn
ورق  زدن	væɾæɢzædæn
ورقه	væɾæɢe
ورم	væɾæm
ورم کردن	væɾæmkæɾdæn
ورود	voɾuːd
ورودی	voɾuːdiː
وزن	væzn
وزن کردن	væznkæɾdæn
وزنه	væzne
وزنه زدن	væznezædæn
وزیر	væziːɾ
وسترن	vesteɾn
وسعت	vosʔæt
وسعت دادن	vosʔætdɒːdæn
وصفی	væsfiː
وصل	væsl
وصل کردن	væslkæɾdæn
وصلت	væslæt
وصلت کردن	væslætkæɾdæn
وصله	væsle
وصله زدن	væslezædæn
وصله کردن	væslekæɾdæn
وصول	vosuːl
وصول کردن	vosuːlkæɾdæn
وضعیت	vædiːjet
وضو	vozuː
وطن	vætæn
وعده	væʔde
وعده دادن	væʔdedɒːdæn
وق	væɢ
وق زدن	væɢzædæn
وقت	væɢt
وقت گل نی	væɢteɡolenej
وقتی	væɢtiː
وقتی که	væɢtiːke
ولادی‌وستوک	velɒːdiːvostuːk
ولاپوک	volɒːpuːk
ولت	volt
ولزی	velziː
ولزی‌ها	velziːhɒː
ولفرام	volfɾɒːm
ولوو	volvo
ولگا	volɡɒː
ولی	vɒːliː
ون	væn
ونزوئلا	venezuːelɒː
ونسان ونگوگ	vænsɒːnvænɡôɡ
ونکوور	vænkuːveɾ
ونگ	vænɡ
ونگ زدن	vænɡzædæn
ونگوگ	vænɡôɡ
وهم	væhm
ووتیک	votiːk
وول	vuːl
وول خوردن	vuːlxoɾdæn
وول زدن	vuːlzædæn
وولوگدا	vuːluːɡdɒː
وکیل	vækiːl
ویتنام	viːjætnɒːm
ویتنامی	viːjætnɒːmiː
ویرایش	viːɾɒːjeʃ
ویرایش کردن	viːɾɒːjeʃkæɾdæn
ویرایشگر	viːɾɒːjeʃɡæɾ
ویرگول	viːɾɡuːl
ویزا	viːzɒː
ویسکی	viːskiː
ویشنو	viːʃnuː
ویلا	viːllɒː,viːlɒː
ویلز	vejlz
وین	viːn
وینتیان	ventiːɒːn
ویولن	viːjolon
ویژه	viːʒæ
ویکتوریا	viːktuːɾiːjɒː
ویکی	viːkiː
ویکی‌واژه	viːkiːvɒːʒe
ویکی‌پدیا	viːkiːpediːjɒː
يشب	jæʃb
يشم	jæʃm
يوزپلنگ	juːzpælænɡ
پا	pɒː
پا افتادن	pɒːoftɒːdæn
پا زدن	pɒːzædæn
پاتولوژی	pɒːtuːluːʒiː
پادرد	pɒːdæɾd
پادرد زدن	pɒːdæɾdzædæn
پادرميانی	pɒːdæɾmiːɒːniː
پادرميانی کردن	pɒːdæɾmiːɒːniːkæɾdæn
پادزهر	pɒːdzæhɾ
پادشاه	pɒːdʃɒːh,pɒːdeʃɒːh
پادشاهی	pɒːdeʃɒːhiː,pɒːdʃɒːhiː
پادشاهی متحد	pɒːdeʃɒːhiːjemottæhed
پاراماریبو	pɒːɾɒːmɒːɾiːbuː
پارامسی	pɒːɾɒːmesiː
پاراگوئه	pɒːɾɒːɡuːʔe
پارس	pɒːɾs
پارس کردن	pɒːɾskæɾdæn
پارسال	pɒːɾsɒːl
پارسه	pɒːɾse
پارسی	pɒːɾsiː
پارو	pɒːɾuː
پارو زدن	pɒːɾuːzædæn
پارک	pɒːɾk
پارک ملی	pɒːɾkemelliː
پارکور	pɒːɾkuːɾ
پارکینگ	pɒːɾkiːnɡ
پاریس	pɒːɾiːs
پاسارگاد	pɒːsɒːɾɡɒːd
پاسبان	pɒːsbɒːn
پاستا	pɒːstæ
پاسخ	pɒːsox
پاسخ دادن	pɒːsoxdɒːdæn,pɒːsoxdɒːdæn
پاسپورت	pɒːspoɾt
پاشا	pɒːʃɒː
پاشنه	pɒːʃne
پاشنه کفش	pɒːʃnejekæfʃ
پالائی	pɒːlɒːʔiː
پالایش	pɒːlɒːjeʃ
پالایشگاه	pɒːlɒːjeʃɡɒːh
پالتو	pɒːlto
پالکی	pɒːlkiː
پامچال	pɒːmt͡ʃɒːl
پامیر	pɒːmiːɾ
پاناما	pɒːnɒːmɒː
پانجه​آ	pænd͡ʒēɒː
پانزده	pɒːnzdæh
پانصد	pɒːnsæd
پانچ	pɒːnt͡ʃ
پاپ	pɒːp
پاپایه	pɒːpɒːje
پاپوش	pɒːpoʃ
پاک	pɒːk
پاک کردن	pɒːkkæɾdæn
پاکت	pɒːkæt
پاکستان	pɒːkestɒːn
پاک‌کن	pɒːkken,pɒːkkon
پاگودا	pɒːɡodɒː
پای	pɒːj
پای افتادن	pɒːjoftɒːdæn
پای سیب	pɒːjesiːb
پایان	pɒːjɒːn
پایان دادن	pɒːjɒːndɒːdæn
پایان رساندن	pɒːjɒːnɾesɒːndæn
پایان رسیدن	pɒːjɒːnɾesiːdæn
پایان گرفتن	pɒːjɒːnɡeɾeftæn
پایان یافتن	pɒːjɒːnjɒːftæn
پایانه اتوبوس	pɒːjɒːnejeotobuːs
پایبندی	pɒːbændiː
پایتخت	pɒːjtæxt,pɒːjetæxt
پایتون	pɒːjton
پایداشتن	pɒːjdɒːʃtæn
پایه	pɒːjeʔ,pɒːje,pɒːjæ
پایگاه داده	pɒːjɡɒːhedɒːde
پایگاه داده‌ها	pɒːjɡɒːhedɒːdehɒː
پاییدن	pɒːeiːdæn,pɒːjiːdæn
پاییز	pɒːjiːz
پایین	pɒːjiːn
پایین پریدن	pɒːjiːnpæɾiːdæn
پتاسيم	potɒːsiːm
پتروسیان	petɾosjɒːn
پتو	pætuː
پخ	pæx
پخت و پز	poxtopæz
پختن	poxtæn
پخته	poxte
پخش	pæxʃ
پخش شدن	pæxʃʃodæn
پخش کردن	pæxʃkæɾdæn
پدر	pedæɾ
پدر و مادر	pedæɾomɒːdæɾ,pedæɾvæmɒːdæɾ
پدربزرگ	pedæɾbozoɾɡ
پدربزرگ و مادربزرگ	pedæɾbozoɾɡomɒːdæɾbozoɾɡ
پدرجد	pedæɾd͡ʒædd
پدرخوانده	pedæɾxwɒːnde
پدرزن	pedæɾzæn
پدرشوهر	pedæɾʃouːhæɾ,pedæɾʃoʊhæɾ
پدیدآورنده	pædiːdɒːvæɾænde
پذیرائی	pæziːɾɒːʔiː
پذیرایی	pæziːɾɒːjiː
پذیرایی کردن	pæziːɾɒːjiːkæɾdæn
پذیرفتن	pæziːɾoftæn
پر	poɾ,pæɾ
پر دادن	pæɾdɒːdæn
پر زدن	pæɾzædæn
پر و بال	pæɾobɒːl
پر و بال زدن	pæɾobɒːlzædæn
پر کردن	poɾkæɾdæn
پر کشیدن	pæɾkeʃiːdæn
پرانتز	pæɾɒːntez
پراگ	pɾɒːɡ
پرتاب	pæɾtɒːb
پرتاب کردن	pæɾtɒːbkæɾdæn
پرتغال	poɾtoɢɒːl
پرتغالی	poɾteɢɒːliː
پرتقال	poɾteɢɒːl
پرتو	pæɾtuː
پرث	peɾs
پرداختن	pæɾdɒːxtæn
پردازش داده‌ها	pæɾdɒːzeʃedɒːdehhɒː
پرده	pæɾde
پرده کرکره	pæɾdekeɾkeɾe
پرده گوش	pæɾdejeɡuːʃ
پردیس	pæɾdiːs
پررنگ	poɾɾænɡ
پرستار	pæɾæstɒːɾ
پرستو	pæɾæstuː
پرستیژ	peɾestiːd͡ʒ
پرسش	poɾseʃ
پرسه	pæɾse
پرسه زدن	pæɾsezædæn
پرسپولیس	peɾspoliːs
پرسیدن	poɾsiːdæn
پرش	pæɾeʃ
پرشکوه	poɾʃokuːh
پرل هاربر	peɾlhɒːɾboɾ
پرم	peɾm
پرماسیدن	pæɾmɒːsiːdæn
پرنده	pæɾænde
پرهام	pæɾhɒːm
پرهیز	pæɾhiːz
پرهیز کردن	pæɾhiːzkæɾdæn
پرو	peɾuː
پرواربندی	pæɾvɒːɾbændiː
پرواز	pæɾvɒːz
پرواز دادن	pæɾvɒːzdɒːdæn
پرواز کردن	pæɾvɒːzkæɾdæn,pæɾvɒːzkæɾdæn
پروانه	pæɾvɒːne
پروتئین	poɾoteiːn
پروتون	pɾuːtuːn
پروتکل اینترنت	pɾotokoleiːnteɾnet
پروستات	pɾostɒːt
پروستریکا	peɾostɾiːkɒː
پروسه	pɾose
پرونده	pæɾvænde
پرووکاتور	pɾovokɒːtoɾ
پروژه	pɾoʒe
پرپر	pæɾpæɾ
پرپر زدن	pæɾpæɾzædæn
پرچم	pæɾt͡ʃæm
پرگار	pæɾɡɒːɾ
پری	pæɾiː
پریدن	pæɾiːdæn
پریروز	pæɾiːɾuːz
پریشب	pæɾiːʃæb
پریشتینا	peɾiːʃtiːnɒː
پرینه	peɾiːne
پزشک	pezeʃk
پزشک زایمان	pezeʃkezɒːjemɒːn
پزشک زنان	pezeʃkezænɒːn
پزشک کودکان	pezeʃkekuːdækɒːn
پزشکی	pezeʃkiː
پزشکی قانونی	pezeʃkiːjeɢɒːnuːniː
پزنده	pæzændæ,pæzænde
پس	pæs,pos
پس از	pæsæz
پس از این	pæsæziːn
پس انداز	pæsændɒːz
پس انداز کردن	pæsændɒːzkæɾdæn
پس دادن	pæsdɒːdæn
پس زدن	pæszædæn
پس غذا	pæsɢæzɒː
پس فردا	pæsfæɾdɒː
پس کشیدن	pæskeʃiːdæn
پس گردنی	pæsɡæɾdæniː
پس گردنی زدن	pæsɡæɾdæniːzædæn
پساانسان	pæsɒːensɒːn
پست	pæst,post
پست الکترونیکی	posteelekteɾoniːkiː
پست سفارشی	postesefɒːɾʃiː
پست هوائی	posthævɒːjiː
پستان	pestɒːn
پستان بند	pestɒːnbænd
پستاندار	pestɒːndæɾ,pestɒːndɒːɾ
پستخانه	postxɒːne
پسته	peste
پستچی	postt͡ʃiː
پسر	pesæɾ
پسر برادر	pesæɾebæɾɒːdæɾ
پسر خواهر	pesæɾexwɒːhæɾ
پسرخاله	pesæɾxɒːle
پسرخوانده	pesæɾxwɒːnde
پسردائی	pesæɾdɒːʔiː
پسردایی	pesæɾdɒːjiː
پسرعمه	pesæɾæmme,pesæɾʔæmme
پسرعمو	pesæɾæmuː,pesæɾʔæmuː
پسند	pæsænd
پسند کردن	pæsændkæɾdæn
پسندیده	pæsændiːdæ,pæsændiːde
پسوند	pæsvænd
پسکوف	pskuːf
پسگک	pæsæɡæk
پس‌زمینه	pæszæmiːne
پس‌فردا	pæsfæɾdɒː
پس‌لرزه	pæslæɾze
پشت	poʃt
پشت سر هم	poʃtesæɾehæm
پشت پا	poʃtepɒː
پشت پا زدن	poʃtepɒːzædæn
پشت گردنی	poʃtɡæɾdæniː
پشت گردنی زدن	poʃtɡæɾdæniːzædæn
پشتو	pæʃto
پشتک	pæʃtæk,poʃtæk
پشتک زدن	poʃtækzædæn
پشتیبان	poʃtiːbɒːn
پشتیبانی	poʃtiːbɒːniː
پشتیبانی کردن	poʃtiːbɒːniːkæɾdæn
پشه	pæʃe
پشه بند	pæʃebænd
پشه بند زدن	pæʃebændzædæn
پشه زدن	pæʃezædæn
پف فیل	pofefiːl
پل	pol
پل زدن	polzædæn
پل کشیدن	polkeʃiːdæn
پلاتو	pelæto
پلاتو زدن	pelætozædæn
پلاتین	pelɒːtiːn
پلاسما	plɒːsmɒː
پلانک	plɒːnk
پلاک	pelɒːk
پلاک زدن	pelɒːkzædæn
پلنگ	pælænɡ
پلنگ برفی	pælænɡebæɾfiː
پله	pelle
پله برقی	pelebæɾɢiː
پلو	polo
پلک	pælk,pelk
پلک زدن	pelkzædæn
پلیس	poliːs
پلیمر	poliːmeɾ
پماد	pomɒːd
پماد زدن	pomɒːdzædæn
پمپ	pomp
پمپ بنزین	pompebenziːn
پنالتی	penɒːltiː
پنالتی زدن	penɒːltiːzædæn
پناه	pænɒːh
پناه آوردن	pænɒːhɒːvæɾdæn
پناه بردن	pænɒːhboɾdæn
پناه دادن	pænɒːhdɒːdæn
پنج	pænd͡ʒ
پنجابی	pænd͡ʒɒːbiː
پنجاه	pænd͡ʒɒːh
پنجر	pænd͡ʒeɾ,pænd͡ʒæɾ
پنجره	pænd͡ʒæɾe,pænd͡ʒeɾe
پنجشنبه	pænd͡ʒʃænbe
پنجم	pænd͡ʒom
پنجه	pænd͡ʒe
پنجه زدن	pænd͡ʒezædæn
پنجول	pænd͡ʒuːl
پنجول زدن	pænd͡ʒuːlzædæn
پنجول کشیدن	pænd͡ʒuːlkeʃiːdæn
پنج‌شنبه	pænd͡ʒʃænbe
پند	pænd
پندار	pendɒːɾ
پنسیلین	penesiːliːn
پنسیلین زدن	penesiːliːnzædæn
پنهان	penhɒːn
پنهان کردن	penhɒːnkæɾdæn
پنهانی	penhɒːniː
پنکه	pænke
پنگان	penɡɒːn
پنگوئن	pænɡuːæn
پنیر	pæniːɾ
پنیسیلین	peniːsiːliːn
پهلو	pæhluː
پهن	pæhn,pehen
پهنیان	pehenjɒːn
پهپاد	pæhpɒːd
پوتین	puːtiːn
پودینگ	puːdiːnɡ
پور	puːɾ
پور سینا	puːɾesiːnɒː
پورتال	poɾtɒːl
پورسلین	poɾseliːn
پورنوگرافی	poɾnoɡɾɒːfiː
پوزخند	puːzxænd
پوزخند زدن	puːzxændzædæn
پوزه	puːze
پوزه زدن	puːzezædæn
پوزه کشیدن	puːzekeʃiːdæn
پوزیترون	posiːtɾon
پوست	puːst
پوست بیضه	puːstebejze
پوست درخت	puːstedeɾæxt
پوست کندن	puːstkændæn
پوست گرفتن	puːstɡeɾeftæn
پوستر	posteɾ
پوسته	puːste,puːstæ
پوسده	puːsedæh
پوشه	puːʃe
پوشیدن	puːʃiːdæn
پوشیده	puːʃiːdæ
پول	puːl
پولاد	puːlɒːd
پوما	puːmɒː
پونز	puːnez
پونه	puːne
پوپک	puːpæk
پوچ	puːt͡ʃ
پوکر	pokeɾ,puːkeɾ
پي ريزي	pejɾiːziː
پيش بايست	piːʃbɒːjæst
پيش شرط	piːʃʃæɾt
پپسیکولا	pepsiːkuːlɒː
پچ‌پچ کردن	pet͡ʃpet͡ʃkæɾdæn
پژو	puːʒo
پژوهیدن	pæʒuːhiːdæn
پک	pok
پک زدن	pokzædæn
پکن	pekæn
پی	piː,pej
پیاده	pjɒːde,piːjɒːde
پیاز	piːjɒːz
پیاله	piːɒːle
پیاله زدن	piːɒːlezædæn
پیام	pejɒːm
پیامک	pæjɒːmæk
پیامک زدن	pæjɒːmækzædæn
پیانو	piːjɒːno
پیانو فورته	piːɒːnofoɾte
پیتزا	piːtzɒː
پیدا کردن	pejdɒːkæɾdæn
پیر	piːɾ
پیرارسال	piːɾɒːɾsɒːl
پیرامون	piːɾɒːmuːn
پیرانا	piːɾɒːnɒː
پیراهن	piːɾɒːhæn
پیرزن	piːɾezæn
پیرمرد	piːɾemæɾd
پیروی	pejɾoviː
پیش	piːʃ
پیش از ظهر	piːʃæzzohɾ
پیش میاد دیگه	píʃmiːɒːddiːɡe
پیشاب	peʃɒːb
پیشانی	piːʃɒːniː
پیشاور	peʃɒːvæɾ
پیشباز  پیشواز	piːʃbɒːzpiːʃvɒːz
پیشباز  پیشواز آمدن	piːʃbɒːzɒːmædæn
پیشرفت	piːʃɾæft
پیشرفت کردن	piːʃɾæftkæɾdæn
پیشرفته	piːʃɾæfte
پیشنام	piːʃnɒːm
پیشنهاد	peʃnæhɒːd,piːʃnæhɒːd
پیشنهاد دادن	piːʃnæhɒːddɒːdæn
پیشنهاد کردن	peʃnæhɒːdkæɾdæn,piːʃnæhɒːdkæɾdæn
پیشه	piːʃæ,piːʃe
پیشوند	piːʃvænd
پیشکش	piːʃkæʃ,piːʃkeʃ
پیشی	piːʃiː
پیشین	piːʃiːn
پیش‌افکند	piːʃæfkænd
پیش‌بینی	piːʃbiːniː
پیش‌بینی کردن	piːʃbiːniːkæɾdæn
پیش‌بینی‌ کردن	piːʃbiːniːkæɾdæn
پیغام	pejɢɒːm
پیل	piːl
پیمان	pejmɒːn
پیمانه	pejmɒːne,pejmɒːnæ
پیمانه کردن	pejmɒːnekæɾdæn
پینه	piːne
پینه بستن	piːnebæstæn
پینه زدن	piːnezædæn
پین‌یین	piːnjiːn
پیوستن	pejvæstæn
پیوسته	pejvæste,pejvæstæ
پیوند	pejvænd
پیوند زدن	pejvændzædæn
پیونگ‌یانگ	piːjonɡjɒːnɡ
پیچ	piːt͡ʃ
پیچ زدن	piːt͡ʃzædæn
پیچیدن	piːt͡ʃiːdæn
پیچیده	piːt͡ʃiːde
پیچ‌گوشتی	piːt͡ʃɡuːʃtiː
پیک	pejk
پی‌غذا	t͡ʃiːɢæzɒː
چاباق‌سر	t͡ʃɒːbɒːɢsæɾ
چادر	t͡ʃɒːdoɾ
چادر زدن	t͡ʃɒːdoɾzædæn
چادر شب	t͡ʃɒːdæɾeʃæb
چارمیخ	t͡ʃæhæɒːɾmiːx
چارمیخ کشیدن	t͡ʃæhæɒːɾmiːxkeʃiːdæn
چاره	t͡ʃɒːɾæ,t͡ʃɒːɾe
چارک	t͡ʃɒːɾæk
چاشنی	t͡ʃɒːʃniː
چاقو	t͡ʃɒːɢuː
چاقو خوردن	t͡ʃɒːɢuːxoɾdæn
چاقو زدن	t͡ʃɒːɢuːzædæn
چاقوی سوئیسی	t͡ʃɒːɢuːjesuːiːsiː
چال	t͡ʃɒːl
چال افتادن	t͡ʃɒːloftɒːdæn
چال انداختن	t͡ʃɒːlændɒːxtæn
چال کردن	t͡ʃɒːlkæɾdæn
چالش	t͡ʃɒːleʃ
چاله	t͡ʃɒːle
چامه	t͡ʃɒːme
چامه سرایی	t͡ʃɒːmesæɾɒːjiː
چانه	t͡ʃɒːne
چانه زدن	t͡ʃɒːnezædæn
چاه	t͡ʃɒːh
چاه زدن	t͡ʃɒːhzædæn
چاپ	t͡ʃɒːp
چاپ زدن	t͡ʃɒːpzædæn
چاپ کردن	t͡ʃɒːpkæɾdæn,t͡ʃɒːpkæɾdæn
چاک	t͡ʃɒːk
چاک خوردن	t͡ʃɒːkxoɾdæn
چاک دادن	t͡ʃɒːkdɒːdæn
چاک زدن	t͡ʃɒːkzædæn
چاک پستان	t͡ʃɒːkpestɒːn
چای	t͡ʃɒːj
چای سبز	t͡ʃɒːjesæbz
چای سیاه	t͡ʃɒːjesiːjɒːh
چبوق	t͡ʃebuːɢ
چتر	t͡ʃætɾ
چتر دریایی	t͡ʃætɾdæɾjɒːjiː
چتر زدن	t͡ʃætɾzædæn
چدن	t͡ʃodæn
چرا	t͡ʃeɾɒː
چرا که نه	t͡ʃeɾɒːkenɒː
چراغ	t͡ʃeɾɒːɢ,t͡ʃeɾɒːĝ
چراغ زدن	t͡ʃeɾɒːɢzædæn
چراغ مطالعه	t͡ʃeɾɒːɢemotɒːleʔe
چربی	t͡ʃæɾbiː
چرت	t͡ʃoɾt
چرت زدن	t͡ʃoɾtzædæn,t͡ʃoɾtzædæn
چرتکه	t͡ʃoɾtke
چرخ	t͡ʃæɾx
چرخ خوردن	t͡ʃæɾxxoɾdæn
چرخ زدن	t��ʃæɾxzædæn
چرخاندن	t͡ʃæɾxɒːndæn
چرخیدن	t͡ʃæɾxiːdæn
چرم	t͡ʃæɾm
چرمی	t͡ʃæɾmiː
چرند	t͡ʃæɾænd
چرنده	t͡ʃæɾænde
چروک	t͡ʃoɾuːk
چروک خوردن	t͡ʃoɾuːkxoɾdæn
چرک	t͡ʃoɾæk,t͡ʃeɾk
چرک گرفتن	t͡ʃeɾkɡeɾeftæn
چرکس	t͡ʃæɾkæs
چس فیل	t͡ʃosefiːl
چسب	t͡ʃæsb
چسب زدن	t͡ʃæsbzædæn
چسب مایع	t͡ʃæsbemɒːjeʔ
چسب نواری	t͡ʃæsbenævɒːɾiː
چسباندن	t͡ʃæsbɒːndæn
چشش	t͡ʃeʃeʃ
چشم	t͡ʃeʃm,t͡ʃæʃm,t͡ʃæŝm,t͡ʃeʃmt͡ʃæʃm
چشم آمدن	t͡ʃeʃmɒːmædæn
چشم افتادن	t͡ʃeʃmoftɒːdæn
چشم انداختن	t͡ʃeʃmændɒːxtæn
چشم انداز	t͡ʃæʃmændɒːz
چشم خوردن	t͡ʃeʃmxoɾdæn
چشم زخم	t͡ʃeʃmzæxm
چشم زخم زدن	t͡ʃeʃmzæxmzædæn
چشم زدن	t͡ʃeʃmzædæn
چشم زهر	t͡ʃeʃmzæhɾ
چشم زهر گرفتن	t͡ʃeʃmzæhɾɡeɾeftæn
چشمه	t͡ʃæʃmæ
چشمک	t͡ʃeʃmæk
چشمک زدن	t͡ʃeʃmækzædæn
چشم‌غره	t͡ʃeʃmɢoɾɾe
چشم‌غره رفتن	t͡ʃeʃmɢoɾɾeɾæftæn
چشم‌پزشک	t͡ʃeʃmpezeʃk
چشم‌پزشکی	t͡ʃeʃmpezeʃkiː
چشیدن	t͡ʃeʃiːdæn
چطور	t͡ʃetouːɾ
چغندر	t͡ʃoɢondæɾ
چقدر	t͡ʃeɢædɾ
چلاقی	t͡ʃolɒːɢiː
چلاقی زدن	t͡ʃolɒːɢiːzædæn
چلچله	t͡ʃelt͡ʃele
چلیپا	t͡ʃæliːpɒː
چماق	t͡ʃomɒːɢ
چماق زدن	t͡ʃomɒːɢzædæn
چمباتمه	t͡ʃombɒːtme
چمباتمه زدن	t͡ʃombɒːtmezædæn
چمبر	t͡ʃæmbæɾ
چمبر زدن	t͡ʃæmbæɾzædæn
چمدان	t͡ʃæmedɒːn
چمپداک	t͡ʃæmpædɒːk
چمچه	t͡ʃæmt͡ʃe,t͡ʃomt͡ʃe
چنبر	t͡ʃænbæɾ
چنبر زدن	t͡ʃænbæɾzædæn
چند	t͡ʃænd
چند تا	t͡ʃændtɒː
چندتایی	t͡ʃændtɒːjiː
چندخدایی	t͡ʃændxodɒːjiː
چندش	t͡ʃendeʃ
چندش شدن	t͡ʃendeʃʃodæn
چندن	t͡ʃændæn
چندک	t͡ʃondæk
چندک زدن	t͡ʃondækzædæn
چندگانه	t͡ʃændɡɒːne
چندین	t͡ʃændiːn
چنگ	t͡ʃænɡ
چنگ آوردن	t͡ʃænɡɒːvæɾdæn
چنگ زدن	t͡ʃænɡzædæn
چنگال	t͡ʃænɡɒːl
چنگك	t͡ʃænɡæk
چنین	t͡ʃoniːn
چه	t͡ʃe
چهار	t͡ʃæhɒːɾ
چهار گوش	t͡ʃæhɒːɾɡuːʃ
چهارده	t͡ʃæhɒːɾdæh
چهارشنبه	t͡ʃæhɒːɾʃænbe
چهارصد	t͡ʃæhɒːɾsæd
چهارم	t͡ʃæhɒːɾom
چهره	t͡ʃehɾæ,t͡ʃehɾe
چهل	t͡ʃehel
چهل و پنج	t͡ʃehelopænd͡ʒ
چهچهه	t͡ʃæht͡ʃæhe
چهچهه زدن	t͡ʃæht͡ʃæhezædæn
چهچهه کردن	t͡ʃæht͡ʃæhekæɾdæn
چوب	t͡ʃuːb
چوب خوردن	t͡ʃuːbxoɾdæn
چوب زدن	t͡ʃuːbzædæn
چوبان	t͡ʃuːbɒːn
چوبه دار	t͡ʃuːbæjedɒːɾ
چوبی	t͡ʃuːbiː
چوبین	t͡ʃuːbiːn
چورک	t͡ʃuːɾæk
چون	t͡ʃon,t͡ʃuːn
چونکه	t͡ʃuːnke
چوپان	t͡ʃuːpɒːn
چوپون	t͡ʃuːpuːn
چوچوله	t͡ʃuːt͡ʃuːle,t͡ʃuːt͡ʃuːlæ
چوگان	t͡ʃoʊɡɒːn
چپ	t͡ʃæp
چپاول	t͡ʃæpɒːvol
چپاول کردن	t͡ʃæpɒːvolkæɾdæn
چپق	t͡ʃopoɢ
چپق کشیدن	t͡ʃopoɢkeʃiːdæn
چپ‌گرا	t͡ʃæpɡæɾɒː
چچنی	t͡ʃet͡ʃeniː
چک	t͡ʃæk,t͡ʃek
چک خوردن	t͡ʃækxoɾdæn
چک زدن	t͡ʃækzædæn
چکاوک	t͡ʃækɒːvæk
چکرز	t͡ʃekeɾz
چکش	t͡ʃækoʃ
چکه	t͡ʃekke
چکه کردن	t͡ʃekkekæɾdæn
چکى	t͡ʃekiː
چکی	t͡ʃekiː
چگونه	t͡ʃeɡuːne
چی	t͡ʃiː
چیدمان	t͡ʃiːdemɒːn
چیدن	t͡ʃiːdæn
چیز	t͡ʃiːz
چیزبرگر	t͡ʃiːzbeɾɡeɾ
چیزی	t͡ʃiːziː
چین	t͡ʃiːn
چین افتادن	t͡ʃiːnoftɒːdæn
چین تایپه	t͡ʃiːntɒːjpe
چین دادن	t͡ʃiːndɒːdæn
چینی	t͡ʃiːniː
چینی ساده‌شده	t͡ʃiːniːjesɒːdeʃode
چینی سنتی	t͡ʃiːniːjesonætiː
ژئودزی	ʒeodeziː
ژاله	ʒɒːle
ژامبون	ʒɒːmbon
ژانر	ʒɒːnɾ
ژانویه	ʒɒːnviːje
ژاویدن	ʒɒːviːdæn
ژاپن	ʒɒːpon
ژاپنی	ʒɒːponiː
ژاکت	ʒɒːket
ژرف	ʒæɾf
ژله	ʒele
ژنرال	ʒeneɾɒːl
ژنو	ʒenev
ژنوم	ʒenuːm,ʒenom
ژوئن	ʒuːʔæn
ژوئیه	ʒuːʔiːje
ژوراسیک	ʒuːɾɒːsiːk
ژورنال	ʒoɾnɒːl
ژوکوف	ʒuːkov
ژیرش	ʒiːɾeʃ
ژیوه	ʒiːve
کاباره	kɒːbɒːɾe
کابل	kɒːbol
کابوس	kɒːbuːs
کاتالانی	kætælɒːniː
کاتولیک	kɒːtoliːk
کاج	kɒːd͡ʒ
کاخ	kɒːx
کاخ سفید	kɒːxesæfiːd
کاخ کرملین	kɒːxekɾemliːn
کادمیوم	kɒːdmiːjom
کار	kɒːɾ
کار افتادن	kɒːɾoftɒːdæn
کار انداختن	kɒːɾændɒːxtæn
کار بردن	kɒːɾboɾdæn
کار بستن	kɒːɾbæstæn
کار کردن	kɒːɾkæɾdæn,kɒːɾkæɾdæn
کار گرفتن	kɒːɾɡeɾeftæn
کار گروهی	kɒːɾeɡoɾuːhiː
کارآموز	kɒːɾɒːmuːz
کارآگاه	kɒːɾɒːɡɒːh
کاراگاه	kɒːɾɒːɡɒːh
کاربر	kɒːɾbæɾ
کارت اعتباری	kɒːɾteeʔtebɒːɾ
کارت پستال	kɒːɾtpostɒːl
کارتاژ	kæɾtɒːʒ
کارتن	kɒːɾton
کارخانه	kɒːɾxɒːne
کارد	kɒːɾd
کارد خوردن	kɒːɾdxoɾdæn
کارد زدن	kɒːɾdzædæn
کارفرما	kɒːɾfæɾmɒː
کارل	kɒːɾl
کارمزد	kɒːɾmozd
کارمند	kɒːɾmænd
کارناوال	kɒːɾnɒːvɒːl
کارنوال	kɒːɾnevɒːl
کاروان	kɒːɾvɒːn
کاروان‌سرا	kɒːɾvɒːnsæɾɒː
کارگر	kɒːɾɡæɾ
کاری است که شده	kɒːɾiːæstkeʃode
کازاخستان	kɒːzɒːxestɒːn
کاست	kɒːst
کاسنی	kɒːsniː
کاسه	kɒːse
کاشتن	kɒːʃtæn
کاشته	kɒːʃte
کاشته زدن	kɒːʃtezædæn
کاشغر	kɒːʃɢæɾ
کاشف	kɒːʃef
کاغذ	kɒːɢæz
کاغذ روزنامه	kɒːɢæzeɾuːznɒːme
کاغذدیواری	kɒːɢæzdiːvɒːɾiː
کاغذدیواری کردن	kɒːɢæzdiːvɒːɾiːkæɾdæn
کاغذی	kɒːɢæziː
کاف	kɒːf
کافر	kɒːfæɾ,kɒːfeɾ
کافه	kɒːfe
کافی	kɒːfiː
کالبدشناسی	kɒːlbodʃenɒːsiː
کالیفرنیا	kɒːliːfoɾniːɒː
کالیفرنیم	kɒːliːfoɾniːom
کام	kɒːm
کام کشیدن	kɒːmkeʃiːdæn
کام گرفتن	kɒːmɡeɾeftæn
کاما سوترا	kɒːmɒːsuːtɾɒː
کامامبر	kɒːmɒːmbeɾ
کامبوج	kɒːmbuːd͡ʒ
کامل	kɒːmel
کامپیوتر	kɒːmpjuːteɾ
کامیون	kɒːmiːon
کان	kɒːn
کانادا	kɒːnɒːdɒː
کانال	kɒːnɒːl
کانال مانش	kɒːnɒːlmɒːnʃ
کانبرا	kɒːnbæɾɒː
کانجی	kɒːnd͡ʒiː
کانگورو	kɒːnɡoɾo
کانی	kɒːniː
کانی‌شناسی	kɒːniːʃenɒːsiː
کاهش	kɒːheʃ
کاهش دادن	kɒːheʃdɒːdæn
کاهش گرفتن	kɒːheʃɡeɾeftæn
کاهو	kɒːhuː
کاپوت	kɒːpuːt
کاپوچینو	kɒːpuːt͡ʃiːnuː
کاکائو	kɒːkɒːoje
کباب	kebɒːb
کباب کردن	kæbɒːbkæɾdæn
کبالت	kobɒːlt
کبد	kæbed
کبریت	kebɾiːt
کبوتر	kæbuːtæɾ
کبوتر چاهی	kæbuːtæɾt͡ʃɒːhiː
کبک	kebek
کتاب	ketɒːb
کتاب الکترونیکی	ketɒːbeelektɾoniːkiː
کتاب داوران	ketɒːbdæwɾæn
کتاب عبارت	ketɒːbeʔebɒːɾæt
کتاب مقدس	ketɒːbemoɢæddæs
کتابخانه	ketɒːbxɒːne
کتابدار	ketɒːbdɒːɾ
کتاب‌فروش	ketɒːbfoɾuːʃ
کتاب‌فروشی	ketɒːbfoɾoʃiː
کتبی	kætbiː
کتری	ketɾiː
کتف	ketf
کتک	kotæk
کتک خوردن	kotækxoɾdæn
کتک زدن	kotækzædæn
کثافت	kesɒːfæt
کثافت زدن	kesɒːfætzædæn
کثافت کشیدن	kesɒːfætkeʃiːdæn
کجا	kod͡ʒɒː
کد پستی	kodepostiː
کدام	kodɒːm
کده	kæde
کدو تنبل	kæduːtænbæl
کر	kæɾ
کراتین	keɾɒːtiːn
کراوات	keɾɒːvɒːt
کراوات زدن	keɾɒːvɒːtzædæn
کراچی	kæɾɒːt͡ʃiː
کرایست‌چرچ	kɾɒːjstt͡ʃeɾt͡ʃ
کرایه	keɾɒːjæ
کرایه دادن	keɾɒːjædɒːdæn
کرایه کردن	keɾɒːjækæɾdæn
کربن	kæɾbon
کرت	keɾet
کرد	koɾd
کردار	keɾdɒːɾ
کردستان	koɾdestɒːn
کردن	kæɾdæn
کردنی	kæɾdæniː
کردی	koɾdiː
کرسی	koɾsiː
کرسی زدن	koɾsiːzædæn
کرفس	kæɾæfs
کرم	kæɾæm,keɾm,keɾem
کرم زدن	keɾemzædæn
کرملین	kɾemliːn
کرنر	koɾneɾ
کرنر زدن	koɾneɾzædæn
کره	kæɾe,koɾɾe,koɾe
کره جنوبی	koɾejed͡ʒænuːbiː
کره زدن	kæɾezædæn
کره شمالی	koɾejeʃemɒːliː
کرواسی	koɾoɒːsiː
کروم	koɾom
کروکودیل	kɾokodiːl
کرکس	kæɾkæs
کرگوشی	kæɾɡuːʃiː
کرگوشی زدن	kæɾɡuːʃiːzædæn
کریسمس	keɾiːsmæs
کریکت	kɾiːket
کس	kæs,kos
کس لیسیدن	kosliːsiːdæn
کسره	kæsɾe
کسشعر	kosʃeʔɾ,koseʃeʔɾ
کسل کننده	keselkonænde
کسی	kæsiː,ksiː
کس‌کش	koskeʃ
کس‌کشی	koskeʃiː
کشاورز	keʃɒːvæɾz
کشاورزی	keʃɒːvæɾziː
کشت	keʃt
کشتارگاه	koʃtɒːɾɡɒːh
کشتن	koʃtæn
کشتی	koʃtiː,kæʃtiː
کشتی فضایی	kæʃtiːefæzɒːje
کشتی نوح	kæʃtiːjenuːh
کشتی هوایی	kæʃtiːjehævɒːjiː
کشتی گذاره	kæʃtiːjeɡozɒːɾæh
کشتی گرفتن	koʃtiːɡeɾeftæn
کشف	kæʃf
کشف شدن	kæʃfʃodæn
کشف کردن	kæʃfkæɾdæn,kæʃfkæɾdæn
کشمش	keʃmeʃ
کشنده	keʃænde
کشو	keʃo
کشور	keʃvæɾ
کشکک زانو	kæʃkækzɒːnuː
کشیدن	keʃiːdæn
کشیده	kæʃiːdæ,keʃiːde,kæʃiːde
کشیده خوردن	keʃiːdexoɾdæn
کشیده زدن	keʃiːdezædæn
کشیش	keʃiːʃ
کعبه	kæʔbe
کف	kæf
کف دادن	kæfdɒːdæn
کف دست	kæfedæst
کف زدن	kæfzædæn
کف زمین	kæfezæmiːn
کف پا	kæfepɒː
کف گیری	kæfɡiːɾiː
کفاره	kæffɒːɾe
کفاره دادن	kæffɒːɾedɒːdæn
کفاش	kæffɒːʃ
کفتار	kæftɒːɾ
کفتر	kæftæɾ
کفش	kæfʃ
کفش راحتی	kæfʃeɾɒːhætiː
کفش‌دوزک	kæfʃduːzæk
کفیر	kefiːɾ
کل	kol
کلاس	kelɒːs
کلاسور	kelɒːsoɾ
کلاسیک	klɒːsiːk
کلاغ	kælɒːɢ
کلان	kælɒːn
کلاه	kolɒːh
کلر	koloɾ
کلروفیل	kloɾofiːl
کلسیم	kælsiːom
کلفت	kolfæt
کلم	kælæm
کلمبیا	kolombiːjɒː
کلمه	kælæme
کلن	koln
کلنجار	kælænd͡ʒɒːɾ
کلنگ	kolænɡ
کلنگ زدن	kolænɡzædæn
کله	kællæ,kælle
کله زدن	kællezædæn
کله معلق	kællemoællæɢ
کله معلق زدن	kællemoællæɢzædæn
کلوچه	koluːt͡ʃæ
کلّه خر	kællexæɾ
کلّه سخت	kællesæxt
کلک	kælæk
کلک خوردن	kælækxoɾdæn
کلک زدن	kælækzædæn
کلید	keliːd
کلیدی	keliːdiː
کلیسا	keliːsɒː
کلیه	kolje
کم	kæm,kom
کم حرف	kæmhæɾf
کم صدا	kæmsedɒː
کم گوی	kæmɡuːj
کماره	kæmɒːɾe
کمال	kæmɒːl
کمان	kæmɒːn
کمان زنبورکی	kæmɒːnezænbuːɾækiː
کمان‌دار	kæmɒːndɒːɾ
کمتر	kæmtæɾ
کمد	komod
کمر	kæmæɾ
کمربند	kæmæɾbænd,kæmæɾbænd
کمردرد	kæmæɾdæɾd
کمردرد زدن	kæmæɾdæɾdzædæn
کمند	kæmænd
کمونیست	komuːniːst
کمونیسم	komuːniːsm
کمک	komæk
کمک کردن	komækkæɾdæn
کمک گرفتن	komækɡeɾeftæn
کمی	kæmiː
کمیاب	kæmjɒːb
کمین	kæmiːn
کمین کردن	kæmiːnkæɾdæn
کمین گرفتن	kæmiːnɡeɾeftæn
کنار	kenɒːɾ,kenɒːɾe
کنار زدن	kenɒːɾzædæn
کناره	kenɒːɾe
کناره گرفتن	kenɒːɾeɡeɾeftæn
کناره گیری	kenɒːɾeɡiːɾiː
کناره گیری کردن	kenɒːɾeɡiːɾiːkæɾdæn
کنایه	kenɒːje
کنایه زدن	kenɒːjezædæn
کنجد	kond͡ʒed,kond͡ʒod
کندن	kændæn
کندهار	kændæhɒːɾ
کندی	kenediː
کنست	kneset
کنستانتینوپول	konstɒːntiːnopol
کنسرت	konseɾt
کنسولگری	konsuːlɡæɾiː
کنعان	kænʔɒːn
کنف	kenæf
کنفرانس	konfeɾɒːns
کنه	kæne
کنونی	konuːniː
کنگر فرنگی	kænɡæɾefæɾænɡiː
کنیسه	kæniːse
که	ke,kæh,koh
کهن	kohæn
کهنه	kohne
کهکشان	kæhkeʃɒːn
کوآلا	koɒːlæ
کوارک	kuːɒːɾk
کوالالامپور	kvɒːlɒːlɒːmpuːɾ
کوبا	kuːbɒː
کوبیدن	kuːbiːdæn
کوتاه	kuːtɒːh
کوتاهی	kuːtɒːhiː
کوتاهی کردن	kuːtɒːhiːkæɾdæn
کودن	kodæn
کودنی	koʊdæniː
کودنی زدن	koʊdæniːzædæn
کودک	kuːdæk
کودکستان	kuːdækestɒːn
کور	kuːɾ
کورسو	kuːɾsuː
کورسو زدن	kuːɾsuːzædæn
کورش	kuːɾoʃ
کوره	kuːɾæ
کوری	kuːɾiː
کوری زدن	kuːɾiːzædæn
کوریم	kuːɾiːom
کوزپلی	kosplej
کوستروما	kostɾomɒː
کوسه	kuːse
کوسوو	kosovo
کوشش	kuːŝeŝ
کوشک	kuːʃk
کوشیدن	kuːŝiːdæn
کوفته	kuːfte
کول	kuːl
کول کردن	kuːlkæɾdæn
کول گرفتن	kuːlɡeɾeftæn
کولون	kolon
کولی	koʊliː
کومیس	kuːmiːs
کون	kuːn
کونا	kuːnɒː
کونگ فو	kuːnɡfuː
کونی	kuːniː
کوه	kuːh
کوه زدن	kuːhzædæn
کوهستان	kuːhestɒːn
کوپرنیسیم	kopeɾniːsiːom
کوپرنیک	kuːpeɾniːk
کوپید	kuːpiːd
کوچ	kuːt͡ʃ
کوچ کردن	kuːt͡ʃkæɾdæn
کوچه	kuːt͡ʃe
کوچه زدن	kuːt͡ʃezædæn
کوچولو	kuːt͡ʃuːluː
کوچک	kuːt͡ʃek
کوچکتر	kuːt͡ʃæktæɾ
کوچیدن‌	kuːt͡ʃiːdæn
کوچ‌ها	kuːt͡ʃhɒː
کوک	kuːk
کوک خوردن	kuːkxoɾdæn
کوک زدن	kuːkzædæn
کوکاکولا	kokɒːkolɒː
کوکب	kouːkæb
کویت	koveiːt
کپنهاگ	kopenhɒːɡ
کپک	kæpæk
کپک زدن	kæpækzædæn
کپی	kæpiː,kopiː
کپی کردن	kæpiːkæɾdæn,kopjkæɾdæn
کک	kek
کی	kej,kiː
کی ۲	kejdoh
کیبورد	kiːboɾd
کیر	kiːɾ
کیر مکیدن	kiːɾmekiːdæn
کیسه	kiːse
کیسه بیضه	kiːsejebejze
کیسه خایه	kiːsejexɒːje
کیسه زدن	kiːsezædæn
کیسه کشیدن	kiːsekeʃiːdæn
کیش	kiːʃ
کیش و مات	kiːʃomɒːt
کیشینف	kiːʃiːnef
کیف	kiːjef,kiːf,kejf
کیف زدن	kiːfzædæn
کیف پول	kiːfepuːl
کیفیت	kejfiːjæt
کیلو	kiːluː
کیلومتر	kiːlometɾ
کیلوگرم	kiːloɡɾæm
کیم	kiːm
کیمیا	kiːmiːjɒː
کیمیاگر	kiːmiːɒːɡæɾ
کیمیاگری	kiːmiːjɒːɡæɾiː
کینه	kiːne
کینه گرفتن	kiːneɡeɾeftæn
کینگستون	kiːnɡston
کیهان	kejhɒːn
کیوسک	kiːjuːsk
کیوسکموتو	kjvskmvtv
کیپا	kiːpɒː
کیک	kejk
گا	ɡɒː
گائیدن	ɡɒːʔiːdæn
گابورون	ɡɒːboɾon
گاراژ	ɡɒːɾɒːʒ
گاز	ɡɒːz
گاز اعصاب	ɡɒːzeæʔsɒːb
گاز زدن	ɡɒːzzædæn
گاز گرفتن	ɡɒːzɡeɾeftæn
گازولین	ɡɒːzuːliːn
گام	ɡɒːm
گام زدن	ɡɒːmzædæn,ɡɒːmzædæn
گاما	ɡɒːmɒː
گامبی	ɡɒːmbiː
گاه	ɡɒːh
گاه به گاه	ɡɒːhbeɡɒːh
گاهی	ɡɒːhiː
گاو	ɡɒːv
گاو نر	ɡɒːvenæɾ
گاوبندی	ɡɒːvbændiː
گاوبندی کردن	ɡɒːvbændiːkæɾdæn
گاینده	ɡɒːjænde
گاییدنی	ɡɒːjedæniː
گت	ɡæt,ɡot
گتو	ɡetuː,ɡeto
گجراتی	ɡod͡ʒæɾɒːtiː
گدایی	ɡedɒːjiː
گدایی زدن	ɡedɒːjiːzædæn
گذاشتن	ɡozɒːʃtæn,topuːt
گذر	ɡozæɾ
گذر کردن	ɡozæɾkæɾdæn
گذرنامه	ɡozæɾnɒːme
گذشتن	ɡozæʃtæn
گذشته	ɡozæʃte
گذشته ی بعید	ɡozæʃtejebæʔiːd
گر	ɡoɾ
گر گرفتن	ɡoɾɡeɾeftæn
گراز	ɡeɾɒːz
گراز دریایی	ɡoɾɒːzedæɾjɒːjiː
گران	ɡeɾɒːn
گرایش جنسی	ɡæɾɒːjeʃed͡ʒensiː
گربه	ɡoɾbe
گربۀ ایرانی	ɡoɾbejeiːɾɒːniː
گربۀ پشمالو	ɡoɾbejepæʃmɒːluː
گرجستان	ɡoɾd͡ʒestɒːn
گرجی	ɡoɾd͡ʒiː
گرد	ɡeɾd,ɡæɾd
گردش کار	ɡæɾdeʃekɒːɾ
گردن	ɡæɾdæn
گردن بند	ɡæɾdænbænd
گردن زدن	ɡæɾdænzædæn,ɡæɾdænzædæn
گردن گرفتن	ɡæɾdænɡeɾeftæn
گرده	ɡoɾde
گردو	ɡeɾduː
گرز	ɡoɾz
گرسنه	ɡoɾosne
گرسنگی	ɡɾosnæɡiː,ɡoɾosneɡiː,ɡɾosneɡiː
گرسنگی کشیدن	ɡoɾosneɡiːkeʃiːdæn
گرفت	ɡeɾeft
گرفتن	ɡeɾæftæn,ɡeɾeftæn
گرم	ɡæɾm,ɡeɾæm
گرما	ɡæɾmɒː
گرمساز	ɡæɾmsɒːz
گرمک	ɡæɾmæk
گرمکن	ɡæɾmkon
گرمی	ɡæɾmiː
گره	ɡeɾe,ɡeɾeh
گره خوردن	ɡeɾehxoɾdæn
گره زدن	ɡeɾehzædæn
گروزنی	ɡɾuːzniː
گروه	ɡoɾuːhʔ,ɡoɾuːh
گروه واژه	ɡoɾuːhvɒːʒe
گرچه	ɡæɾt͡ʃe
گرگ	ɡoɾɡ
گرگینه	ɡoɾɡiːne
گریبان	ɡæɾiːbɒːn
گریز	ɡoɾiːz
گریز زدن	ɡoɾiːzzædæn
گریستن	ɡeɾiːstæn
گرین کارت	ɡɾiːnkɒːɾt
گرینلند	ɡɾiːnlænd
گریه	ɡeɾje
گریه افتادن	ɡeɾjeoftɒːdæn
گریه انداختن	ɡeɾjeændɒːxtæn
گریه زدن	ɡeɾjezædæn
گریه کردن	ɡeɾjekæɾdæn,ɡeɾjekæɾdæn
گریه گرفتن	ɡeɾjeɡeɾeftæn
گریونا	ɡɾiːvnɒː
گریپ فروت	ɡeɾiːpfoɾuːt
گزارش	ɡozɒːɾeʃ
گزارش دادن	ɡozɒːɾeʃdɒːdæn
گزارشی	ɡozɒːɾeʃiː
گزاره	ɡozɒːɾe
گزاف گفتن	ɡæzɒːfɡoftæn
گزر	ɡæzæɾ
گزنه	ɡæzne
گزیدن	ɡæziːdæn
گزینه	ɡoziːne
گستاخ	ɡostɒːx
گستردن	ɡostæɾdæn
گسترده	ɡostæɾde
گسترده شدن	ɡostæɾdæʃodæn,ɡostæɾdeʃodæn
گسترش	ɡostæɾeʃ
گسترش دادن	ɡostæɾeʃdɒːdæn
گسترش یافتن	ɡostæɾeʃjɒːftæn
گشت	ɡæʃt
گشت زدن	ɡæʃtzædæn
گشتاپو	ɡestɒːpuː
گشتن	ɡæʃtæn
گشنیز	ɡeʃniːz
گشودن	ɡoʃuːdæn
گفت و گو	ɡoftoɡuː
گفتار	ɡoftɒːɾ
گفتن	ɡoftæn
گفته	ɡofte
گفته شدن	ɡofteʃodæn
گفتگو	ɡoftoɡuː,ɡofteɡuːɡoftoɡuː,ɡoftɡuː,ɡofteɡuː
گفتگو کردن	ɡofteɡuːkæɾdæn
گل	ɡel,ɡol,ɡol
گل آفتاب‌گردان	ɡolæftɒːbɡæɾdɒːn
گل آویز	ɡolɒːviːz
گل خوردن	ɡolxoɾdæn
گل دادن	ɡoldɒːdæn
گل زدن	ɡolzædæn,ɡolzædæn
گل کردن	ɡolkæɾdæn
گل کلم	ɡolekælæm
گلاب	ɡolɒːb
گلابی	ɡolɒːbiː
گلاسنوست	ɡlɒːsnost
گلایه	ɡelɒːje
گلایه کردن	ɡelɒːjekæɾdæn
گلدان	ɡoldɒːn
گلزار	ɡolzɒːɾ
گلف	ɡolf
گلو	ɡæluː
گلوله	ɡoluːle
گلوله بستن	ɡoluːlebæstæn
گلوله خوردن	ɡoluːlexoɾdæn
گلوله زدن	ɡoluːlezædæn
گلوگاه	ɡæluːɡɒːh
گلپر	ɡolpæɾ
گل‌کلم	ɡolkælæm
گم کردن	ɡomkæɾdæn
گماردن	ɡomɒːɾdæn
گمان	ɡomɒːn
گمان 	ɡomɒːn
گمان  کردن	ɡomɒːnkæɾdæn
گمان بردن	ɡomɒːnboɾdæn,ɡomɒːnboɾdæn
گمان زدن	ɡomɒːnzædæn
گمان کردن	ɡomɒːnkæɾdæn
گمانه	ɡomɒːne
گمانه زدن	ɡomɒːnezædæn
گناه	ɡonɒːh
گناه کبیره	ɡonɒːhekæbiːɾe
گناه کردن	ɡonɒːhkæɾdæn
گناهکار	ɡonɒːhkɒːɾ
گنبد	ɡonbæd
گنجشک	ɡond͡ʒeʃk
گنجه	ɡænd͡ʒe
گنجینه	ɡænd͡ʒiːne
گند	ɡænd
گند زدن	ɡændzædæn
گند کشیدن	ɡændkeʃiːdæn
گندم	ɡændom
گندمی	ɡændomiː
گنوستیسیزم	ɡnostiːsiːzm
گنوستیک	ɡnostiːk
گنگ	ɡænɡ,ɡonɡ
گنیس	ɡnejs
گه	ɡoh
گهگاه	ɡæhɡɒːh
گو	ɡoʊ,ɡuː
گواهی‌نامه رانندگی	ɡovɒːhiːnɒːmejeɾɒːnændeɡiː
گواوا	ɡvɒːvɒː
گوته	ɡote,ɡuːte
گوجه	ɡod͡ʒe,ɡoʊd͡ʒe
گوجه فرنگی	ɡod͡ʒefæɾænɡiː
گود	ɡoʊd
گود افتادن	ɡoʊdoftɒːdæn
گودال	ɡouːdɒːl
گوراسب	ɡuːɾɒːsb
گورخر	ɡuːɾexæɾ
گورستان	ɡuːɾestɒːn
گورکن	ɡuːɾkæn
گوریل	ɡoɾiːl
گوز	ɡuːz
گوزن	ɡævæzn
گوساله	ɡuːsɒːle
گوسفند	ɡuːsfænd,ɡosfænd
گوش	ɡuːʃ
گوش دادن	ɡuːʃdɒːdæn,ɡuːʃdɒːdæn
گوش رسیدن	ɡuːʃɾesiːdæn
گوش کردن	ɡuːʃkæɾdæn,ɡuːʃkæɾdæn
گوشت	ɡuːʃt,ɡoʃt
گوشتخوار	ɡuːʃtxɒːɾ
گوشمالی دادن	ɡuːŝmɒːliːdɒːdæn
گوشه	ɡuːʃe
گوشه و کنایه	ɡuːʃeokenɒːje
گوشه و کنایه زدن	ɡuːʃeokenɒːjezædæn
گول	ɡuːl
گول خوردن	ɡuːlxoɾdæn
گول زدن	ɡuːlzædæn
گولاگ	ɡuːlɒːɡ
گوندولا	ɡondolɒː
گونه	ɡuːnæ,ɡuːne
گونیا	ɡuːniːjɒː
گوهر	ɡohæɾ
گویان	ɡuːjɒːn
گویش	ɡuːjeʃ
گویه	ɡuːje
گياه	ɡiːjɒːh
گير دادن قلاب	ɡiːɾdɒːdæneɢollɒːb
گپ	ɡæp
گپ زدن	ɡæpzædæn
گپيدن	ɡæpiːdæn
گچ	ɡæt͡ʃ
گیاهخوار	ɡiːjɒːhxɒːɾ
گیاه‌شناسی	ɡiːjɒːhʃenɒːsiː
گیتار	ɡiːtɒːɾ
گیتاریست	ɡiːtɒːɾiːst
گیتاشناسی	ɡiːtɒːʃenɒːsiː
گیتی	ɡiːtiː
گیر	ɡiːɾ
گیر آوردن	ɡiːɾɒːvæɾdæn
گیره	ɡiːɾe
گیلارد	ɡiːlɒːɾd
گیلاس	ɡiːlɒːs
گیلک	ɡiːlæk
گیلگمش	ɡiːlɡæmeʃ
گیهان	ɡeiːhɒːn
گیومه	ɡiːjuːme
گیوه	ɡiːve
گیک	ɡiːk
یا	jɒː
یائسگی	jɒːeseɡiː
یائونده	jɒːʔuːnde
یاخته	jæxte
یاد	jɒːd
یاد آمدن	jɒːdɒːmædæn
یاد آوردن	jɒːdɒːvæɾdæn
یاد افتادن	jɒːdoftɒːdæn
یاد انداختن	jɒːdændɒːxtæn
یاد بردن	jɒːdboɾdæn
یاد دادن	jɒːddɒːdæn,jɒːddɒːdæn
یاد ماندن	jɒːdmɒːndæn
یاد کردن	jɒːdkæɾdæn
یاد گرفتن	jɒːdɡeɾeftæn,jɒːdɡeɾeftæn
یادآوری	jɒːdɒːvæɾiː
یادآوری کردن	jɒːdɒːvæɾiːkæɾdæn,jɒːdɒːvæɾiːkæɾdæn
یادبود	jɒːdbuːd
یادداشت	jɒːddɒːʃt
یادداشت کردن	jɒːddɒːʃtkæɾdæn
یادش آمدن	jɒːdæʃɒːmædæn
یادگار	jɒːdɡɒːɾ
یادگاری	jɒːdeɡɒːɾiː
یار	jɒːɾ
یاروسلاول	jæɾuːslɒːvl
یاری	jɒːɾiː
یاری دادن	jɒːɾiːdɒːdæn
یاری کردن	jɒːɾiːkæɾdæn
یاریگر	jɒːɾiːɡæɾ
یازده	jɒːzdæh
یاس	jɒːs
یاس شیروانی	jɒːseʃiːɾvɒːniː
یاسمن	jɒːsæmen
یاسمون	jɒːsæmuːn
یاسمین	jɒːsæmiːn
یافتن	jɒːftæn
یاقوتی	jɒːɢuːtiː
یالتا	jɒːltæ
یاماکا	jɒːmɒːkɒː
یانگتسه	jænɡtse
یانگون	jɒːnɡon
یاهو	jɒːhuː
یاوری	jɒːvæɾiː
یاوری کردن	jɒːvæɾiːkæɾdæn
یاوه گفتن	jɒːvæɡoftæn
یاکوتسک	jækuːtsk
یتیم	jætiːm
یتیم‌خانه	jætiːmxɒːne
یخ	jæx
یخ بستن	jæxbæstæn
یخ زدن	jæxzædæn
یخ کردن	jæxkæɾdæn
یخچال	jæxt͡ʃɒːl
یخکوه	jæxkuːh
یخ‌زده	jæxzæde
ید	jod
یدک	jædæk
یدک کشیدن	jædækkeʃiːdæn
یزدان	jæzdɒːn
یشمی	jæʃmiː
یعنی	jæʔniː
یقه	jæɢe
یقین	jɒːɢiːn
یقین کردن	jæɢiːnkæɾdæn
یمن	jæmæn
ینی‌چری	jeniːt͡ʃeɾiː
یه	je
یه کمی	jekæmiː
یه ی	jeiː
یهودستیزی	jæhuːdsetiːziː
یهودی	jæhuːdiː
یهودیت	jæhuːdiːjæt
یهودی‌ستیزی	jæhuːdiːsetiːziː
یهوه	jæhve
یواش	jævɒːʃ
یوان	juːɒːn
یوتیوب	juːtjuːb
یورتمه	joɾtmæ
یورش	juːɾeʃ,joɾeʃ
یورش آوردن	joɾeʃɒːvæɾdæn
یورش بردن	joɾeʃboɾdæn
یورو	juːɾo
یوز	juːz
یوزپلنگ	juːzpælænɡ
یونان	juːnɒːn
یونانی	juːnɒːniː
یونیکس	juːniːks
یونی‌کد	juːniːkod
یک	jek
یک کم	jekkæm
یک کمی	jekkæmiː
یکتا	jektɒː
یکتاپرستی	jektɒːpæɾæstiː
یکسان	jeksɒːn
یکشنبه	jekʃænbe
یکم	jekom
یکمین	jekomiːn
یکی	jekiː
یکی بود یکی نبود	jekiːbuːdjekiːnæbuːd
یکی یکی	jekiːjekiː
یک‌بار	jekbɒːɾ
یک‌شنبه	jekʃænbe
ییدیش	jiːdiːʃ
‌قطع	ɢætʔ
‌قطع شدن	ɢætʔʃodæn
‌قطع کردن	ɢætʔkæɾdæn
‏توانا بود هر که دانا بود	tævɒːnɒːbovædhæɾkedɒːnɒːbovæd
ﺱیﺲﺘﻣ ﻉﺎﻤﻟ	siːstemɒːmæl
