ँ	ə̃
ं	ə̃m
ं	ə̃n
ं	ə̃ŋ
ं	ə̃ɳ
अँकवैया	ə̃ŋkwə̯ijäː
अँगड़ाई	ə̃ŋɡɽäːiː
अँगरेज़	ə̃ŋɡɾeːd͡ʒ
अँगरेज़	ə̃ŋɡɾeːz
अँगरेज़ी	ə̃ŋɡɾeːd͡ʒiː
अँगरेज़ी	ə̃ŋɡɾeːziː
अँगहीन	ə̃ŋɡʱĩːn̪
अँगिया	ə̃ŋɡijäː
अँगीठी	ə̃ŋɡiːʈʰiː
अँगूठी	ə̃ŋɡuːʈʰiː
अँग्रेज़	ə̃ŋɡɾeːd͡ʒ
अँग्रेज़	ə̃ŋɡɾeːz
अँग्रेज़ी	ə̃ŋɡɾeːd͡ʒiː
अँग्रेज़ी	ə̃ŋɡɾeːziː
अँटना	ə̃ɳʈn̪äː
अँतड़ी	ə̃n̪t̪ɽiː
अंक	ə̃ŋk
अंकगणित	ə̃ŋkɡəɳɪt̪
अंकन	ə̃ŋkə̃n̪
अंकनी	ə̃ŋkn̪iː
अंकल	ə̃ŋkəl̪
अंकारा	ə̃ŋkäːɾäː
अंकित	ə̃ŋkɪt̪
अंकुर	ə̃ŋkʊɾ
अंकुरित	ə̃ŋkʊɾɪt̪
अंकुश	ə̃ŋkʊʃ
अंग	ə̃ŋɡ
अंगच्छेद	ə̃ŋɡət̚t͡ʃʰeːd̪
अंगड़ाई	ə̃ŋɡɽäːiː
अंगदान	ə̃ŋɡd̪ä̃ːn̪
अंगन	ə̃ŋɡə̃n̪
अंगना	ə̃ŋɡən̪äː
अंगसंग	ə̃ŋɡs̪ə̃ŋɡ
अंगहीन	ə̃ŋɡʱĩːn̪
अंगार	ə̃ŋɡäːɾ
अंगारा	ə̃ŋɡäːɾäː
अंगिया	ə̃ŋɡijäː
अंगीकार	ə̃ŋɡiːkäːɾ
अंगुल	ə̃ŋɡʊl̪
अंगुली	ə̃ŋɡʊl̪iː
अंगूठा	ə̃ŋɡuːʈʰäː
अंगूठी	ə̃ŋɡuːʈʰiː
अंगूर	ə̃ŋɡuːɾ
अंगूरी	ə̃ŋɡuːɾiː
अंगोछा	ə̃ŋɡoːt͡ʃʰäː
अंगोट	ə̃ŋɡoːʈ
अंगोला	ə̃ŋɡoːl̪äː
अंग्रेज	ə̃ŋɡɾeːd͡ʒ
अंग्रेज	ə̃ŋɡɾeːz
अंग्रेज़	ə̃ŋɡɾeːd͡ʒ
अंग्रेज़	ə̃ŋɡɾeːz
अंग्रेज़ियत	ə̃ŋɡɾeːd͡ʒijət̪
अंग्रेज़ियत	ə̃ŋɡɾeːzijət̪
अंग्रेज़ी	ə̃ŋɡɾeːd͡ʒiː
अंग्रेज़ी	ə̃ŋɡɾeːziː
अंग्रेजी	ə̃ŋɡɾeːd͡ʒiː
अंग्रेजी	ə̃ŋɡɾeːziː
अंचल	ə̃n̪t͡ʃəl̪
अंछर	ə̃n̪t͡ʃʰəɾ
अंजन	ə̃n̪d͡ʒə̃n̪
अंजाम	ə̃n̪d͡ʒä̃ːm
अंजीर	ə̃n̪d͡ʒiːɾ
अंजु	ə̃n̪d͡ʒuː
अंटार्कटिका	ə̃ɳʈäːɾkʈɪkäː
अंटार्टिका	ə̃ɳʈäːɾʈɪkäː
अंडकोष	ə̃ɳɖkoːʃ
अंडमान	ə̃ɳɖmä̃ːn̪
अंडा	ə̃ɳɖäː
अंडोरा	ə̃ɳɖoːɾäː
अंत	ə̃n̪t̪
अंतःक्षेप	ə̃n̪t̪əɦkʃeːp
अंतड़ी	ə̃n̪t̪ɽiː
अंतर	ə̃n̪t̪əɾ
अंतरंगता	ə̃n̪t̪əɾə̃ŋɡt̪äː
अंतरजाल	ə̃n̪t̪əɾd͡ʒäːl̪
अंतरण	ə̃n̪t̪ɾə̃ɳ
अंतरराष्ट्रीय	ə̃n̪t̪əɾɾäːʃʈɾiːjᵊ
अंतरराष्ट्रीयता	ə̃n̪t̪əɾɾäːʃʈɾiːjt̪äː
अंतरा	ə̃n̪t̪əɾäː
अंतरा	ə̃n̪t̪ɾäː
अंतराल	ə̃n̪t̪əɾäːl̪
अंतरिक्ष	ə̃n̪t̪əɾɪkʃ
अंतरिक्ष	ə̃n̪t̪ɾɪkʃ
अंतरिम	ə̃n̪t̪ɾɪ̃m
अंतर्कालीन	ə̃n̪t̪əɾkäːl̪ĩːn̪
अंतर्गत	ə̃n̪t̪əɾɡət̪
अंतर्जातीय	ə̃n̪t̪əɾd͡ʒäːt̪iːjᵊ
अंतर्जाल	ə̃n̪t̪əɾd͡ʒäːl̪
अंतर्देशीय	ə̃n̪t̪əɾd̪eːʃiːjᵊ
अंतर्धान	ə̃n̪t̪əɾd̪ʱä̃ːn̪
अंतर्निहित	ə̃n̪t̪əɾn̪ɪɦɪt̪
अंतर्राष्ट्रीय	ə̃n̪t̪əɾɾäːʃʈɾiːjᵊ
अंतर्वासी	ə̃n̪t̪əɾʋäːs̪iː
अंताक्षरी	ə̃n̪t̪äːkʃəɾiː
अंतिम	ə̃n̪t̪ɪ̃m
अंत्येष्टि	ə̃n̪t̪jeːʃʈiː
अंत्र	ə̃n̪t̪ɾᵊ
अंदर	ə̃n̪d̪əɾ
अंदाज	ə̃n̪d̪äːd͡ʒ
अंदाज	ə̃n̪d̪äːz
अंदाज़	ə̃n̪d̪äːd͡ʒ
अंदाज़	ə̃n̪d̪äːz
अंदाज़ा	ə̃n̪d̪äːd͡ʒäː
अंदाज़ा	ə̃n̪d̪äːzäː
अंधड़	ə̃n̪d̪ʱəɽ
अंधविश्वास	ə̃n̪d̪ʱʋɪʃʋäːs̪
अंधा	ə̃n̪d̪ʱäː
अंधाधुंध	ə̃n̪d̪ʱäːd̪ʱʊ̃n̪d̪ʱ
अंधेरा	ə̃n̪d̪ʱeːɾäː
अंबर	ə̃mbəɾ
अंबा	ə̃mbäː
अंबु	ə̃mbuː
अंश	ə̃n̪ʃ
अंशकालिक	ə̃n̪ʃkäːl̪ɪk
अंशतः	ə̃n̪ʃt̪əɦ
अंशुक	ə̃n̪ʃʊk
अकड़न	əkɽə̃n̪
अकड़ना	əkəɽn̪äː
अकर्मण्यता	əkəɾmə̃ɳjət̪äː
अकस्मात्	əkəs̪mäːt̪
अक़्ल	əkl̪ᵊ
अक़्ल	əkəl̪
अक़्ल	əql̪ᵊ
अक़्ल	əqəl̪
अक़्लमंद	əkl̪ᵊmə̃n̪d̪
अक़्लमंद	əkəl̪mə̃n̪d̪
अक़्लमंद	əql̪ᵊmə̃n̪d̪
अक़्लमंद	əqəl̪mə̃n̪d̪
अकाज	əkäːd͡ʒ
अकादमिक	əkäːd̪mɪk
अकादमी	əkäːd̪miː
अकारण	əkäːɾə̃ɳ
अकारथ	əkäːɾət̪ʰ
अकाल	əkäːl̪
अकेला	əkeːl̪äː
अकेलापन	əkeːl̪äːpə̃n̪
अक्खड़	ək̚kʰəɽ
अक्खा	ək̚kʰäː
अक्षत	əkʃət̪
अक्षम्य	əkʃə̃mjᵊ
अक्षर	əkʃəɾ
अक्षरारंभ	əkʃəɾäːɾə̃mbʱ
अक्स	əks̪
अक्सर	əks̪əɾ
अखंड	əkʰə̃ɳɖ
अखंडता	əkʰə̃ɳɖt̪äː
अखबार	əkʰbäːɾ
अखबार	əxbäːɾ
अखरना	əkʰəɾn̪äː
अख़बार	əkʰbäːɾ
अख़बार	əxbäːɾ
अख़बारवाला	əkʰbäːɾʋäːl̪äː
अख़बारवाला	əxbäːɾʋäːl̪äː
अखाड़ा	əkʰäːɽäː
अखिल	əkʰɪl̪
अखिलेश	əkʰɪl̪eːʃ
अगरतला	əɡəɾt̪əl̪äː
अगरबत्ती	əɡəɾbət̪̚t̪iː
अगला	əɡl̪äː
अगवानी	əɡʋäːn̪iː
अगस्त	əɡəs̪t̪
अगाऊ	əɡäːuː
अगिन	əɡɪ̃n̪
अगुआ	əɡʊäː
अग्नि	əɡn̪iː
अग्निपरीक्षा	əɡn̪ɪpəɾiːkʃäː
अग्निशस्त्र	əɡn̪ɪʃəs̪t̪ɾᵊ
अग्निशामक	əɡn̪ɪʃäːmək
अग्न्याशय	əɡn̪jäːʃəj
अग्रवाल	əɡɾᵊʋäːl̪
अग्रहायण	əɡɾəɦäːjə̃ɳ
अग्रिम	əɡɾɪ̃m
अग्रिमता	əɡɾɪ̃mt̪äː
अचंभा	ət͡ʃə̃mbʱäː
अचकन	ət͡ʃkə̃n̪
अचानक	ət͡ʃäːn̪ək
अच्छा	ət̚t͡ʃʰäː
अच्छाई	ət̚t͡ʃʰäːiː
अच्छापन	ət̚t͡ʃʰäːpə̃n̪
अछना	ət͡ʃʰn̪äː
अछूता	ət͡ʃʰuːt̪äː
अजनबियत	əd͡ʒn̪əbijət̪
अजनबी	əd͡ʒn̪əbiː
अजवाइन	əd͡ʒʋäːɪ̃n̪
अज़दहा	əd͡ʒd̪əɦäː
अज़दहा	əzd̪əɦäː
अज़रबैजान	əd͡ʒəɾbɛːd͡ʒä̃ːn̪
अज़रबैजान	əzəɾbɛːd͡ʒä̃ːn̪
अज़ान	əd͡ʒä̃ːn̪
अज़ान	əzä̃ːn̪
अज़ाब	əd͡ʒäːb
अज़ाब	əzäːb
अज़ीम	əd͡ʒĩːm
अज़ीम	əzĩːm
अजाइब	əd͡ʒäːɪb
अजान	əd͡ʒä̃ːn̪
अजायबघर	əd͡ʒäːjəbɡʱəɾ
अजिल्द	əd͡ʒɪl̪d̪
अजूबा	əd͡ʒuːbäː
अजेंडा	əd͡ʒẽːɳɖäː
अज्ञात	əɡjäːt̪
अज्ञानपन	əɡjä̃ːn̪pə̃n̪
अज्ञेयवाद	əɡjeːjʋäːd̪
अज्ञेयवादी	əɡjeːjʋäːd̪iː
अझ़दहा	əzd̪əɦäː
अझ़दहा	əʒd̪əɦäː
अटकना	əʈəkn̪äː
अटकल	əʈkəl̪
अटकलपच्चू	əʈkəl̪pət̚t͡ʃuː
अटकाना	əʈkäːn̪äː
अटकाव	əʈkäːʋ
अटपटा	əʈpəʈäː
अटल	əʈəl̪
अटारी	əʈäːɾiː
अट्टालिका	əʈ̚ʈäːl̪ɪkäː
अट्ठा	əʈ̚ʈʰäː
अट्ठाईस	əʈ̚ʈʰäːiːs̪
अट्ठानवे	əʈ̚ʈʰä̃ːn̪weː
अट्ठावन	əʈ̚ʈʰäːʋə̃n̪
अट्ठासी	əʈ̚ʈʰäːs̪iː
अठन्नी	əʈʰə̃n̪n̪iː
अठपहिया	əʈʰpəiːjäː
अठपहिया	əʈʰpəɦijäː
अठहत्तर	əʈʰɦət̪̚t̪əɾ
अठारह	əʈʰäːɾəɦ
अड़ंगा	əɽə̃ŋɡäː
अड़चन	əɽt͡ʃə̃n̪
अड़तालीस	əɽt̪äːl̪iːs̪
अड़तीस	əɽt̪iːs̪
अड़ना	əɽn̪äː
अड़सठ	əɽs̪əʈʰ
अड़ाना	əɽäːn̪äː
अड़ियल	əɽijəl̪
अण्डा	ə̃ɳɖäː
अतिकाल	ət̪ɪkäːl̪
अतिवाद	ət̪ɪʋäːd̪
अतिवादी	ət̪ɪʋäːd̪iː
अतिसंवेदनशील	ət̪ɪs̪ə̃mweːd̪ə̃n̪ʃiːl̪
अतिसार	ət̪ɪs̪äːɾ
अतुलित	ət̪ʊl̪ɪt̪
अतुल्य	ət̪ʊl̪jᵊ
अत्फ़ाल	ət̪fäːl̪
अत्फ़ाल	ət̪pʰäːl̪
अत्यंत	ət̪jə̃n̪t̪
अत्यन्त	ət̪jə̃n̪t̪
अत्याचार	ət̪jäːt͡ʃäːɾ
अत्याचारी	ət̪jäːt͡ʃäːɾiː
अत्यावश्यक	ət̪jäːʋəʃjək
अत्युत्तम	ət̪jʊt̪̚t̪ə̃m
अथवा	ət̪ʰʋäː
अथाह	ət̪ʰäːɦ
अदहन	əd̪ɦə̃n̪
अदा	əd̪äː
अदाकार	əd̪äːkäːɾ
अदालत	əd̪äːl̪ət̪
अदालती	əd̪äːl̪ət̪iː
अदावत	əd̪äːʋət̪
अद्यतन	əd̪jət̪ə̃n̪
अद्यापि	əd̪jäːpiː
अधिकतम	əd̪ʱɪkt̪ə̃m
अधिकता	əd̪ʱɪkt̪äː
अधिकरण	əd̪ʱɪkəɾə̃ɳ
अधिकार	əd̪ʱɪkäːɾ
अधिकारिणी	əd̪ʱɪkäːɾɪɳiː
अधिकारिता	əd̪ʱɪkäːɾɪt̪äː
अधिकारी	əd̪ʱɪkäːɾiː
अधिनायक	əd̪ʱɪn̪äːjək
अधिनियम	əd̪ʱɪn̪ijə̃m
अधिभार	əd̪ʱɪbʱäːɾ
अधिमास	əd̪ʱɪmäːs̪
अधिलाभ	əd̪ʱɪl̪äːbʱ
अधिवक्ता	əd̪ʱɪʋəkt̪äː
अधिवार्षिकी	əd̪ʱɪʋäːɾʃɪkiː
अधिवेशन	əd̪ʱɪʋeːʃə̃n̪
अधिसूचना	əd̪ʱɪs̪uːt͡ʃn̪äː
अधिसूचित	əd̪ʱɪs̪uːt͡ʃɪt̪
अधीक्षक	əd̪ʱiːkʃək
अधीक्षण	əd̪ʱiːkʃə̃ɳ
अधीन	əd̪ʱĩːn̪
अधीनता	əd̪ʱĩːn̪t̪äː
अधीरता	əd̪ʱiːɾt̪äː
अधुना	əd̪ʱʊn̪äː
अधूरा	əd̪ʱuːɾäː
अधोहस्ताक्षरी	əd̪ʱoːɦəs̪t̪äːkʃəɾiː
अध्यक्ष	əd̪ʱjəkʃ
अध्यक्षता	əd̪ʱjəkʃt̪äː
अध्ययन	əd̪ʱjəjə̃n̪
अध्ययन	əd̪ʱjə̃n̪
अध्यादेश	əd̪ʱjäːd̪eːʃ
अध्यापक	əd̪ʱjäːpək
अध्यापिका	əd̪ʱjäːpɪkäː
अध्याय	əd̪ʱjäːj
अनंतपुर	ən̪ə̃n̪t̪pʊɾ
अनकटा	ə̃n̪kəʈäː
अनकहा	ə̃n̪kəɦäː
अनखिला	ə̃n̪kʰɪl̪äː
अनगढ़	ə̃n̪ɡəɽʱ
अनगिनत	ə̃n̪ɡɪn̪ət̪
अनचखा	ə̃n̪t͡ʃəkʰäː
अनचाहा	ə̃n̪t͡ʃäːɦäː
अनजाना	ə̃n̪d͡ʒäːn̪äː
अनजाने	ə̃n̪d͡ʒäːn̪eː
अनदेखा	ə̃n̪d̪eːkʰäː
अननुमेय	ə̃n̪n̪ʊmeːj
अनन्नास	ən̪ə̃n̪n̪äːs̪
अनपच	ə̃n̪pət͡ʃ
अनपढ़	ə̃n̪pəɽʱ
अनब्याहा	ə̃n̪bjäːɦäː
अनमना	ə̃n̪mən̪äː
अनमोल	ə̃n̪moːl̪
अनर्थ	ən̪əɾt̪ʰ
अनशन	ə̃n̪ʃə̃n̪
अनसुना	ə̃n̪s̪ʊn̪äː
अनस्तित्व	ən̪əs̪t̪ɪt̪wᵊ
अनहोनी	ə̃n̪ɦoːn̪iː
अनाचार	ən̪äːt͡ʃäːɾ
अनाज	ən̪äːd͡ʒ
अनाड़ी	ən̪äːɽiː
अनातोली	ən̪äːt̪oːl̪iː
अनाथालय	ən̪äːt̪ʰäːl̪əj
अनाधिकारिक	ən̪äːd̪ʱɪkäːɾɪk
अनाम	ən̪ä̃ːm
अनामिका	ən̪äːmɪkäː
अनार	ən̪äːɾ
अनारदाना	ən̪äːɾd̪äːn̪äː
अनावश्यक	ən̪äːʋəʃjək
अनिच्छा	ən̪ɪt̚t͡ʃʰäː
अनिद्रा	ən̪ɪd̪ɾäː
अनियंत्रित	ən̪ijə̃n̪t̪ɾɪt̪
अनियमित	ən̪ijəmɪt̪
अनियमितता	ən̪ijəmɪt̪̚t̪äː
अनिवार्य	ən̪ɪʋäːɾjᵊ
अनिवार्यतः	ən̪ɪʋäːɾjət̪əɦ
अनिश्चित	ən̪ɪʃt͡ʃɪt̪
अनिश्चितता	ən̪ɪʃt͡ʃɪt̪̚t̪äː
अनुकरण	ən̪ʊkəɾə̃ɳ
अनुकूल	ən̪ʊkuːl̪
अनुकूलन	ən̪ʊkuːl̪ə̃n̪
अनुगृहीत	ən̪ʊɡɾɪɦiːt̪
अनुग्रह	ən̪ʊɡɾəɦ
अनुचित	ən̪ʊt͡ʃɪt̪
अनुच्छेद	ən̪ʊt̚t͡ʃʰeːd̪
अनुज्ञप्ति	ən̪ʊɡjəpt̪iː
अनुदान	ən̪ʊd̪ä̃ːn̪
अनुनय	ən̪ʊn̪əj
अनुनाद	ən̪ʊn̪äːd̪
अनुनासिक	ən̪ʊn̪äːs̪ɪk
अनुनासिकता	ən̪ʊn̪äːs̪ɪkt̪äː
अनुपजाऊ	ən̪ʊpd͡ʒäːuː
अनुपम	ən̪ʊpə̃m
अनुपयोगी	ən̪ʊpjoːɡiː
अनुपस्थित	ən̪ʊpəs̪t̪ʰɪt̪
अनुपस्थिति	ən̪ʊpəs̪t̪ʰɪt̪iː
अनुपात	ən̪ʊpäːt̪
अनुपूरक	ən̪ʊpuːɾək
अनुप्रयुक्त	ən̪ʊpɾəjʊkt̪
अनुप्रास	ən̪ʊpɾäːs̪
अनुभव	ən̪ʊbʱəʋ
अनुभवी	ən̪ʊbʱəʋiː
अनुभूति	ən̪ʊbʱuːt̪iː
अनुमति	ən̪ʊmət̪iː
अनुमान	ən̪ʊmä̃ːn̪
अनुमानतः	ən̪ʊmä̃ːn̪t̪əɦ
अनुमानित	ən̪ʊmäːn̪ɪt̪
अनुमेय	ən̪ʊmeːj
अनुमोदन	ən̪ʊmoːd̪ə̃n̪
अनुमोदित	ən̪ʊmoːd̪ɪt̪
अनुयायी	ən̪ʊjäːjiː
अनुरक्षण	ən̪ʊɾəkʃə̃ɳ
अनुरागहीनता	ən̪ʊɾäːɡɦĩːn̪t̪äː
अनुरूप	ən̪ʊɾuːp
अनुरोध	ən̪ʊɾoːd̪ʱ
अनुवांशिक	ən̪ʊʋä̃ːn̪ʃɪk
अनुवांशिकी	ən̪ʊʋä̃ːn̪ʃɪkiː
अनुवाद	ən̪ʊʋäːd̪
अनुवादक	ən̪ʊʋäːd̪ək
अनुवादित	ən̪ʊʋäːd̪ɪt̪
अनुशासन	ən̪ʊʃäːs̪ə̃n̪
अनुशासित	ən̪ʊʃäːs̪ɪt̪
अनुशीलन	ən̪ʊʃiːl̪ə̃n̪
अनुष्ठान	ən̪ʊʃʈʰä̃ːn̪
अनुसंधान	ən̪ʊs̪ə̃n̪d̪ʱä̃ːn̪
अनुसरण	ən̪ʊs̪əɾə̃ɳ
अनुस्वार	ən̪ʊs̪ʋäːɾ
अनूठा	ən̪uːʈʰäː
अनूदित	ən̪uːd̪ɪt̪
अनूप	ən̪uːp
अनेक	ən̪eːk
अनेकता	ən̪eːkt̪äː
अनेकानेक	ən̪eːkäːn̪eːk
अनौपचारिक	ən̪ɔːpt͡ʃäːɾɪk
अन्त	ə̃n̪t̪
अन्तरिक्ष	ə̃n̪t̪əɾɪkʃ
अन्तर्गत	ə̃n̪t̪əɾɡət̪
अन्दर	ə̃n̪d̪əɾ
अन्न	ə̃n̪n̪ᵊ
अन्य	ə̃n̪jə
अन्यथा	ə̃n̪jət̪ʰäː
अन्याय	ə̃n̪jäːj
अन्यायपूर्ण	ə̃n̪jäːjpuːɾɳ
अन्यायी	ə̃n̪jäːjiː
अपकार	əpkäːɾ
अपक्व	əpəkwə
अपना	əpn̪äː
अपमान	əpmä̃ːn̪
अपमानजनक	əpmä̃ːn̪d͡ʒən̪ək
अपमानित	əpmäːn̪ɪt̪
अपराध	əpɾäːd̪ʱ
अपराधिनी	əpɾäːd̪ʱɪn̪iː
अपराधी	əpɾäːd̪ʱiː
अपरिपक्व	əpɾɪpəkwᵊ
अपर्याप्त	əpəɾjäːpt̪
अपलक	əpəl̪ək
अपवाद	əpwäːd̪
अपव्यय	əpwjəj
अपशकुन	əpʃəkʊ̃n̪
अपसामान्य	əps̪äːmä̃ːn̪jᵊ
अपहरण	əpɦəɾə̃ɳ
अपहर्ता	əpʰəɾt̪äː
अपाहिज	əpäːɦɪd͡ʒ
अपेक्षा	əpeːkʃäː
अपेक्षाकृत	əpeːkʃäːkɾɪt̪
अपेक्षित	əpeːkʃɪt̪
अपॉइंटमेंट	əpɔɪ̃ɳʈmẽːɳʈ
अप्रकाशित	əpɾəkäːʃɪt̪
अप्रचलित	əpɾət͡ʃəl̪ɪt̪
अप्रत्यक्ष	əpɾət̪jəkʃ
अप्रत्याशित	əpɾət̪jäːʃɪt̪
अप्रसन्न	əpɾəs̪ə̃n̪n̪ᵊ
अप्रैल	əpɾɛːl̪
अप्सरा	əps̪əɾäː
अफगानिस्तान	əfɣäːn̪ɪs̪t̪ä̃ːn̪
अफगानिस्तान	əpʰɡäːn̪ɪs̪t̪ä̃ːn̪
अफरना	əpʰəɾn̪äː
अफसर	əfs̪əɾ
अफसर	əpʰs̪əɾ
अफ़लातून	əfl̪äːt̪ũːn̪
अफ़लातून	əpʰl̪äːt̪ũːn̪
अफ़वाह	əfʋäːɦ
अफ़वाह	əpʰʋäːɦ
अफ़सर	əfs̪əɾ
अफ़सर	əpʰs̪əɾ
अफ़साना	əfs̪äːn̪äː
अफ़साना	əpʰs̪äːn̪äː
अफ़सोसजनक	əfs̪oːs̪d͡ʒən̪ək
अफ़सोसजनक	əpʰs̪oːs̪d͡ʒən̪ək
अफ़ीम	əfĩːm
अफ़ीम	əpʰĩːm
अफ़ीमची	əfĩːmt͡ʃiː
अफ़ीमची	əpʰĩːmt͡ʃiː
अफ़्ग़ानिस्तान	əfɣäːn̪ɪs̪t̪ä̃ːn̪
अफ़्ग़ानिस्तान	əpʰɡäːn̪ɪs̪t̪ä̃ːn̪
अफ़्रीका	əfɾiːkäː
अफ़्रीका	əpʰɾiːkäː
अफ़्साना	əfs̪äːn̪äː
अफ़्साना	əpʰs̪äːn̪äː
अफीम	əfĩːm
अफीम	əpʰĩːm
अबटाबाद	əbʈäːbäːd̪
अबाबील	əbäːbiːl̪
अबिचल	əbɪt͡ʃəl̪
अबिवात्त	əbɪʋäːt̪t̪
अब्बा	əb̚bäː
अभयारण्य	əbʱjäːɾə̃ɳjᵊ
अभागा	əbʱäːɡäː
अभाव	əbʱäːʋ
अभिकथन	əbʱɪkət̪ʰə̃n̪
अभिकलित्र	əbʱɪkəl̪ɪt̪ɾᵊ
अभिकारक	əbʱɪkäːɾək
अभिक्रिया	əbʱɪkɾijäː
अभिगम	əbʱɪɡə̃m
अभिनंदन	əbʱɪn̪ə̃n̪d̪ə̃n̪
अभिनय	əbʱɪn̪əj
अभिनेता	əbʱɪn̪eːt̪äː
अभिनेत्री	əbʱɪn̪eːt̪ɾiː
अभिप्राय	əbʱɪpɾäːj
अभिभावक	əbʱɪbʱäːʋək
अभिमानी	əbʱɪmäːn̪iː
अभियंता	əbʱijə̃n̪t̪äː
अभियंत्रण	əbʱijə̃n̪t̪ɾə̃ɳ
अभियंत्रिकी	əbʱijə̃n̪t̪ɾɪkiː
अभियन्ता	əbʱijə̃n̪t̪äː
अभियांत्रिकी	əbʱijä̃ːn̪t̪ɾɪkiː
अभियान	əbʱijä̃ːn̪
अभियुक्त	əbʱijʊkt̪
अभियोक्ता	əbʱijoːkt̪äː
अभियोग	əbʱijoːɡ
अभियोजक	əbʱijoːd͡ʒək
अभिलाषा	əbʱɪl̪äːʃäː
अभिलेख	əbʱɪl̪eːkʰ
अभिवादन	əbʱɪʋäːd̪ə̃n̪
अभ्यंग	əbʱjə̃ŋɡ
अभ्यस्त	əbʱjəs̪t̪
अभ्यागत	əbʱjäːɡət̪
अभ्यास	əbʱjäːs̪
अभ्यासक्रम	əbʱjäːs̪kɾə̃m
अभ्यासवश	əbʱjäːs̪ʋəʃ
अमचूर	ə̃mt͡ʃuːɾ
अमन	əmə̃n̪
अमरावती	ə̃mɾäːʋət̪iː
अमरीका	ə̃mɾiːkäː
अमरूद	ə̃mɾuːd̪
अमल	əməl̪
अमानत	əmäːn̪ət̪
अमानती	əmäːn̪ət̪iː
अमानवीय	əmäːn̪əʋiːjᵊ
अमानवीयता	əmäːn̪əʋiːjət̪äː
अमान्य	əmä̃ːn̪jᵊ
अमावस	əmäːʋəs̪
अमाशय	əmäːʃəj
अमूल्य	əmuːl̪jᵊ
अमृत	ə̃mɾɪt̪
अमृतसर	ə̃mɾɪt̪s̪əɾ
अमेरिकन	əmeːɾɪkə̃n̪
अमेरिका	əmeːɾɪkäː
अम्बर	ə̃mbəɾ
अम्मा	ə̃mmäː
अम्माँ	ə̃mmä̃ː
अम्मी	ə̃mmiː
अम्ल	ə̃ml̪ᵊ
अम्लता	ə̃ml̪ᵊt̪äː
अम्लपित्त	ə̃ml̪əpɪt̪t̪
अम्लपित्त	ə̃ml̪ᵊpɪt̪t̪
अम्लीय	ə̃ml̪iːjᵊ
अयनांत	əjən̪ä̃ːn̪t̪
अयस्	əjəs̪
अयस्क	əjəs̪k
अयोग्यता	əjoːɡjət̪äː
अयोध्या	əjoːd̪ʱjäː
अरंडी	əɾə̃ɳɖiː
अरक्तता	əɾəkt̪̚t̪äː
अरगनी	əɾəɡn̪iː
अरदली	əɾd̪əl̪iː
अरबिंद	əɾbɪ̃n̪d̪
अरमान	əɾmä̃ːn̪
अरविंद	əɾʋɪ̃n̪d̪
अरसा	əɾs̪äː
अरस्तू	əɾəs̪t̪uː
अराजक	əɾäːd͡ʒək
अराजकता	əɾäːd͡ʒəkt̪äː
अराजकवाद	əɾäːd͡ʒəkwäːd̪
अराजकवादी	əɾäːd͡ʒəkwäːd̪iː
अरारोट	əɾäːɾoːʈ
अरिहंत	əɾɪɦə̃n̪t̪
अरोरा	əɾoːɾäː
अर्जन	əɾd͡ʒə̃n̪
अर्जुन	əɾd͡ʒʊ̃n̪
अर्जेंटीना	əɾd͡ʒẽːɳʈiːn̪äː
अर्जेण्टीना	əɾd͡ʒẽːɳʈiːn̪äː
अर्जेन्टीना	äːɾd͡ʒẽːɳʈiːn̪äː
अर्थव्यवस्था	əɾt̪ʰəʋjəʋəs̪t̪ʰäː
अर्थशास्त्री	əɾt̪ʰəʃäːs̪t̪ɾiː
अर्थहीन	əɾt̪ʰɦĩːn̪
अर्थात	əɾt̪ʰäːt̪
अर्थात्	əɾt̪ʰäːt̪
अर्थालंकार	əɾt̪ʰäːl̪ə̃ŋkäːɾ
अर्दली	əɾd̪əl̪iː
अर्धकुशल	əɾd̪ʱkʊʃəl̪
अर्धतत्सम	əɾd̪ʱət̪ət̪s̪ə̃m
अर्धवार्षिक	əɾd̪ʱʋäːɾʃɪk
अर्धविकसित	əɾd̪ʱʋɪks̪ɪt̪
अर्धशिक्षित	əɾd̪ʱʃɪkʃɪt̪
अर्धसरकारी	əɾd̪ʱs̪əɾkäːɾiː
अर्धसाप्ताहिक	əɾd̪ʱs̪äːpt̪äːɦɪk
अर्धांगिनी	əɾd̪ʱä̃ːŋɡɪn̪iː
अर्धायु	əɾd̪ʱäːjuː
अर्पण	əɾpə̃ɳ
अर्यमा	əɾjəmäː
अलंकार	əl̪ə̃ŋkäːɾ
अलंकृत	əl̪ə̃ŋkɾɪt̪
अलक़तरा	əl̪kət̪ɾäː
अलक़तरा	əl̪qət̪ɾäː
अलगाना	əl̪ɡäːn̪äː
अलगाव	əl̪ɡäːʋ
अलगाववाद	əl̪ɡäːʋʋäːd̪
अलगाववादी	əl̪ɡäːʋʋäːd̪iː
अलबता	əl̪bət̪äː
अलबत्ता	əl̪bət̪̚t̪äː
अलबम	əl̪bə̃m
अलम	əl̪ə̃m
अलमारी	əl̪mäːɾiː
अलम्	əl̪ə̃m
अलविदा	əl̪ʋɪd̪äː
अलसाना	əl̪s̪äːn̪äː
अलहदा	əl̪ɛɦd̪äː
अलादीन	əl̪äːd̪ĩːn̪
अलापना	əl̪äːpn̪äː
अलार्म	əl̪ɑːɾm
अलार्म	əl̪ɑːɾəm
अलाव	əl̪äːʋ
अलि	əl̪iː
अलिखित	əl̪ɪkʰɪt̪
अलीगढ	əl̪iːɡəɽʱ
अलीगढ़	əl̪iːɡəɽʱ
अलोना	əl̪oːn̪äː
अल्जीरिया	əl̪d͡ʒiːɾijäː
अल्टीमेटम	əl̪ʈiːmeːʈə̃m
अल्पकारी	əl̪pəkäːɾiː
अल्पसंख्यक	əl̪ps̪ə̃ŋkʰjək
अल्पावस्था	əl̪päːʋəs̪t̪ʰäː
अल्पाहार	əl̪päːɦäːɾ
अल्फ़ा	əl̪fäː
अल्फ़ा	əl̪pʰäː
अल्फ़ाज़	əl̪fäːz
अल्फ़ाज़	əl̪pʰäːd͡ʒ
अल्बम	əl̪bə̃m
अल्बानियन	əl̪bäːn̪ijə̃n̪
अल्बानिया	əl̪bäːn̪ijäː
अल्लाह	əl̪l̪äːɦ
अल्हड़	əl̪ɦəɽ
अवकलज	əʋkəl̪əd͡ʒ
अवकलन	əʋkəl̪ə̃n̪
अवकलनीय	əʋkəl̪ən̪iːjᵊ
अवक्षयण	əʋkʃəjə̃ɳ
अवक्षेपण	əʋkʃeːpə̃ɳ
अवगुण	əʋɡʊ̃ɳ
अवज्ञा	əʋəɡjäː
अवतल	əʋt̪əl̪
अवतार	əʋt̪äːɾ
अवधारण	əʋd̪ʱäːɾə̃ɳ
अवधारणा	əʋd̪ʱäːɾɳäː
अवनति	əʋn̪ət̪iː
अवपंक	əʋpə̃ŋk
अवयस्क	əʋəjəs̪k
अवलंब	əʋl̪ə̃mb
अवलोकन	əʋl̪oːkə̃n̪
अवशोषण	əʋʃoːʃə̃ɳ
अवशोषित	əʋʃoːʃɪt̪
अवसंरचना	əʋs̪ə̃ɾət͡ʃn̪äː
अवसर	əʋs̪əɾ
अवस्था	əʋəs̪t̪ʰäː
अवहेलना	əʋɦeːl̪n̪äː
अवांछित	əʋä̃ːn̪t͡ʃʰɪt̪
अवाई	əʋäːiː
अवाक्	əʋäːk
अवाम	əʋä̃ːm
अवार्ड	əʋäːɾɖ
अविकसित	əʋɪks̪ɪt̪
अविकारी	əʋɪkäːɾiː
अविचल	əʋɪt͡ʃəl̪
अविच्छिन्न	əʋɪt̚t͡ʃʰɪ̃n̪n̪ᵊ
अविनय	əʋɪn̪əj
अविनीत	əʋɪn̪iːt̪
अविलंब	əʋɪl̪ə̃mb
अविवाहित	əʋɪʋäːɦɪt̪
अविश्वास	əʋɪʃʋäːs̪
अविश्वासनीय	əʋɪʃʋäːs̪n̪iːjᵊ
अविस्मरणीय	əʋɪs̪məɾəɳiːjᵊ
अवैतनिक	ʋɛːt̪ən̪ɪk
अवोकाडो	əʋoːkäːɖoː
अव्यवस्था	əʋjəʋəs̪t̪ʰäː
अव्यावहारिक	əʋjäːʋɦäːɾɪk
अव्वल	əʋʋəl̪
अशांत	əʃä̃ːn̪t̪
अशांति	əʃä̃ːn̪t̪iː
अशान्ति	əʃä̃ːn̪t̪iː
अशिष्टता	əʃɪʃʈt̪äː
अशुद्धि	əʃʊd̪̚d̪ʱiː
अश्लील	əʃl̪iːl̪
अश्लीलता	əʃl̪iːl̪t̪äː
अश्विनी	əʃʋɪn̪iː
अष्टकोण	əʂʈkõːɳ
असंख्य	əs̪ə̃ŋkʰjᵊ
असंगत	əs̪ə̃ŋɡət̪
असंगति	əs̪ə̃ŋɡət̪iː
असंतुष्ट	əs̪ə̃n̪t̪ʊʂʈ
असंतोष	əs̪ə̃n̪t̪oːʃ
असंतोषजनक	əs̪ə̃n̪t̪oːʃd͡ʒən̪ək
असंभव	əs̪ə̃mbʱəʋ
असंभावित	əs̪ə̃mbʱäːʋɪt̪
असंवेदनशील	əs̪ə̃mweːd̪ə̃n̪ʃiːl̪
असंवैधानिक	əs̪ə̃mwɛːd̪ʱäːn̪ɪk
असत्य	əs̪ət̪jᵊ
असत्याभास	əs̪ət̪jäːbʱäːs̪
असफल	əs̪əpʰəl̪
असफलता	əs̪əpʰəl̪t̪äː
असबाब	əs̪bäːb
असभ्य	əs̪əbʱjᵊ
असभ्यता	əs̪əbʱjət̪äː
असम	əs̪ə̃m
असमंजस	əs̪əmə̃n̪d͡ʒəs̪
असमय	əs̪əməj
असमर्थ	əs̪əməɾt̪ʰ
असमर्थता	əs̪əməɾt̪ʰt̪äː
असमान	əs̪mä̃ːn̪
असमान	əs̪əmä̃ːn̪
असमानता	əs̪əmä̃ːn̪t̪äː
असमाप्त	əs̪əmäːpt̪
असमीकरण	əs̪əmiːkəɾə̃ɳ
असम्भव	əs̪ə̃mbʱəʋ
असर	əs̪əɾ
असल	əs̪əl̪
असलियत	əs̪l̪ijət̪
असली	əs̪l̪iː
असहमत	əs̪ɛɦmət̪
असहमति	əs̪ɛɦmət̪iː
असहयोग	əs̪ɛɦjoːɡ
असहाय	əs̪ɦäːj
असहिष्णु	əs̪əɦɪʃɳuː
असहिष्णुता	əs̪əɦɪʃɳʊt̪äː
असह्य	əs̪ɛɦjᵊ
असाढ़	əs̪äːɽʱ
असाधारण	əs̪äːd̪ʱäːɾə̃ɳ
असाध्य	əs̪äːd̪ʱjᵊ
असामयिक	əs̪äːməjɪk
असामाजिक	əs̪äːmäːd͡ʒɪk
असामान्य	əs̪äːmä̃ːn̪jᵊ
असार	əs̪äːɾ
असावधान	əs̪äːʋd̪ʱä̃ːn̪
असावधानता	əs̪äːʋd̪ʱä̃ːn̪t̪äː
असिस्टेंट	əs̪ɪs̪ʈẽːɳʈ
असीम	əs̪ĩːm
असीस	əs̪iːs̪
असुंदर	əsʊ̃n̪d̪əɾ
असुरक्षित	əs̪ʊɾəkʃɪt̪
असुविधा	əs̪ʊʋɪd̪ʱäː
असुविधाजनक	əs̪ʊʋɪd̪ʱäːd͡ʒən̪ək
असेंबली	əs̪ẽːmbl̪iː
असैनिक	əs̪ɛːn̪ɪk
अस्तबल	əs̪t̪əbəl̪
अस्तर	əs̪t̪əɾ
अस्तव्यस्त	əs̪t̪wjəs̪t̪
अस्तित्व	əs̪t̪ɪt̪wᵊ
अस्थमा	əs̪t̪ʰəmäː
अस्थायी	əs̪t̪ʰäːjiː
अस्थि	əs̪t̪ʰiː
अस्थिपंजर	əs̪t̪ʰɪpə̃n̪d͡ʒəɾ
अस्थिर	əs̪t̪ʰɪɾ
अस्थिरता	əs̪t̪ʰɪɾt̪äː
अस्पताल	əs̪pət̪äːl̪
अस्पताली	əs̪pət̪äːl̪iː
अस्पष्ट	əs̪pəʂʈ
अस्पष्टता	əs̪pəʃʈət̪äː
अस्पृश्य	əs̪pɾɪʃjᵊ
अस्पृश्यता	əs̪pɾɪʃjət̪äː
अस्मिता	əs̪mɪt̪äː
अस्वस्थ	əs̪ʋəs̪t̪ʰ
अस्वस्थता	əs̪ʋəs̪t̪ʰət̪äː
अस्वाभाविक	əs̪ʋäːbʱäːʋɪk
अस्वीकार	əs̪ʋiːkäːɾ
अस्वीकृत	əs̪ʋiːkɾɪt̪
अस्वीकृति	əs̪ʋiːkɾɪt̪iː
अस्सी	əs̪s̪iː
अहं	ɛɦɛ̃
अहं	ɛɦɛ̃m
अहंकार	ɛɦɛ̃ŋkäːɾ
अहबाब	ɛɦbäːb
अहम	ɛɦɛ̃m
अहमदाबाद	ɛɦməd̪äːbäːd̪
अहमियत	ɛɦmijət̪
अहवाल	ɛɦʋäːl̪
अहसास	ɛɦs̪äːs̪
अहाता	əɦäːt̪äː
अहिंदी	əɦɪ̃n̪d̪iː
अहिंसक	əɦɪ̃n̪s̪ək
अहिंसा	əɦɪ̃n̪s̪äː
अहिंसात्मक	əɦɪ̃n̪s̪äːt̪mək
अहिच्छत्र	əɦɪt̚t͡ʃʰət̪ɾᵊ
अहिनाह	əɦɪn̪äːɦ
अहिर्बुश्न	əɦɪɾbʊʃn̪ᵊ
अहिवात	əɦɪʋäːt̪
अहिवाद	əɦɪʋäːd̪
अहेरन	əɦeːɾə̃n̪
अहोभाग्य	əɦoːbʱäːɡjᵊ
आ	äː
आँकड़ा	ä̃ːkɽäː
आँख	ä̃ːkʰ
आँगन	ä̃ːɡə̃n̪
आँगनवाड़ी	ä̃ːŋɡə̃n̪wäːɽiː
आँच	ä̃ːt͡ʃ
आँचलिक	ä̃ːt͡ʃl̪ɪk
आँत	ä̃ːt̪
आँधी	ä̃ːn̪d̪ʱiː
आँसू	ä̃ːs̪uː
आंगन	ä̃ːɡə̃n̪
आंग्ल	ä̃ːŋɡl̪ᵊ
आंत	ä̃ːn̪t̪
आंतरिक	ä̃ːn̪t̪ɾɪk
आंदोलन	ä̃ːn̪d̪oːl̪ə̃n̪
आंधी	ä̃ːn̪d̪ʱiː
आंवला	ä̃ːmwl̪äː
आंशिक	ä̃ːn̪ʃɪk
आंसू	ä̃ːn̪s̪uː
आइंदा	äːɪ̃n̪d̪äː
आइंस्टीनियम	äːɪ̃n̪s̪ʈiːn̪ijə̃m
आइज़ोल	äːɪd͡ʒoːl̪
आइज़ोल	äːɪzoːl̪
आइसक्रीम	äːɪs̪kɾĩːm
आइसलैंड	äːɪs̪l̪ɛ̃ːɳɖ
आइस्ड	äːɪs̪ɖ
आई	äːiː
आईना	aːiːnaː
आईला	äːiːl̪äː
आउट	äːʊʈ
आक	äːk
आकर्षक	äːkəɾʃək
आकर्षण	äːkəɾʃə̃ɳ
आकर्षित	äːkəɾʃɪt̪
आकर्षी	äːkəɾʃiː
आकलन	äːkəl̪ə̃n̪
आकस्मिक	äːkəs̪mɪk
आक़ा	äːkäː
आक़ा	äːqäː
आकांक्षा	äːkä̃ːkʃäː
आकांक्षी	äːkä̃ːkʃiː
आकार	äːkäːɾ
आकाश	äːkäːʃ
आकाशगंगा	äːkäːʃɡə̃ŋɡäː
आकाशवाणी	äːkäːʃʋäːɳiː
आकाशी	äːkäːʃiː
आकृत	äːkɾɪt̪
आकृति	äːkɾɪt̪iː
आकृष्ट	äːkɾɪʂʈ
आक्रमण	äːkɾəmə̃ɳ
आक्रमणकारी	äːkɾəmə̃ɳkäːɾiː
आक्रामक	äːkɾäːmək
आक्रामकता	äːkɾäːməkt̪äː
आक्रोश	äːkɾoːʃ
आक्षेप	äːkʃeːp
आखरी	äːkʰɾiː
आखरी	äːxɾiː
आख़िर	äːkʰɪɾ
आख़िर	äːxɪɾ
आख़िरकार	äːkʰɪɾkäːɾ
आख़िरकार	äːxɪɾkäːɾ
आख़िरत	äːkʰɪɾət̪
आख़िरत	äːxɪɾət̪
आख़िरी	äːkʰɪɾiː
आख़िरी	äːkʰɾiː
आख़िरी	äːxɪɾiː
आख़िरी	äːxɾiː
आखातीज	äːkʰäːt̪iːd͡ʒ
आखिर	äːkʰɪɾ
आखिर	äːxɪɾ
आखिरी	äːkʰɪɾiː
आखेट	äːkʰeːʈ
आखेटक	äːkʰeːʈək
आग	äːɡ
आगंतुक	äːɡə̃n̪t̪ʊk
आगजनी	äːɡd͡ʒən̪iː
आगज़नी	äːɡd͡ʒən̪iː
आगज़नी	äːɡzən̪iː
आगमन	äːɡəmə̃n̪
आगरा	äːɡɾäː
आग़ा	äːɡäː
आग़ा	äːɣäː
आग़ाज़	äːɡäːd͡ʒ
आग़ाज़	äːɣäːz
आग़ोश	äːɡoːʃ
आग़ोश	äːɣoːʃ
आगा	äːɡäː
आगार	äːɡäːɾ
आगाह	äːɡäːɦ
आगाही	äːɡäːɦiː
आगे	äːɡeː
आग्नेय	äːɡn̪eːj
आग्नेयास्त्र	äːɡn̪eːjäːs̪t̪ɾᵊ
आग्रह	äːɡɾəɦ
आग्रहपूर्वक	äːɡɾɛɦpuːɾʋək
आघ	äːɡʱ
आघात	äːɡʱäːt̪
आघातपूर्ण	äːɡʱäːt̪puːɾɳ
आचरण	äːt͡ʃəɾə̃ɳ
आचार	äːt͡ʃäːɾ
आचार्य	äːt͡ʃäːɾjᵊ
आछा	äːt͡ʃʰäː
आज	äːd͡ʒ
आजमाइश	äːd͡ʒmäːɪʃ
आजमाना	äːd͡ʒmäːn̪äː
आजमाना	äːzmäːn̪äː
आज़माइश	äːd͡ʒmäːɪʃ
आज़माइश	äːzmäːɪʃ
आज़माना	äːd͡ʒmäːn̪äː
आज़माना	äːzmäːn̪äː
आज़र्बैजान	äːd͡ʒəɾbɛːd͡ʒä̃ːn̪
आज़र्बैजान	äːzəɾbɛːd͡ʒä̃ːn̪
आज़ाद	äːd͡ʒäːd̪
आज़ाद	äːzäːd̪
आज़ार	äːd͡ʒäːɾ
आज़ार	äːzäːɾ
आजाद	äːd͡ʒäːd̪
आजादी	äːd͡ʒäːd̪iː
आजीवन	äːd͡ʒiːʋə̃n̪
आजीविका	äːd͡ʒiːʋɪkäː
आज्ञा	äːɡjäː
आटा	äːʈäː
आटिचोक	äːʈɪt͡ʃoːk
आठ	äːʈʰ
आठवाँ	äːʈʰʋä̃ː
आडंबर	äːɖə̃mbəɾ
आडवाणी	äːɖwäːɳiː
आड़	äːɽ
आड़ा	äːɽäː
आड़ू	äːɽuː
आण्विक	ä̃ːɳwɪk
आतंकमय	äːt̪ə̃ŋkməj
आतंकवाद	äːt̪ə̃ŋkwäːd̪
आतंकवादी	äːt̪ə̃ŋkwäːd̪iː
आतंकित	äːt̪ə̃ŋkɪt̪
आततायी	äːt̪ət̪äːjiː
आतमीयता	äːt̪miːjt̪äː
आतिश	äːt̪ɪʃ
आतिशबाज़ी	äːt̪ɪʃbäːd͡ʒiː
आतिशबाज़ी	äːt̪ɪʃbäːziː
आतिशबाजी	äːt̪ɪʃbäːd͡ʒiː
आतिशबाजी	äːt̪ɪʃbäːziː
आतुर	äːt̪ʊɾ
आतुरता	äːt̪ʊɾt̪äː
आत्मकथा	äːt̪mᵊkət̪ʰäː
आत्मघात	äːt̪məɡʱäːt̪
आत्मघाती	äːt̪məɡʱäːt̪iː
आत्मज्ञान	äːt̪məɡjä̃ːn̪
आत्मत्याग	äːt̪mət̪jäːɡ
आत्मनिंदा	äːt̪mən̪ɪ̃n̪d̪äː
आत्मनिर्णय	äːt̪mən̪ɪɾɳəj
आत्मनिर्भर	äːt̪mən̪ɪɾbʱəɾ
आत्मनिर्भरता	äːt̪mən̪ɪɾbʱəɾt̪äː
आत्मप्रशंसा	äːt̪məpɾəʃə̃n̪s̪äː
आत्मबलिदान	äːt̪məbəl̪ɪd̪ä̃ːn̪
आत्मबोध	äːt̪məboːd̪ʱ
आत्मरक्षा	äːt̪məɾəkʃäː
आत्मविश्वास	äːt̪məʋɪʃʋäːs̪
आत्मसंतोष	äːt̪məs̪ə̃n̪t̪oːʃ
आत्मसंमान	äːt̪məs̪ə̃mmä̃ːn̪
आत्मसमर्पण	äːt̪mᵊs̪əməɾpə̃ɳ
आत्मसात	äːt̪məs̪äːt̪
आत्मसात्	äːt̪məs̪äːt̪
आत्मस्तुति	äːt̪məs̪t̪ʊt̪iː
आत्महत्या	äːt̪mᵊɦət̪jäː
आत्मा	äːt̪mäː
आत्माभिमान	äːt̪mäːbʱɪmä̃ːn̪
आत्मिक	äːt̪mɪk
आत्मीय	äːt̪miːjᵊ
आत्मीयता	äːt̪miːjt̪äː
आत्मोद्धार	äːt̪moːd̪̚d̪ʱäːɾ
आदत	äːd̪ət̪
आदतन	äːd̪ət̪ə̃n̪
आदम	äːd̪ə̃m
आदमी	äːd̪miː
आदर	äːd̪əɾ
आदरणीय	äːd̪əɾɳiːjᵊ
आदरपूर्वक	äːd̪əɾpuːɾʋək
आदर्श	äːd̪əɾʃ
आदा	äːd̪äː
आदान	äːd̪ä̃ːn̪
आदाब	äːd̪äːb
आदि	äːd̪iː
आदिभाषा	äːd̪ɪbʱäːʃäː
आदिम	äːd̪ɪ̃m
आदिवासी	äːd̪ɪʋäːs̪iː
आदी	äːd̪iː
आदेश	äːd̪eːʃ
आध	äːd̪ʱ
आधा	äːd̪ʱäː
आधार	äːd̪ʱäːɾ
आधारभूत	äːd̪ʱäːɾbʱuːt̪
आधारित	äːd̪ʱäːɾɪt̪
आधिक	äːd̪ʱɪk
आधिकारिक	äːd̪ʱɪkäːɾɪk
आधिक्य	äːd̪ʱɪkjᵊ
आधिपत्य	äːd̪ʱɪpət̪jᵊ
आधुनिक	äːd̪ʱʊn̪ɪk
आधुनिकतम	äːd̪ʱʊn̪ɪkt̪ə̃m
आधुनिकता	äːd̪ʱʊn̪ɪkt̪äː
आधुनिकीकरण	äːd̪ʱʊn̪ɪkiːkəɾə̃ɳ
आध्यात्मिक	äːd̪ʱjäːt̪mɪk
आन	ä̃ːn̪
आनंद	äːn̪ə̃n̪d̪
आनंददायी	äːn̪ə̃n̪d̪d̪äːjiː
आनंदमय	äːn̪ə̃n̪d̪məj
आनन	äːn̪ə̃n̪
आनरेरी	ä̃ːn̪ɾeːɾiː
आना	äːn̪äː
आनुवंशिकी	äːn̪ʊʋə̃n̪ʃɪkiː
आन्दोलन	ä̃ːn̪d̪oːl̪ə̃n̪
आप	äːp
आपका	äːpkäː
आपत्ति	äːpət̪̚t̪iː
आपत्तिजनक	äːpət̪̚t̪iːd͡ʒən̪ək
आपदा	äːpd̪äː
आपबीती	äːp̚biːt̪iː
आपस	äːpəs̪
आपसदारी	äːpəs̪d̪äːɾiː
आपसी	äːps̪iː
आपा	äːpäː
आपात	äːpäːt̪
आपातकाल	äːpäːt̪käːl̪
आपाधापी	äːpäːd̪ʱäːpiː
आपूर्ति	äːpuːɾt̪iː
आपेक्षिक	äːpeːkʃɪk
आप्रवास	äːpɾəʋäːs̪
आप्रवासी	äːpɾəʋäːs̪iː
आफत	äːpʰət̪
आफताब	äːft̪äːb
आफताब	äːpʰt̪äːb
आफ़त	äːfət̪
आफ़त	äːpʰət̪
आफ़ताब	äːft̪äːb
आफ़ताब	äːpʰt̪äːb
आफ़रीन	äːfɾĩːn̪
आफ़रीन	äːpʰɾĩːn̪
आफ़्रीदी	äːfɾiːd̪iː
आफ़्रीदी	äːpʰɾiːd̪iː
आफिस	äːpʰɪs̪
आब	äːb
आबकारी	äːbkäːɾiː
आबदस्त	äːbd̪əs̪t̪
आबरू	äːbɾuː
आबला	äːbl̪äː
आभास	äːbʱäːs̪
आभूषण	äːbʱuːʃə̃ɳ
आम	ä̃ːm
आमंत्रण	äːmə̃n̪t̪ɾə̃ɳ
आमंत्रित	äːmə̃n̪t̪ɾɪt̪
आमदनी	äːməd̪̚n̪iː
आमवात	ä̃ːmwäːt̪
आमाशय	äːmäːʃəj
आमिक्षा	äːmɪkʃäː
आमुख	äːmʊkʰ
आय	äːj
आयत	äːjət̪
आयतन	äːjt̪ə̃n̪
आयन	äːjə̃n̪
आयरलैंड	äːjəɾl̪ɛ̃ːɳɖ
आया	äːjäː
आयात	äːjäːt̪
आयातक	äːjäːt̪ək
आयातकर्ता	äːjäːt̪kəɾt̪äː
आयाम	äːjä̃ːm
आयु	äːjuː
आयुक्त	äːjʊkt̪
आयुर्विज्ञान	äːjʊɾʋɪɡjä̃ːn̪
आयुर्वेद	äːjʊɾʋeːd̪
आयोग	äːjoːɡ
आयोजन	äːjoːd͡ʒə̃n̪
आयोजित	äːjoːd͡ʒɪt̪
आरंभिक	äːɾə̃mbʱɪk
आरक्षण	äːɾəkʃə̃ɳ
आरज़ू	äːɾd͡ʒuː
आरज़ू	äːɾzuː
आरा	äːɾäː
आराम	äːɾä̃ːm
आराम	ɑːɾɑːm
आरामगाह	äːɾä̃ːmɡäːɦ
आरामदेह	äːɾä̃ːmd̪eːɦ
आरोग्य	äːɾoːɡjᵊ
आरोप	äːɾoːp
आर्जेंटीना	äːɾd͡ʒẽːɳʈiːn̪äː
आर्थिक	äːɾt̪ʰɪk
आर्थिकी	äːɾt̪ʰɪkiː
आर्द्र	äːɾd̪ɾᵊ
आर्मीनिया	äːɾmiːn̪ijäː
आर्मेनियन	äːɾmeːn̪ijə̃n̪
आर्मेनिया	äːɾmeːn̪ijäː
आर्य	äːɾjᵊ
आर्यन	äːɾjə̃n̪
आर्यमन	äːɾjəmə̃n̪
आलपीन	äːl̪pĩːn̪
आलप्पुष़ा	äːl̪əp̚pʊɭäː
आलम	äːl̪ə̃m
आलय	äːl̪əj
आलस	äːl̪əs̪
आलसी	äːl̪s̪iː
आलस्य	äːl̪əs̪jᵊ
आला	äːl̪äː
आलिम	äːl̪ɪ̃m
आलीशान	äːl̪iːʃä̃ːn̪
आलु	äːl̪uː
आलुक	äːl̪ʊk
आलू	äːl̪uː
आलेख	äːl̪eːkʰ
आलोचना	äːl̪oːt͡ʃn̪äː
आवंटन	äːʋə̃ɳʈə̃n̪
आवंटित	äːʋə̃ɳʈɪt̪
आवक	äːʋək
आवर्त	äːʋəɾt̪
आवर्धन	äːʋəɾd̪ʱə̃n̪
आवश्यक	äːʋəʃjək
आवश्यकता	äːʋəʃjəkt̪äː
आवाज	äːʋäːd͡ʒ
आवाज	äːʋäːz
आवाज़	äːʋäːd͡ʒ
आवाज़	äːʋäːz
आवाजाही	äːʋäːd͡ʒäːɦiː
आवारा	äːʋäːɾäː
आवाहन	äːʋäːɦə̃n̪
आविष्कार	äːʋɪʃkäːɾ
आवृत्ति	äːʋɾɪt̪̚t̪iː
आवेग	äːʋeːɡ
आवेदन	äːʋeːd̪ə̃n̪
आवेदनकर्ता	äːʋeːd̪ə̃n̪kəɾt̪äː
आवेश	äːʋeːʃ
आवेशित	äːʋeːʃɪt̪
आव्यूह	äːʋjuːɦ
आशंका	äːʃə̃ŋkäː
आशना	äːʃn̪äː
आशय	äːʃəj
आशा	äːʃäː
आशावाद	äːʃäːʋäːd̪
आशिक़	äːʃɪk
आशिक़	äːʃɪq
आशिक़मिज़ाज	äːʃɪkmɪd͡ʒäːd͡ʒ
आशिक़मिज़ाज	äːʃɪqmɪzäːd͡ʒ
आशिक़ी	äːʃɪkiː
आशिक़ी	äːʃɪqiː
आशियाना	äːʃijäːn̪äː
आशिष	äːʃɪʃ
आशीर्वाद	äːʃiːɾʋäːd̪
आशुलिपि	äːʃʊl̪ɪpiː
आश्चर्य	äːʃt͡ʃəɾjᵊ
आश्रम	äːʃɾə̃m
आश्रय	äːʃɾəj
आश्वासन	äːʃʋäːs̪ə̃n̪
आश्विन	äːʃʋɪ̃n̪
आषाढ़	äːʃäːɽʱ
आस	äːs̪
आसंका	äːs̪ə̃ŋkäː
आसंद	äːs̪ə̃n̪d̪
आसक्त	äːs̪əkt̪
आसन	äːs̪ə̃n̪
आसन्द	äːs̪ə̃n̪d̪
आसन्न	äːs̪ə̃n̪n̪ᵊ
आसमान	äːs̪mä̃ːn̪
आसमानी	äːs̪mäːn̪iː
आसरा	äːs̪ɾäː
आसवन	äːs̪əʋə̃n̪
आसानी	äːs̪äːn̪iː
आसाम	äːs̪ä̃ːm
आसामी	äːs̪äːmiː
आसार	äːs̪äːɾ
आस्ति	äːs̪t̪iː
आस्तिक	äːs̪t̪ɪk
आस्तीन	äːs̪t̪ĩːn̪
आस्था	äːs̪t̪ʰäː
आह	äːɦ
आहट	äːɦəʈ
आहत	äːɦət̪
आहरण	äːɦɾə̃ɳ
आहार	äːɦäːɾ
आहिस्ता	äːɦɪs̪t̪äː
आहिस्ता	äːɪs̪t̪äː
आहुति	äːɦʊt̪iː
इंक़लाब	ɪ̃n̪kəl̪äːb
इंक़लाब	ɪ̃n̪qəl̪äːb
इंक़िलाब	ɪ̃ŋkɪl̪äːb
इंक़िलाब	ɪ̃ɴqɪl̪äːb
इंकार	ɪ̃ŋkäːɾ
इंगन	ɪ̃ŋɡə̃n̪
इंगनी	ɪ̃ŋɡn̪iː
इंगलिस्तान	ɪ̃ŋɡl̪ɪs̪t̪ä̃ːn̪
इंग्लिश	ɪ̃ŋɡl̪ɪʃ
इंग्लैंड	ɪ̃ŋɡl̪ɛ̃ːɳɖ
इंच	ɪ̃n̪t͡ʃ
इंचियोन	ɪ̃n̪t͡ʃijõːn̪
इंजन	ɪ̃n̪d͡ʒə̃n̪
इंजीनियर	ɪ̃n̪d͡ʒiːn̪ijəɾ
इंजीनियरी	ɪ̃n̪d͡ʒiːn̪ijəɾiː
इंजील	ɪ̃n̪d͡ʒiːl̪
इंटरनेट	ɪ̃ɳʈəɾn̪eːʈ
इंटरफ़ेस	ɪ̃ɳʈəɾfeːs̪
इंटरफ़ेस	ɪ̃ɳʈəɾpʰeːs̪
इंटरव्यू	ɪ̃ɳʈəɾʋjuː
इंटेल	ɪ̃ɳʈeːl̪
इंट्यूबेशन	ɪ̃ɳʈjuːbeːʃə̃n̪
इंडस्ट्री	ɪ̃ɳɖəs̪ʈɾiː
इंडिया	ɪ̃ɳɖijäː
इंडोनेशियन	ɪ̃ɳɖoːn̪eːʃijə̃n̪
इंडोनेशिया	ɪ̃ɳɖoːn̪eːʃijäː
इंतक़ाम	ɪ̃n̪t̪əkä̃ːm
इंतक़ाम	ɪ̃n̪t̪əqä̃ːm
इंतक़ाल	ɪ̃n̪t̪əkäːl̪
इंतक़ाल	ɪ̃n̪t̪əqäːl̪
इंतकाल	ɪ̃n̪t̪əkäːl̪
इंतकाल	ɪ̃n̪t̪əqäːl̪
इंतख़ाब	ɪ̃n̪t̪əkʰäːb
इंतख़ाब	ɪ̃n̪t̪əxäːb
इंतज़ाम	ɪ̃n̪t̪əd͡ʒä̃ːm
इंतज़ाम	ɪ̃n̪t̪əzä̃ːm
इंतज़ार	ɪ̃n̪t̪əd͡ʒäːɾ
इंतज़ार	ɪ̃n̪t̪əzäːɾ
इंतहा	ɪ̃n̪t̪əɦäː
इंतिफ़ादा	ɪ̃n̪t̪ɪfäːd̪äː
इंतिफ़ादा	ɪ̃n̪t̪ɪpʰäːd̪äː
इंतिहा	ɪ̃n̪t̪ɪɦäː
इंदु	ɪ̃n̪d̪uː
इंदुर	ɪ̃n̪d̪ʊɾ
इंदौर	ɪ̃n̪d̪ɔːɾ
इंद्रनाथ	ɪ̃n̪d̪ɾən̪äːt̪ʰ
इंद्रिय	ɪ̃n̪d̪ɾɪj
इंफाल	ɪ̃mpʰäːl̪
इंसानी	ɪ̃n̪s̪äːn̪iː
इंस्पेक्टर	ɪ̃n̪s̪peːkʈəɾ
इकट्ठा	ɪkəʈ̚ʈʰäː
इकतारा	ɪkt̪äːɾäː
इकतालीस	ɪkt̪äːl̪iːs̪
इकतीस	ɪkt̪iːs̪
इकत्तीस	ɪkət̪̚t̪iːs̪
इकनाली	ɪkn̪äːl̪iː
इकपहिया	ɪkəpʰijäː
इकबाल	ɪkbäːl̪
इकबाल	ɪqbäːl̪
इकरार	ɪkɾäːɾ
इकरार	ɪqɾäːɾ
इकलौता	ɪkl̪ɔːt̪äː
इकसठ	ɪks̪əʈʰ
इकसिंगा	ɪks̪ɪ̃ŋɡäː
इकहत्तर	ɪkɦət̪̚t̪əɾ
इकाई	ɪkäːiː
इकानवे	ɪkä̃ːn̪weː
इकावन	ɪkäːʋə̃n̪
इकासी	ɪkäːs̪iː
इक्कीस	ɪk̚kiːs̪
इक्यानवे	ɪkjä̃ːn̪weː
इक्यावन	ɪkjäːʋə̃n̪
इक्यासी	ɪkjäːs̪iː
इख़्तियार	ɪkʰt̪ijäːɾ
इख़्तियार	ɪxt̪ijäːɾ
इग्ज़ाम	ɪɡd͡ʒä̃ːm
इग्ज़ाम	ɪɡzä̃ːm
इग्लू	ɪɡl̪uː
इच्छा	ɪt̚t͡ʃʰäː
इजमाली	ɪd͡ʒmäːl̪iː
इज़हार	ɪd͡ʒʱäːɾ
इज़हार	ɪzɦäːɾ
इज़ाफ़ा	ɪd͡ʒäːpʰäː
इज़ाफ़ा	ɪzäːfäː
इज़्ज़त	ɪd̚d͡ʒət̪
इजाजत	ɪd͡ʒäːd͡ʒət̪
इजाजत	ɪd͡ʒäːzət̪
इजाज़त	ɪd͡ʒäːd͡ʒət̪
इजाज़त	ɪd͡ʒäːzət̪
इज्जत	ɪd̚d͡ʒət̪
इटली	ɪʈl̪iː
इटली	ɪʈəl̪iː
इटालियन	ɪʈäːl̪ijə̃n̪
इडली	ɪɖl̪iː
इतराना	ɪt̪ɾäːn̪äː
इतवार	ɪt̪wäːɾ
इतालवी	ɪt̪äːl̪ʋiː
इतिहास	ɪt̪ɪɦäːs̪
इतिहासकार	ɪt̪ɪɦäːs̪käːɾ
इत्तिहाद	ɪt̪̚t̪ɪɦäːd̪
इत्तेला	ɪt̪̚t̪eːl̪äː
इत्मीनान	ɪt̪miːn̪ä̃ːn̪
इत्यादि	ɪt̪jäːd̪iː
इथियोपिया	ɪt̪ʰijoːpijäː
इन	ɪ̃n̪
इनका	ɪ̃n̪käː
इनकार	ɪ̃n̪käːɾ
इनको	ɪ̃n̪koː
इनसाफ़	ɪ̃n̪s̪äːf
इनसाफ़	ɪ̃n̪s̪äːpʰ
इनायत	ɪn̪äːjət̪
इन्टरनेट	ɪ̃n̪ʈəɾn̪eːʈ
इन्हें	ɪ̃n̪ɦẽː
इफ़्तिताह	ɪft̪ɪt̪äːɦ
इफ़्तिताह	ɪpʰt̪ɪt̪äːɦ
इबादत	ɪbäːd̪ət̪
इब्तिदा	ɪbt̪ɪd̪äː
इब्तिदाई	ɪbt̪ɪd̪äːiː
इब्राहीम	ɪbɾäːɦĩːm
इमदाद	ɪ̃md̪äːd̪
इमला	ɪ̃ml̪äː
इमली	ɪ̃ml̪iː
इमारत	ɪmäːɾət̪
इमारती	ɪmäːɾət̪iː
इमोशन	ɪmoːʃə̃n̪
इम्तहान	ɪ̃mt̪əɦä̃ːn̪
इम्तिहान	ɪ̃mt̪ɪɦä̃ːn̪
इम्तेहान	ɪ̃mt̪eːɦä̃ːn̪
इराक़	ɪɾäːk
इराक़	ɪɾäːq
इरादतन	ɪɾäːd̪̚t̪ə̃n̪
इरादा	ɪɾäːd̪äː
इलज़ाम	ɪl̪d͡ʒä̃ːm
इलज़ाम	ɪl̪zä̃ːm
इलाक़ा	ɪl̪äːkäː
इलाक़ा	ɪl̪äːqäː
इलाज	ɪl̪äːd͡ʒ
इलायची	ɪl̪äːjt͡ʃiː
इलाहाबाद	ɪl̪äːɦäːbäːd̪
इलाही	ɪl̪äːɦiː
इलेक्ट्रॉन	ɪl̪eːkʈɾɔ̃n̪
इल्तिजा	ɪl̪t̪ɪd͡ʒäː
इल्मी	ɪl̪miː
इशारा	ɪʃäːɾäː
इश्तहार	ɪʃt̪əɦäːɾ
इश्तिहार	ɪʃt̪ɪɦäːɾ
इस	ɪs̪
इसका	ɪs̪käː
इसको	ɪs̪koː
इसबग़ोल	ɪs̪bəɡoːl̪
इसबग़ोल	ɪs̪bəɣoːl̪
इसबगोल	ɪs̪bəɡoːl̪
इसबगोल	ɪs̪bəɣoːl̪
इसमाईल	ɪs̪mäːiːl̪
इसमें	ɪs̪mẽː
इसराईली	ɪs̪ɾäːiːl̪iː
इसराज	ɪs̪ɾäːd͡ʒ
इसरार	ɪs̪ɾäːɾ
इसरो	ɪs̪ɾoː
इसलिए	ɪs̪l̪ɪeː
इससे	ɪs̪s̪eː
इसी	ɪs̪iː
इसीलिए	ɪs̪iːl̪ɪeː
इसे	ɪs̪eː
इस्टाम	ɪs̪ʈä̃ːm
इस्तक़बाल	ɪs̪t̪əkbäːl̪
इस्तक़बाल	ɪs̪t̪əqbäːl̪
इस्तांबुल	ɪs̪t̪ä̃ːmbʊl̪
इस्तीफ़ा	ɪs̪t̪iːfäː
इस्तीफ़ा	ɪs̪t̪iːpʰäː
इस्तेमाल	ɪs̪t̪eːmäːl̪
इस्पात	ɪs̪päːt̪
इस्म	ɪs̪m
इस्राइल	ɪs̪ɾäːɪl̪
इस्लाम	ɪs̪l̪ä̃ːm
इस्लामाबाद	ɪs̪l̪äːmäːbäːd̪
ई	iː
ईंधन	ĩːn̪d̪ʱə̃n̪
ईक्वाडोर	iːkwäːɖoːɾ
ईजियन	iːd͡ʒijə̃n̪
ईटानगर	iːʈäːn̪əɡəɾ
ईमान	iːmä̃ːn̪
ईमानदार	iːmä̃ːn̪d̪äːɾ
ईमेल	iːmeːl̪
ईराक	iːɾäːk
ईरान	iːɾä̃ːn̪
ईरानी	iːɾäːn̪iː
ईर्ष्या	iːɾʃjäː
ईसा	iːs̪äː
ईसाई	iːs̪äːiː
उँडेलना	ʊ̃ɳɖeːl̪n̪äː
उंगली	ʊ̃ŋɡl̪iː
उंचाई	ʊ̃n̪t͡ʃäːiː
उंडुक	ʊ̃ɳɖʊk
उंडुकपुच्छ	ʊ̃ɳɖʊkpʊt̚t͡ʃʰ
उंस	ʊ̃n̪s̪
उकसाना	ʊks̪äːn̪äː
उक़ाब	ʊkäːb
उक़ाब	ʊqäːb
उखड़ना	ʊkʰəɽn̪äː
उखाड़ना	ʊkʰäːɽn̪äː
उगना	ʊɡn̪äː
उगलना	ʊɡəl̪n̪äː
उचकना	ʊt͡ʃəkn̪äː
उचक्का	ʊt͡ʃək̚käː
उच्चायुक्त	ʊt̚t͡ʃäːjʊkt̪
उच्चायोग	ʊt̚t͡ʃäːjoːɡ
उच्चारण	ʊt̚t͡ʃäːɾə̃ɳ
उच्छेदन	ʊt̚t͡ʃʰeːd̪ə̃n̪
उच्छ्वास	ʊt̚t͡ʃʰʋäːs̪
उछलना	ʊt͡ʃʰəl̪n̪äː
उजड़ना	ʊd͡ʒəɽn̪äː
उजला	ʊd͡ʒl̪äː
उज़्बेकिस्तान	ʊd͡ʒbeːkɪs̪t̪ä̃ːn̪
उज़्बेकिस्तान	ʊzbeːkɪs̪t̪ä̃ːn̪
उजागर	ʊd͡ʒäːɡəɾ
उजाला	ʊd͡ʒäːl̪äː
उज्ज्वल	ʊd̚d͡ʒʋəl̪
उठना	ʊʈʰn̪äː
उड़ना	ʊɽn̪äː
उड़ान	ʊɽä̃ːn̪
उड़िया	ʊɽijäː
उड़ीसा	ʊɽiːs̪äː
उड्डयन	ʊɖ̚ɖəjə̃n̪
उढ़काना	ʊɽʱkäːn̪äː
उतरना	ʊt̪əɾn̪äː
उतरवाना	ʊt̪əɾʋäːn̪äː
उतारना	ʊt̪äːɾn̪äː
उतावला	ʊt̪äːʋl̪äː
उत्तम	ʊt̪̚t̪ə̃m
उत्तर	ʊt̪̚t̪əɾ
उत्तरकाशी	ʊt̪̚t̪əɾkäːʃiː
उत्तरदायित्व	ʊt̪̚t̪əɾd̪äːjɪt̪wᵊ
उत्तरदायी	ʊt̪̚t̪əɾd̪äːjiː
उत्तराखंड	ʊt̪̚t̪əɾäːkʰə̃ɳɖ
उत्तराधिकार	ʊt̪̚t̪əɾäːd̪ʱɪkäːɾ
उत्तराधिकारी	ʊt̪̚t̪əɾäːd̪ʱɪkäːɾiː
उत्तरार्द्ध	ʊt̪̚t̪əɾäːɾd̪d̪ʱ
उत्तरी	ʊt̪̚t̪əɾiː
उत्तेजना	ʊt̪̚t̪eːd͡ʒn̪äː
उत्तेजित	ʊt̪̚t̪eːd͡ʒɪt̪
उत्तोलक	ʊt̪̚t̪oːl̪ək
उत्तोलन	ʊt̪̚t̪oːl̪ə̃n̪
उत्पत्ति	ʊt̪pət̪̚t̪iː
उत्पन्न	ʊt̪pə̃n̪n̪
उत्पन्न	ʊt̪pə̃n̪n̪ᵊ
उत्पल	ʊt̪pəl̪
उत्पाद	ʊt̪päːd̪
उत्पादक	ʊt̪päːd̪ək
उत्पादको	ʊt̪päːd̪əkoː
उत्पादकों	ʊt̪päːd̪əkõː
उत्पादन	ʊt̪päːd̪ə̃n̪
उत्पीठिका	ʊt̪piːʈʰɪkäː
उत्पीड़न	ʊt̪piːɽə̃n̪
उत्सर्जन	ʊt̪s̪əɾd͡ʒə̃n̪
उत्साह	ʊt̪s̪äːɦ
उत्साहित	ʊt̪s̪äːɦɪt̪
उत्सुक	ʊt̪s̪ʊk
उत्सुकता	ʊt̪s̪ʊkt̪äː
उदजन	ʊd̪̚d͡ʒə̃n̪
उदजारेय	ʊd̪̚d͡ʒäːɾeːj
उदयकाल	ʊd̪əjkäːl̪
उदयवर्ष	ʊd̪əjʋəɾʃ
उदारता	ʊd̪äːɾt̪äː
उदारतावाद	ʊd̪äːɾt̪äːʋäːd̪
उदारवाद	ʊd̪äːɾʋäːd̪
उदास	ʊd̪äːs̪
उदासी	ʊd̪äːs̪iː
उदासीन	ʊd̪äːs̪ĩːn̪
उदाहरण	ʊd̪äːɦɾə̃ɳ
उदाहरण	ʊd̪ʱäːɾə̃ɳ
उद्घाटन	ʊd̪ɡʱäːʈə̃n̪
उद्देशिका	ʊd̪̚d̪eːʃɪkäː
उद्देश्य	ʊd̪̚d̪eːʃjᵊ
उद्यान	ʊd̪jä̃ːn̪
उद्योगीकरण	ʊd̪joːɡiːkəɾə̃ɳ
उधड़ना	ʊd̪ʱəɽn̪äː
उधार	ʊd̪ʱäːɾ
उधेड़ना	ʊd̪ʱeːɽn̪äː
उनका	ʊ̃n̪käː
उनको	ʊ̃n̪koː
उनचास	ʊ̃n̪t͡ʃäːs̪
उनतालीस	ʊ̃n̪t̪äːl̪iːs̪
उनतीस	ʊ̃n̪t̪iːs̪
उनसठ	ʊ̃n̪s̪əʈʰ
उनहत्तर	ʊ̃n̪ɦət̪̚t̪əɾ
उनासी	ʊn̪äːs̪iː
उनींदा	ʊn̪ĩːn̪d̪äː
उन्नत	ʊ̃n̪n̪ət̪
उन्नति	ʊ̃n̪n̪ət̪iː
उन्नाव	ʊ̃n̪n̪äːʋ
उन्नीस	ʊ̃n̪n̪iːs̪
उन्माद	ʊ̃n̪mäːd̪
उन्मुक्त	ʊ̃n̪mʊkt̪
उन्मूलन	ʊ̃n̪muːl̪ə̃n̪
उन्यासी	ʊ̃n̪jäːs̪iː
उन्हें	ʊ̃n̪ɦẽː
उन्होंने	ʊ̃n̪ɦõːn̪eː
उपकरण	ʊpkəɾə̃ɳ
उपकार	ʊpkäːɾ
उपचार	ʊpt͡ʃäːɾ
उपचुनाव	ʊpt͡ʃʊn̪äːʋ
उपजना	ʊpəd͡ʒn̪äː
उपजाऊ	ʊpd͡ʒäːuː
उपदान	ʊpd̪ä̃ːn̪
उपधान	ʊpd̪ʱä̃ːn̪
उपधारा	ʊpd̪ʱäːɾäː
उपनगर	ʊpn̪əɡəɾ
उपनाम	ʊpn̪ä̃ːm
उपनायिका	ʊpn̪äːjɪkäː
उपनिर्देशक	ʊpn̪ɪɾd̪eːʃək
उपनिषद्	ʊpn̪ɪʃəd̪
उपनेत्र	ʊpn̪eːt̪ɾᵊ
उपन्यास	ʊpə̃n̪jäːs̪
उपन्यासकार	ʊpə̃n̪jäːs̪käːɾ
उपपत्ति	ʊp̚pət̪̚t̪iː
उपबोली	ʊp̚boːl̪iː
उपभाषा	ʊpəbʱäːʃäː
उपभाषा	ʊp̚bʱäːʃäː
उपभोक्ता	ʊp̚bʱoːkt̪äː
उपभोग	ʊp̚bʱoːɡ
उपभोज्य	ʊp̚bʱoːd͡ʒjᵊ
उपयोगिता	ʊpjoːɡɪt̪äː
उपरांत	ʊpɾä̃ːn̪t̪
उपलब्ध	ʊpl̪əbd̪ʱ
उपलब्धि	ʊpl̪əbd̪ʱiː
उपला	ʊpl̪äː
उपवन	ʊpwə̃n̪
उपवास	ʊpwäːs̪
उपसचिव	ʊpəs̪t͡ʃɪʋ
उपसमुच्चय	ʊpəs̪mʊt̚t͡ʃəj
उपसर्ग	ʊps̪əɾɡ
उपस्थित	ʊpəs̪t̪ʰɪt̪
उपस्थिति	ʊpəs̪t̪ʰɪt̪iː
उपहार	ʊpʰäːɾ
उपाधि	ʊpäːd̪ʱiː
उपाध्याय	ʊpäːd̪ʱjäːj
उपाय	ʊpäːj
उपायुक्त	ʊpäːjʊkt̪
उपासक	ʊpäːs̪ək
उपेक्षा	ʊpeːkʃäː
उबरना	ʊbəɾn̪äː
उबाऊ	ʊbäːuː
उबालना	ʊbäːl̪n̪äː
उभरना	ʊbʱəɾn̪äː
उमंग	ʊmə̃ŋɡ
उमड़ना	ʊməɽn̪äː
उमरा	ʊ̃mɾäː
उमस	ʊməs̪
उमा	ʊmäː
उम्दा	ʊ̃md̪äː
उम्मीदवार	ʊ̃mmiːd̪wäːɾ
उम्मीद्वार	ʊ̃mmiːd̪wäːɾ
उम्रक़ैद	ʊ̃mɾəkɛːd̪
उम्रक़ैद	ʊ̃mɾəqɛːd̪
उरुमची	ʊɾʊ̃mt͡ʃiː
उरोस्थि	ʊɾoːs̪t̪ʰiː
उलझन	ʊl̪d͡ʒʱə̃n̪
उलझना	ʊl̪əd͡ʒʱn̪äː
उलझाना	ʊl̪d͡ʒʱäːn̪äː
उलटना	ʊl̪əʈn̪äː
उलटा	ʊl̪ʈäː
उलटी	ʊl̪ʈiː
उलफ़त	ʊl̪fət̪
उलफ़त	ʊl̪pʰət̪
उलहना	ʊl̪ɛɦn̪äː
उलाहना	ʊl̪äːɦn̪äː
उलीचना	ʊl̪iːt͡ʃn̪äː
उलूक	ʊl̪uːk
उल्का	ʊl̪käː
उल्टा	ʊl̪ʈäː
उल्टी	ʊl̪ʈiː
उल्लंघन	ʊl̪l̪ə̃ŋɡʱə̃n̪
उल्लू	ʊl̪l̪uː
उल्लेख	ʊl̪l̪eːkʰ
उल्लेखनीय	ʊl̪l̪eːkʰn̪iːjᵊ
उषा	ʊʃäː
उस	ʊs̪
उसका	ʊs̪käː
उसको	ʊs̪koː
उसमान	ʊs̪mä̃ːn̪
उससे	ʊs̪s̪eː
उसाँस	ʊs̪ä̃ːs̪
उसांस	ʊs̪ä̃ːs̪
उसी	ʊs̪iː
उसूल	ʊs̪uːl̪
उसे	ʊs̪eː
उस्ताद	ʊs̪t̪äːd̪
उस्मानाबाद	ʊs̪mäːn̪äːbäːd̪
उस्मानी	ʊs̪mäːn̪iː
ऊँचा	ũːt͡ʃäː
ऊँचाई	ũːt͡ʃäːiː
ऊंचा	ũːt͡ʃäː
ऊंचाई	ũːt͡ʃäːiː
ऊटपटांग	uːʈəpʈä̃ːŋɡ
ऊदबिलाव	uːd̪bɪl̪äːʋ
ऊन	ũːn̪
ऊना	uːn̪äː
ऊनी	uːn̪iː
ऊपरवाला	uːpəɾʋäːl̪äː
ऊफ़ा	uːfäː
ऊफ़ा	uːpʰäː
ऊबना	uːbn̪äː
ऊर्जा	uːɾd͡ʒäː
ऊर्णा	uːɾɳäː
ऊर्ध्ववायु	uːɾd̪ʱʋəʋäːjuː
ऊर्ध्वाधर	uːɾd̪ʱʋäːd̪ʱəɾ
ऊष्मा	uːʃmäː
ऊष्मीकरण	uːʃmiːkəɾə̃ɳ
ऊसर	uːs̪əɾ
ऋण	ɾɪ̃ɳ
ऋणदाता	ɾɪ̃ɳd̪äːt̪äː
ऋणदाताओ	ɾɪ̃ɳd̪äːt̪äːoː
ऋणदाताओं	ɾɪ̃ɳd̪äːt̪äːõː
ऋणमुक्त	ɾɪ̃ɳmʊkt̪
ऋणाग्र	ɾɪɳäːɡɾᵊ
ऋणायन	ɾɪɳäːjə̃n̪
ऋषि	ɾɪʃiː
ऋषिकेश	ɾɪʃɪkeːʃ
एंड्रॉइड	ẽːɳɖɾɔɪɖ
एकघातीय	eːkɡʱäːt̪iːjᵊ
एकजुटता	eːkd͡ʒʊʈt̪äː
एकतरफ़ा	eːkt̪əɾfäː
एकतरफ़ा	eːkt̪əɾpʰäː
एकता	eːkt̪äː
एकदम	eːkd̪ə̃m
एकरूपता	eːkɾuːpt̪äː
एकल	eːkəl̪
एकवचन	eːkwət͡ʃə̃n̪
एकवर्णीय	eːkwəɾɳiːjᵊ
एकसदनीय	eːks̪əd̪ən̪iːjᵊ
एकसदनीयता	eːks̪əd̪ən̪iːjt̪äː
एकसमान	eːks̪əmä̃ːn̪
एकांत	eːkä̃ːn̪t̪
एकाएक	eːkäːeːk
एकाध	eːkäːd̪ʱ
एकाधिकार	eːkäːd̪ʱɪkäːɾ
एकीकरण	eːkiːkəɾə̃ɳ
एजेंट	eːd͡ʒẽːɳʈ
एजेंसी	eːd͡ʒẽːn̪s̪iː
एटीएम	eːʈiːẽːm
एडवायज़री	eːɖwäːjd͡ʒəɾiː
एडवायज़री	eːɖwäːjzəɾiː
एडिलेड	eːɖɪl̪eːɖ
एड्स	eːɖs̪
एतबार	eːt̪bäːɾ
एतराज़	eːt̪ɾäːd͡ʒ
एतराज़	eːt̪ɾäːz
एमएलए	ẽːm‿eːl̪‿eː
एयरलाइन	eːjəɾl̪äːɪ̃n̪
एलची	eːl̪t͡ʃiː
एलान	eːl̪ä̃ːn̪
एल्युमिनियम	eːl̪jʊmɪn̪ijə̃m
एवं	eːʋə̃m
एशिया	eːʃijäː
एसोसिएशन	eːs̪oːs̪ɪeːʃə̃n̪
एस्केलेटर	eːs̪keːl̪eːʈəɾ
एस्टोनिया	eːs̪ʈoːn̪ijäː
एस्पेरांतो	eːs̪peːɾä̃ːn̪t̪oː
एस्पेरान्तो	eːs̪peːɾä̃ːn̪t̪oː
एहतजाज	eːɦt̪əd͡ʒäːd͡ʒ
एहतियात	eːɦt̪ijäːt̪
एहसान	ɛɦs̪ä̃ːn̪
एहसानमंद	eːɦs̪ä̃ːn̪mə̃n̪d̪
एहसास	eːɦs̪äːs̪
ऐच्छिक	ɛːt̚t͡ʃʰɪk
ऐतराज़	ɛːt̪ɾäːd͡ʒ
ऐतराज़	ɛːt̪ɾäːz
ऐतिहासिक	ɛːt̪ɪɦäːs̪ɪk
ऐनक	ɛːn̪ək
ऐनिमे	ɛːn̪ɪmeː
ऐयाशी	ə̯ijäːʃiː
ऐरन	ɛːɾə̃n̪
ऐसा	ɛːs̪äː
ऐसी	ɛːs̪iː
ऐसे	ɛːs̪eː
ऐहतियातन	ɛːɦt̪ijäːt̪ə̃n̪
ऑकलैंड	ɔkl̪ɛ̃ːɳɖ
ऑक्सफ़ोर्ड	ɔks̪foːɾɖ
ऑक्सफ़ोर्ड	ɔks̪pʰoːɾɖ
ऑफ़िस	ɔfɪs̪
ऑफ़िस	ɔpʰɪs̪
ऑर्थोडॉक्सी	ɔɾt̪ʰoːɖɔks̪iː
ऑस्ट्रिया	ɔs̪ʈɾijäː
ऑस्ट्रेलिया	ɔs̪ʈɾeːl̪ijäː
ओकाई	oːkäːiː
ओखली	oːkʰl̪iː
ओगाज़्म	oːɡäːd͡ʒm
ओगाज़्म	oːɡäːzm
ओछा	oːt͡ʃʰäː
ओझल	oːd͡ʒʱəl̪
ओझा	oːd͡ʒʱäː
ओटावा	oːʈäːʋäː
ओडिशा	oːɖɪʃäː
ओढ़ना	oːɽʱn̪äː
ओणम	oːɳə̃m
ओमान	oːmä̃ːn̪
ओलंदेज़	oːl̪ə̃n̪d̪eːd͡ʒ
ओलंदेज़	oːl̪ə̃n̪d̪eːz
ओलंपिक	oːl̪ə̃mpɪk
ओला	oːl̪äː
ओलिंपियाड	oːl̪ɪ̃mpijäːɖ
ओशिआनिया	oːʃijäːn̪ijäː
ओष्ठ्य	oːʃʈʰjə
ओसाका	oːs̪äːkäː
ओहायो	oːɦäːjoː
औक़ात	ɔːkäːt̪
औक़ात	ɔːqäːt̪
औज़ार	ɔːd͡ʒäːɾ
औज़ार	ɔːzäːɾ
औजार	ɔːd͡ʒäːɾ
औजार	ɔːzäːɾ
औत्सुक्य	ɔːt̪s̪ʊkjᵊ
औद्योगीकरण	ɔːd̪joːɡiːkəɾə̃ɳ
औपचारिक	ɔːpt͡ʃäːɾɪk
औपस्थ्य	ɔːpəs̪t̪ʰjᵊ
औरंगाबाद	ɔːɾə̃ŋɡäːbäːd̪
औलाद	ɔːl̪äːd̪
औलिया	ɔːl̪ijäː
औषध	ɔːʃəd̪ʱ
औषधि	ɔːʃd̪ʱiː
औषधी	ɔːʃd̪ʱiː
औषधीय	ɔːʃd̪ʱiːjᵊ
औसत	ɔːs̪ət̪
औसतन	ɔːs̪t̪ə̃n̪
कँगनी	kə̃ŋɡn̪iː
कंकड़	kə̃ŋkəɽ
कंकड़ीला	kə̃ŋkɽiːl̪äː
कंकाल	kə̃ŋkäːl̪
कंक्रीट	kə̃ŋkɾiːʈ
कंगन	kə̃ŋɡə̃n̪
कंगारू	kə̃ŋɡäːɾuː
कंगाल	kə̃ŋɡäːl̪
कंजूस	kə̃n̪d͡ʒuːs̪
कंठ	kə̃ɳʈʰ
कंठमाला	kə̃ɳʈʰmäːl̪äː
कंठ्य	kə̃ɳʈʰjə
कंडकटर	kə̃ɳɖəkʈəɾ
कंडीशनर	kə̃ɳɖiːʃn̪əɾ
कंद	kə̃n̪d̪
कंदरा	kə̃n̪d̪əɾäː
कंदुक	kə̃n̪d̪ʊk
कंधा	kə̃n̪d̪ʱäː
कंप	kə̃mp
कंपन	kə̃mpə̃n̪
कंपनी	kə̃mpn̪iː
कंपनी	kə̃mpən̪iː
कंपित	kə̃mpɪt̪
कंपू	kə̃mpuː
कंप्यूटर	kə̃mpjuːʈəɾ
कंप्यूटरीकरण	kə̃mpjuːʈɾiːkəɾə̃ɳ
कंबल	kə̃mbəl̪
कंबोडिया	kə̃mboːɖijäː
कक्ष	kəkʃ
कक्षा	kəkʃäː
कगार	kəɡäːɾ
कचनार	kət͡ʃn̪äːɾ
कचरा	kət͡ʃɾäː
कचहरी	kət͡ʃɛɦɾiː
कचालू	kət͡ʃäːl̪uː
कच्चा	kət̚t͡ʃäː
कच्छ	kət̚t͡ʃʰ
कच्छा	kət̚t͡ʃʰäː
कछारी	kət͡ʃʰäːɾiː
कछुआ	kət͡ʃʰʊäː
कजरारा	kəd͡ʒɾäːɾäː
कज़ाख़स्तान	kəd͡ʒäːkʰəs̪t̪ä̃ːn̪
कज़ाख़स्तान	kəzäːxəs̪t̪ä̃ːn̪
कटना	kəʈn̪äː
कटहल	kəʈʰəl̪
कटाई	kəʈäːiː
कटाक्ष	kəʈäːkʃ
कटार	kəʈäːɾ
कटोरा	kəʈoːɾäː
कट्टर	kəʈ̚ʈəɾ
कट्ठा	kəʈ̚ʈʰäː
कठघरा	kəʈʰɡʱəɾäː
कठमुल्ला	kəʈʰmʊl̪l̪äː
कठिन	kəʈʰɪ̃n̪
कठिनता	kəʈʰɪ̃n̪t̪äː
कठिनाई	kəʈʰɪn̪äːiː
कठुआ	kəʈʰʊäː
कडपा	kəɖpäː
कड़कड़ाना	kəɽkəɽäːn̪äː
कड़वा	kəɽʋäː
कड़वापन	kəɽʋäːpə̃n̪
कड़वाहट	kəɽʋäːɦəʈ
कड़ा	kəɽäː
कढ़ाई	kəɽʱäːiː
कतराना	kət̪ɾäːn̪äː
कतल	kət̪əl̪
कतल	qət̪əl̪
कतार	kət̪äːɾ
कतार	qət̪äːɾ
कत्ल	kət̪l̪
कत्ल	qət̪l̪
कथन	kət̪ʰə̃n̪
कथा	kət̪ʰäː
कदन	kəd̪ə̃n̪
कदाचित्	kəd̪äːt͡ʃɪt̪
कदापि	kəd̪äːpiː
कद्दू	kəd̪̚d̪uː
कनटोप	kə̃n̪ʈoːp
कनपटी	kə̃n̪pəʈiː
कनपेड़	kə̃n̪peːɽ
कनाडा	kən̪äːɖäː
कनिया	kən̪ijäː
कनिष्ठ	kən̪ɪʂʈʰ
कनिष्ठा	kən̪ɪʃʈʰäː
कनीज़	kən̪iːd͡ʒ
कनीज़	kən̪iːz
कन्द	kə̃n̪d̪
कन्दरा	kə̃n̪d̪əɾäː
कन्दुक	kə̃n̪d̪ʊk
कन्नड	kə̃n̪n̪əɖ
कन्नड	kə̃n̪n̪əɖᵊ
कन्नड़	kə̃n̪n̪əɽ
कन्नड़	kə̃n̪n̪əɽᵊ
कन्नौज	kə̃n̪n̪ɔːd͡ʒ
कन्या	kə̃n̪jäː
कन्हैया	kə̃n̪ɦə̯ijäː
कपड़ा	kəpɽäː
कपाल	kəpäːl̪
कपास	kəpäːs̪
कपिलवस्तु	kəpɪl̪ʋəs̪t̪uː
कप्तान	kəpt̪ä̃ːn̪
कफ़न	kəfə̃n̪
कफ़न	kəpʰə̃n̪
कबड्डी	kəbəɖ̚ɖiː
कबाड़	kəbäːɽ
कबाब	kəbäːb
कबूल	kəbuːl̪
कबूल	qəbuːl̪
कम	kə̃m
कमज़ोर	kə̃md͡ʒoːɾ
कमज़ोर	kə̃mzoːɾ
कमबख़्त	kə̃mbəkʰt̪
कमबख़्त	kə̃mbəxt̪
कमरबंद	kəməɾbə̃n̪d̪
कमरबन्द	kəməɾbə̃n̪d̪
कमरा	kə̃mɾäː
कमर्शियल	kəməɾʃijəl̪
कमल	kəməl̪
कमली	kə̃ml̪iː
कमाई	kəmäːiː
कमाऊ	kəmäːuː
कमान	kəmä̃ːn̪
कमाल	kəmäːl̪
कमिश्नर	kəmɪʃn̪əɾ
कमीना	kəmiːn̪äː
कमीनापन	kəmiːn̪äːpə̃n̪
कमीशन	kəmiːʃə̃n̪
कमेंट	kəmẽːɳʈ
कमेरा	kəmeːɾäː
कम्प	kə̃mp
कम्पन	kə̃mpə̃n̪
कम्पित	kə̃mpɪt̪
कम्बल	kə̃mbəl̪
कम्बोडिया	kə̃mboːɖijäː
कम्युनिजम	kə̃mjʊn̪ɪd͡ʒə̃m
कम्युनिजम	kə̃mjʊn̪ɪzə̃m
कम्युनिज़म	kə̃mjʊn̪ɪd͡ʒm
कम्युनिज़म	kə̃mjʊn̪ɪd͡ʒə̃m
कम्युनिज़म	kə̃mjʊn̪ɪzm
कम्युनिज़म	kə̃mjʊn̪ɪzə̃m
कम्युनिज़्म	kə̃mjʊn̪ɪd͡ʒmᵊ
कम्युनिज़्म	kə̃mjʊn̪ɪzmᵊ
कम्युनिज्म	kə̃mjʊn̪ɪd͡ʒmᵊ
कम्युनिज्म	kə̃mjʊn̪ɪzmᵊ
कयामत	kəjäːmət̪
कयामत	qəjäːmət̪
करघा	kəɾɡʱäː
करण	kəɾə̃ɳ
करता	kəɾt̪äː
करना	kəɾn̪äː
करनाल	kəɾn̪äːl̪
करनी	kəɾn̪iː
करनेवाला	kəɾn̪eːʋäːl̪äː
कराची	kəɾäːt͡ʃiː
करारा	kəɾäːɾäː
करिश्मा	kəɾɪʃmäː
करूंगा	kəɾũːŋɡäː
करेला	kəɾeːl̪äː
करौंदा	kəɾɔ̃ːn̪d̪äː
कर्ता	kəɾt̪äː
कर्तृत्व	kəɾt̪ɾɪt̪wᵊ
कर्नाटक	kəɾn̪äːʈək
कर्मचारी	kəɾmət͡ʃäːɾiː
कर्मशाला	kəɾməʃäːl̪äː
कल	kəl̪
कलंक	kəl̪ə̃ŋk
कलकत्ता	kəl̪kət̪̚t̪äː
कलक्टर	kəl̪əkʈəɾ
कलन	kəl̪ə̃n̪
कलम	kəl̪ə̃m
कलमकारी	kəl̪ə̃mkäːɾiː
कलमा	kəl̪mäː
कलसा	kəl̪s̪äː
कलह	kəl̪əɦ
कला	kəl̪äː
कलाई	kəl̪äːiː
कलाकार	kəl̪äːkäːɾ
कलात्मक	kəl̪äːt̪mək
कलावंत	kəl̪äːʋə̃n̪t̪
कली	kəl̪iː
कलीसिया	kəl̪iːs̪ijäː
कलेजा	kəl̪eːd͡ʒäː
कलेवा	kəl̪eːʋäː
कलोर	kəl̪oːɾ
कल्टी	kəl̪ʈiː
कल्पना	kəl̪pən̪äː
कल्पनादर्श	kəl̪pən̪äːd̪əɾʃ
कल्पित	kəl̪pɪt̪
कविता	kəʋɪt̪äː
कशमकश	kəʃə̃mkəʃ
कष्टसाध्य	kəʂʈs̪äːd̪ʱjᵊ
कसके	kəs̪keː
कसम	kəs̪ə̃m
कसम	qəs̪ə̃m
कसर	kəs̪əɾ
कसरत	kəs̪ɾət̪
कसाई	kəs̪äːiː
कसाई	qəs̪äːiː
कसूर	kəs̪uːɾ
कसूर	qəs̪uːɾ
कसेरा	kəs̪eːɾäː
कसौटी	kəs̪ɔːʈiː
कहना	kɛɦn̪äː
कहनी	kɛɦn̪iː
कहर	kɛɦɛɾ
कहर	qɛɦɛɾ
कहलाना	kɛɦl̪äːn̪äː
कहवा	kɛɦʋäː
कहवा	qɛɦʋäː
कहा	kəɦäː
कहाँ	kəɦä̃ː
कहानी	kəɦäːn̪iː
कहानीकार	kəɦäːn̪iːkäːɾ
कहावत	kəɦäːʋət̪
क़तरा	kət̪ɾäː
क़तरा	qət̪ɾäː
क़त्ल	kət̪l̪
क़त्ल	qət̪l̪
क़त्लेआम	kət̪l̪eːä̃ːm
क़त्लेआम	qət̪l̪eːä̃ːm
क़दम	kəd̪ə̃m
क़दम	qəd̪ə̃m
क़दमताल	kəd̪ə̃mt̪äːl̪
क़दमताल	qəd̪ə̃mt̪äːl̪
क़दीम	kəd̪ĩːm
क़दीम	qəd̪ĩːm
क़द्दावर	kəd̪̚d̪äːʋəɾ
क़द्दावर	qəd̪̚d̪äːʋəɾ
क़द्रदान	kəd̪ɾəd̪ä̃ːn̪
क़द्रदान	qəd̪ɾəd̪ä̃ːn̪
क़फ़स	kəpʰəs̪
क़फ़स	qəfəs̪
क़बीला	kəbiːl̪äː
क़बीला	qəbiːl̪äː
क़बूल	kəbuːl̪
क़बूल	qəbuːl̪
क़ब्ज़ा	kəbd͡ʒäː
क़ब्ज़ा	qəbzäː
क़ब्रिस्तान	kəbɾɪs̪t̪ä̃ːn̪
क़ब्रिस्तान	qəbɾɪs̪t̪ä̃ːn̪
क़रार	kəɾäːɾ
क़रार	qəɾäːɾ
क़रीबन	kəɾiːbə̃n̪
क़रीबन	qəɾiːbə̃n̪
क़लम	kəl̪ə̃m
क़लम	qəl̪ə̃m
क़व्वाल	kəʋʋäːl̪
क़व्वाल	qəʋʋäːl̪
क़व्वाली	kəʋʋäːl̪iː
क़व्वाली	qəʋʋäːl̪iː
क़सम	kəs̪ə̃m
क़सम	qəs̪ə̃m
क़साई	kəs̪äːiː
क़साई	qəs̪äːiː
क़सीदा	kəs̪iːd̪äː
क़सीदा	qəs̪iːd̪äː
क़सूर	kəs̪uːɾ
क़सूर	qəs̪uːɾ
क़स्बा	kəs̪bäː
क़स्बा	qəs̪bäː
क़हर	kɛɦɛɾ
क़हर	qɛɦɛɾ
क़हवा	kɛɦʋäː
क़हवा	qɛɦʋäː
क़ाज़ी	käːd͡ʒiː
क़ाज़ी	qäːziː
क़ातिल	käːt̪ɪl̪
क़ातिल	qäːt̪ɪl̪
क़ातिलाना	käːt̪ɪl̪äːn̪äː
क़ातिलाना	qäːt̪ɪl̪äːn̪äː
क़ानून	käːn̪ũːn̪
क़ानून	qäːn̪ũːn̪
क़ानूनगो	käːn̪ũːn̪ɡoː
क़ानूनगो	qäːn̪ũːn̪ɡoː
क़ाफ़िला	käːpʰɪl̪äː
क़ाफ़िला	qäːfɪl̪äː
क़ाबिज़	käːbɪd͡ʒ
क़ाबिज़	qäːbɪz
क़ाबिल	käːbɪl̪
क़ाबिल	qäːbɪl̪
क़ाबिलीयत	käːbɪl̪iːjət̪
क़ाबिलीयत	qäːbɪl̪iːjət̪
क़ायदा	käːjd̪äː
क़ायदा	qäːjd̪äː
क़ायम	käːjə̃m
क़ायम	qäːjə̃m
क़ालीन	käːl̪ĩːn̪
क़ालीन	qäːl̪ĩːn̪
क़ासिद	käːs̪ɪd̪
क़ासिद	qäːs̪ɪd̪
क़ाहिरा	käːɦɪɾäː
क़ाहिरा	qäːɦɪɾäː
क़िला	kɪl̪äː
क़िला	qɪl̪äː
क़िल्लत	kɪl̪l̪ət̪
क़िल्लत	qɪl̪l̪ət̪
क़िस्त	kɪs̪t̪
क़िस्त	qɪs̪t̪
क़िस्म	kɪs̪m
क़िस्म	qɪs̪m
क़िस्मत	kɪs̪mət̪
क़िस्मत	qɪs̪mət̪
क़िस्सा	kɪs̪s̪äː
क़िस्सा	qɪs̪s̪äː
क़ुरान	kʊɾä̃ːn̪
क़ुरान	qʊɾä̃ːn̪
क़ुल्फ़ी	kʊl̪pʰiː
क़ुल्फ़ी	qʊl̪fiː
क़ैंची	kɛ̃ːn̪t͡ʃiː
क़ैंची	qɛ̃ːn̪t͡ʃiː
क़ैदख़ाना	kɛːd̪kʰäːn̪äː
क़ैदख़ाना	qɛːd̪xäːn̪äː
क़ौम	kɔ̃ːm
क़ौम	qɔ̃ːm
का	käː
काँख	kä̃ːkʰ
काँच	kä̃ːt͡ʃ
काँटा	kä̃ːʈäː
काँपना	kä̃ːpn̪äː
काँव	kä̃ːʋ
काँस	kä̃ːs̪
काँसा	kä̃ːs̪äː
कांग्रेस	kä̃ːŋɡɾeːs̪
कांग्रेसी	kä̃ːŋɡɾeːs̪iː
कांटा	kä̃ːʈäː
कांति	kä̃ːn̪t̪iː
कांदा	kä̃ːn̪d̪äː
कांसा	kä̃ːn̪s̪äː
कांसी	kä̃ːn̪s̪iː
काका	käːkäː
काकी	käːkiː
कागज	käːɡəd͡ʒ
कागज	käːɣəz
कागज़	käːɡəd͡ʒ
कागज़	käːɣəz
कागद	käːɡəd̪
काग़ज	käːɡəd͡ʒ
काग़ज	käːɣəz
काग़ज़	käːɡəd͡ʒ
काग़ज़	käːɣəz
काग़ज़ात	käːɡd͡ʒäːt̪
काग़ज़ात	käːɣzäːt̪
काज	käːd͡ʒ
काजल	käːd͡ʒəl̪
काजू	käːd͡ʒuː
काटना	käːʈn̪äː
काठ	käːʈʰ
काठमांडू	käːʈʰmä̃ːɳɖuː
काढ़ना	käːɽʱn̪äː
कान	kä̃ːn̪
कानपुर	kä̃ːn̪pʊɾ
काना	käːn̪äː
कानून	käːn̪ũːn̪
कानून	qäːn̪ũːn̪
कान्ति	kä̃ːn̪t̪iː
कान्हा	kä̃ːn̪ɦäː
कापी	käːpiː
कापीराइट	käːpiːɾäːɪʈ
काफल	käːpʰəl̪
काफ़ी	käːfiː
काफ़ी	käːpʰiː
काफी	käːfiː
काफी	käːpʰiː
काबीना	käːbiːn̪äː
काबुकी	käːbʊkiː
काबुल	käːbʊl̪
काम	kä̃ːm
कामकाज	kä̃ːmkäːd͡ʒ
कामक्रिया	käːməkɾijäː
कामगार	kä̃ːmɡäːɾ
कामचोर	kä̃ːmt͡ʃoːɾ
कामना	kä̃ːmn̪äː
कामयाब	kä̃ːmjäːb
कामवाली	kä̃ːmwäːl̪iː
कामिल	käːmɪl̪
कामी	käːmiː
कामुक	käːmʊk
कामुकता	käːmʊkt̪äː
कामोन्माद	käːmõːn̪mäːd̪
कायको	käːjkoː
कायनात	käːjn̪äːt̪
कायर	käːjəɾ
कायांतरण	käːjä̃ːn̪t̪əɾə̃ɳ
कायान्तरण	käːjä̃ːn̪t̪əɾə̃ɳ
कायोत्सर्ग	käːjoːt̪s̪əɾɡ
कार	käːɾ
कारक	käːɾək
कारख़ाना	käːɾkʰäːn̪äː
कारख़ाना	käːɾxäːn̪äː
कारखाना	käːɾkʰäːn̪äː
कारखाना	käːɾxäːn̪äː
कारगर	käːɾɡəɾ
कारण	käːɾə̃ɳ
कारतूस	käːɾt̪uːs̪
कारनामा	käːɾn̪äːmäː
कारबार	käːɾbäːɾ
कारवाँ	käːɾʋä̃ː
कारा	käːɾäː
कारावास	käːɾäːʋäːs̪
कारोबारी	käːɾoːbäːɾiː
कार्गो	käːɾɡoː
कार्टून	käːɾʈũːn̪
कार्ड	käːɾɖ
कार्डिफ़	käːɾɖɪf
कार्डिफ़	käːɾɖɪpʰ
कार्तिक	käːɾt̪ɪk
कार्त्तिक	käːɾt̪ɪk
कार्थेज	käːɾt̪ʰeːd͡ʒ
कार्य	käːɾjᵊ
कार्यकर्ता	käːɾjəkəɾt̪äː
कार्यकाल	käːɾjəkäːl̪
कार्यकुशल	käːɾjəkʊʃəl̪
कार्यक्रम	käːɾjəkɾə̃m
कार्यभार	käːɾjəbʱäːɾ
कार्यशाला	käːɾjəʃäːl̪äː
कार्यसमिति	käːɾjəs̪əmɪt̪iː
कार्यसूची	käːɾjəs̪uːt͡ʃiː
कार्यान्वित	käːɾjä̃ːn̪wɪt̪
कार्यालय	käːɾjäːl̪əj
कार्रवाई	käːɾɾəʋäːiː
काल	käːl̪
कालक्रम	käːl̪kɾə̃m
कालजयी	käːl̪d͡ʒəjiː
कालद्वीप	käːl̪əd̪wiːp
काला	käːl̪äː
कालाधन	käːl̪äːd̪ʱə̃n̪
कालापन	käːl̪äːpə̃n̪
कालिज	käːl̪ɪd͡ʒ
काली	käːl̪iː
कालीन	käːl̪ĩːn̪
कालू	käːl̪uː
कालेज	käːl̪eːd͡ʒ
काल्पनिक	käːl̪pən̪ɪk
काव्य	käːʋjᵊ
काष्ठशर्करा	käːʂʈʰʃəɾkəɾäː
कासा	käːs̪äː
किंतु	kɪ̃n̪t̪uː
किंवदंती	kɪ̃mwd̪ə̃n̪t̪iː
किचन	kɪt͡ʃə̃n̪
कितना	kɪt̪̚n̪äː
कितने	kɪt̪̚n̪eː
किताब	kɪt̪äːb
किन	kɪ̃n̪
किनारा	kɪn̪äːɾäː
किन्नर	kɪ̃n̪n̪əɾ
किफ़ायत	kɪfäːjət̪
किफ़ायत	kɪpʰäːjət̪
किफ़ायती	kɪfäːjət̪iː
किफ़ायती	kɪpʰäːjət̪iː
किया	kijäː
किरकिला	kɪɾkɪl̪äː
किरण	kɪɾə̃ɳ
किरणपुंज	kɪɾə̃ɳpʊ̃n̪d͡ʒ
किरदार	kɪɾd̪äːɾ
किराँची	kɪɾä̃ːt͡ʃiː
किराया	kɪɾäːjäː
किरायेदार	kɪɾäːjeːd̪äːɾ
किरासन	kɪɾäːs̪ə̃n̪
किर्गिज़स्तान	kɪɾɡɪd͡ʒəs̪t̪ä̃ːn̪
किर्गिज़स्तान	kɪɾɡɪzəs̪t̪ä̃ːn̪
किला	kɪl̪äː
किला	qɪl̪äː
किलो	kɪl̪oː
किलोग्राम	kɪl̪oːɡɾä̃ːm
किलोमीटर	kɪl̪oːmiːʈəɾ
किशोरा	kɪʃoːɾäː
किसान	kɪs̪ä̃ːn̪
किसानी	kɪs̪äːn̪iː
किस्म	kɪs̪m
किस्म	qɪs̪m
कीटाणु	kiːʈäːɳuː
कीड़ा	kiːɽaː
कीमिया	kiːmijäː
कीर्तन	kiːɾt̪ə̃n̪
कील	kiːl̪
कुँआ	kʊ̃äː
कुँआरी	kʊ̃äːɾiː
कुंजड़ा	kʊ̃n̪d͡ʒɽäː
कुंजी	kʊ̃n̪d͡ʒiː
कुंजीपटल	kʊ̃n̪d͡ʒiːpəʈəl̪
कुंडली	kʊ̃ɳɖl̪iː
कुंडली	kʊ̃ɳɖəl̪iː
कुंद	kʊ̃n̪d̪
कुआँ	kʊä̃ː
कुकुरमुत्ता	kʊkʊɾmʊt̪̚t̪äː
कुख्यात	kʊkʰjäːt̪
कुख्याति	kʊkʰjäːt̪iː
कुचलना	kʊt͡ʃəl̪n̪äː
कुटिया	kʊʈijäː
कुटिल	kʊʈɪl̪
कुटुंब	kʊʈʊ̃mb
कुट्टार	kʊʈ̚ʈäːɾ
कुतरना	kʊt̪əɾn̪äː
कुत्ता	kʊt̪̚t̪äː
कुत्ती	kʊt̪̚t̪iː
कुत्रापि	kʊt̪ɾäːpiː
कुदाल	kʊd̪äːl̪
कुनबा	kʊ̃n̪bäː
कुप्पी	kʊp̚piː
कुमाऊँ	kʊmäːũː
कुमारी	kʊmäːɾiː
कुमुदिनी	kʊmʊd̪ɪn̪iː
कुम्हड़ा	kʊ̃mɦəɽäː
कुम्हलाना	kʊ̃mɦl̪äːn̪äː
कुरता	kʊɾt̪äː
कुरूपता	kʊɾuːpt̪äː
कुर्नूल	kʊɾn̪uːl̪
कुल	kʊl̪
कुलक	kʊl̪ək
कुलधर्म	kʊl̪d̪ʱəɾm
कुल्चा	kʊl̪t͡ʃäː
कुल्ला	kʊl̪l̪äː
कुल्हड़	kʊl̪ɦəɽ
कुशल	kʊʃəl̪
कुशासन	kʊʃäːs̪ə̃n̪
कुसल	kʊs̪əl̪
कुसुम	kʊs̪ʊ̃m
कुसूर	kʊs̪uːɾ
कुसूर	qʊs̪uːɾ
कुहनी	kɔɦn̪iː
कुहरा	kɔɦɾäː
कूटनीति	kuːʈn̪iːt̪iː
कूटनीतिक	kuːʈn̪iːt̪ɪk
कूटनीतिज्ञ	kuːʈn̪iːt̪ɪɡj
कूड़ा	kuːɽäː
कूड़ेदान	kuːɽeːd̪ä̃ːn̪
कूदना	kuːd̪̚n̪äː
कूलॉम	kuːl̪ɔ̃m
कूल्हा	kuːl̪ɦäː
कृतित्व	kɾɪt̪ɪt̪wᵊ
कृत्रिम	kɾɪt̪ɾɪ̃m
कृदंत	kɾɪd̪ə̃n̪t̪
कृदन्त	kɾɪd̪ə̃n̪t̪
कृपया	kɾɪpjäː
कृष्ण	kɾɪʃə̃ɳ
कृष्ण	kɾɪʃɳ
कृष्ण	kɾɪʃɳäː
कृष्णा	kɾɪʃɳäː
कॅटलोनिया	kæʈl̪oːn̪ijäː
कॅन्सर	kæ̃n̪s̪əɾ
केंद्र	kẽːn̪d̪ɾᵊ
केंद्रक	kẽːn̪d̪ɾək
केंद्रित	kẽːn̪d̪ɾɪt̪
केंद्रीकरण	kẽːn̪d̪ɾiːkəɾə̃ɳ
केकड़ा	keːkɽaː
केतली	keːt̪l̪iː
केन्द्र	kẽːn̪d̪ɾᵊ
केन्या	kẽːn̪jäː
केपटाउन	keːpʈäːʊ̃n̪
केरल	keːɾəl̪
केरल	keːɾəl̪ᵊ
केला	keːl̪äː
केलि	keːl̪iː
कैंची	kɛ̃ːn̪t͡ʃiː
कैंची	qɛ̃ːn̪t͡ʃiː
कैंटीन	kɛ̃ːɳʈĩːn̪
कैंडी	kɛ̃ːɳɖiː
कैंब्रिज	kɛ̃ːmbɾɪd͡ʒ
कैंसर	kæ̃n̪s̪əɾ
कैथल	kɛːt̪ʰəl̪
कैनबरा	kɛːn̪əbɾäː
कैमरा	kɛ̃ːmɾäː
कैरम	kɛːɾə̃m
कैलकुलेटर	kɛːl̪kʊl̪eːʈəɾ
कैलगरी	kɛːl̪ɡəɾiː
कैलिफ़ोर्निया	kɛːl̪ɪfoːɾn̪ijäː
कैलिफ़ोर्निया	kɛːl̪ɪpʰoːɾn̪ijäː
कैसा	kɛːs̪äː
कॉपीराइट	kɔpiːɾäːɪʈ
कॉमनवेल्थ	kɔmə̃n̪weːl̪t̪ʰ
कॉमेडियन	kɔmeːɖijə̃n̪
कोंकण	kõːŋkə̃ɳ
कोंकणी	kõːŋkɳiː
कोंपल	kõːmpəl̪
कोटवाल	koːʈwäːl̪
कोटा	koːʈäː
कोठा	koːʈʰäː
कोठारी	koːʈʰäːɾiː
कोड़ा	koːɽäː
कोण	kõːɳ
कोतवाल	koːt̪wäːl̪
कोपचा	koːpt͡ʃäː
कोमोरोस	koːmoːɾoːs̪
कोयंबतूर	koːjə̃mbət̪uːɾ
कोयल	koːjəl̪
कोयला	koːjl̪aː
कोरा	koːɾäː
कोरियन	koːɾijə̃n̪
कोरिया	koːɾijäː
कोरियाई	koːɾijäːiː
कोरेगांव	koːɾeːɡä̃ːmw
कोरोनावायरस	koːɾoːn̪äːʋäːjɾəs̪
कोलकाता	koːl̪käːt̪äː
कोलाहल	koːl̪äːɦəl̪
कोशकला	koːʃkəl̪äː
कोशिका	koːʃɪkäː
कोष	koːʃ
कोष्ठक	koːʃʈʰək
कोस	koːs̪
कोसना	koːs̪n̪äː
कोहनी	koːɦn̪iː
कोहराम	koːɦɾä̃ːm
कोहिमा	koːɦɪmäː
कोहेनूर	koːɦeːn̪uːɾ
कौंसिल	kɔ̃ːn̪s̪ɪl̪
कौआ	kə̯uʋäː
कौन	kɔ̃ːn̪
कौमार्य	kɔːmäːɾjᵊ
कौवा	kə̯uʋäː
क्या	kjäː
क्यूबा	kjuːbäː
क्योंकि	kjõːŋkiː
क्रम	kɾə̃m
क्रमण	kɾəmə̃ɳ
क्रमबद्ध	kɾə̃mbəd̪d̪ʱ
क्रमशः	kɾə̃mʃəɦ
क्रमसूचक	kɾə̃ms̪uːt͡ʃək
क्रमागत	kɾəmäːɡət̪
क्रमादेशन	kɾəmäːd̪eːʃə̃n̪
क्रांति	kɾä̃ːn̪t̪iː
क्रांतिकारी	kɾä̃ːn̪t̪ɪkäːɾiː
क्राइस्टचर्च	kɾäːɪs̪ʈt͡ʃəɾt͡ʃ
क्रान्ति	kɾä̃ːn̪t̪iː
क्रिया	kɾijäː
क्रियाकलाप	kɾijäːkəl̪äːp
क्रियापद	kɾijäːpəd̪
क्रियारूप	kɾijäːɾuːp
क्रियावाचक	kɾijäːʋäːt͡ʃək
क्रियाविशेषण	kɾijäːʋɪʃeːʃə̃ɳ
क्रिसमस	kɾɪs̪məs̪
क्रिस्टल	kɾɪs̪ʈəl̪
क्रिस्मस	kɾɪs̪məs̪
क्रीड़ा	kɾiːɽäː
क्रीड़ास्थल	kɾiːɽäːs̪t̪ʰəl̪
क्रीड़िका	kɾiːɽɪkäː
क्रीडिका	kɾiːɖɪkäː
क्रीम	kɾĩːm
क्रूस	kɾuːs̪
क्रेता	kɾeːt̪äː
क्रेमलिन	kɾẽːml̪ɪ̃n̪
क्रोएशिया	kɾoːeːʃijäː
क्लब	kl̪əb
क्लर्क	kl̪əɾk
क्लास	kl̪äːs̪
क्वथनांक	kwət̪ʰən̪ä̃ːk
क्वारंटीन	kwäːɾə̃ɳʈĩːn̪
क्वार्टज़	kwäːɾʈd͡ʒ
क्वार्टज़	kwäːɾʈz
क्विंटल	kwɪ̃ɳʈəl̪
क्वेटा	kweːʈäː
क्षण	kʃə̃ɳ
क्षति	kʃət̪iː
क्षत्राणी	kʃət̪ɾäːɳiː
क्षत्रिय	kʃət̪ɾijə
क्षमता	kʃə̃mt̪äː
क्षमा	kʃəmäː
क्षम्य	kʃə̃mjᵊ
क्षयरोग	kʃəjɾoːɡ
क्षारातु	kʃäːɾäːt̪uː
क्षारीय	kʃäːɾiːjᵊ
क्षितिज	kʃɪt̪ɪd͡ʒ
क्षीण	kʃĩːɳ
क्षुद्र	kʃʊd̪ɾᵊ
क्षुधा	kʃʊd̪ʱäː
क्षुब्ध	kʃʊbd̪ʱ
क्षेत्र	kʃeːt̪ɾᵊ
क्षेत्रफल	kʃeːt̪ɾəpʰəl̪
क्षेत्ररक्षण	kʃeːt̪ɾəɾəkʃə̃ɳ
क्षेत्राधिकार	kʃeːt̪ɾäːd̪ʱɪkäːɾ
क्षेत्रीय	kʃeːt̪ɾiːjᵊ
खँखड़	kʰə̃ŋkʰəɽ
खंड	kʰə̃ɳɖ
खंडशः	kʰə̃ɳɖʃəɦ
खंडहर	kʰə̃ɳɖʱəɾ
खंबा	kʰə̃mbäː
खंभा	kʰə̃mbʱäː
खगोल	kʰəɡoːl̪
खच्चर	kʰət̚t͡ʃəɾ
खटखटाना	kʰəʈkʰəʈäːn̪äː
खटमल	kʰəʈməl̪
खटमिट्ठा	kʰəʈmɪʈ̚ʈʰäː
खटाई	kʰəʈäːiː
खड़ा	kʰəɽäː
खड़िया	kʰəɽijäː
खड़ूस	kʰəɽuːs̪
खण्ड	kʰə̃ɳɖ
खतौनी	kʰət̪ɔːn̪iː
खदान	kʰəd̪ä̃ːn̪
खदेड़ना	kʰəd̪eːɽn̪äː
खनन	kʰən̪ə̃n̪
खनाखन	kʰən̪äːkʰə̃n̪
खनिज	kʰən̪ɪd͡ʒ
खनित्र	kʰən̪ɪt̪ɾᵊ
खपरैल	kʰəpɾɛːl̪
खयाल	kʰəjäːl̪
खयाल	xəjäːl̪
खयालें	kʰəjäːl̪ẽː
खयालें	xəjäːl̪ẽː
खयालो	kʰəjäːl̪oː
खयालो	xəjäːl̪oː
खयालों	kʰəjäːl̪õː
खयालों	xəjäːl̪õː
खरा	kʰəɾäː
खराई	kʰəɾäːiː
खरोंच	kʰəɾõːn̪t͡ʃ
खरोंचना	kʰəɾõːn̪t͡ʃn̪äː
खलना	kʰəl̪n̪äː
खलनायक	kʰəl̪n̪äːjək
खलासी	kʰəl̪äːs̪iː
खलासी	xəl̪äːs̪iː
खलिहान	kʰəl̪ɪɦä̃ːn̪
खल्लास	kʰəl̪l̪äːs̪
खसरा	kʰəs̪ɾäː
ख़ंजर	kʰə̃n̪d͡ʒəɾ
ख़ंजर	xə̃n̪d͡ʒəɾ
ख़ज़ाना	kʰəd͡ʒäːn̪äː
ख़ज़ाना	xəzäːn̪äː
ख़तम	kʰət̪ə̃m
ख़तम	xət̪ə̃m
ख़ता	kʰət̪äː
ख़ता	xət̪äː
ख़त्म	kʰət̪ə̃m
ख़त्म	xət̪ə̃m
ख़फ़ा	kʰəpʰäː
ख़फ़ा	xəfäː
ख़बरनवीस	kʰəbəɾn̪əʋiːs̪
ख़बरनवीस	xəbəɾn̪əʋiːs̪
ख़म	kʰə̃m
ख़म	xə̃m
ख़मियाज़ा	kʰəmijäːd͡ʒäː
ख़मियाज़ा	xəmijäːzäː
ख़याल	kʰəjäːl̪
ख़याल	xəjäːl̪
ख़रबूज़ा	kʰəɾbuːd͡ʒäː
ख़रबूज़ा	xəɾbuːzäː
ख़राब	kʰəɾäːb
ख़राब	xəɾäːb
ख़राश	kʰəɾäːʃ
ख़राश	xəɾäːʃ
ख़रीदना	kʰəɾiːd̪̚n̪äː
ख़रीदना	xəɾiːd̪̚n̪äː
ख़रीदवाना	kʰəɾiːd̪wäːn̪äː
ख़रीदवाना	xəɾiːd̪wäːn̪äː
ख़रीदार	kʰəɾiːd̪äːɾ
ख़रीदार	xəɾiːd̪äːɾ
ख़रीदारी	kʰəɾiːd̪äːɾiː
ख़रीदारी	xəɾiːd̪äːɾiː
ख़र्चा	kʰəɾt͡ʃäː
ख़र्चा	xəɾt͡ʃäː
ख़लक़	kʰəl̪k
ख़लक़	xəl̪q
ख़लासी	kʰəl̪äːs̪iː
ख़लासी	xəl̪äːs̪iː
ख़लिश	kʰəl̪ɪʃ
ख़लिश	xəl̪ɪʃ
ख़लीफ़ा	kʰəl̪iːpʰäː
ख़लीफ़ा	xəl̪iːfäː
ख़सरा	kʰəs̪ɾäː
ख़सरा	xəs̪ɾäː
ख़ाक	kʰäːk
ख़ाक	xäːk
ख़ाक़ान	kʰäːkä̃ːn̪
ख़ाक़ान	xäːqä̃ːn̪
ख़ाका	kʰäːkäː
ख़ाका	xäːkäː
ख़ातिर	kʰäːt̪ɪɾ
ख़ातिर	xäːt̪ɪɾ
ख़ातून	kʰäːt̪ũːn̪
ख़ातून	xäːt̪ũːn̪
ख़ान	kʰä̃ːn̪
ख़ान	xä̃ːn̪
ख़ानक़ाह	kʰä̃ːn̪käːɦ
ख़ानक़ाह	xä̃ːn̪qäːɦ
ख़ानगी	kʰä̃ːn̪ɡiː
ख़ानगी	xä̃ːn̪ɡiː
ख़ानदान	kʰä̃ːn̪d̪ä̃ːn̪
ख़ानदान	xä̃ːn̪d̪ä̃ːn̪
ख़ानदानी	kʰä̃ːn̪d̪äːn̪iː
ख़ानदानी	xä̃ːn̪d̪äːn̪iː
ख़ानसामा	kʰä̃ːn̪s̪äːmäː
ख़ानसामा	xä̃ːn̪s̪äːmäː
ख़ानसामाँ	kʰä̃ːn̪s̪äːmä̃ː
ख़ानसामाँ	xä̃ːn̪s̪äːmä̃ː
ख़ाना	kʰäːn̪äː
ख़ाना	xäːn̪äː
ख़ानाबदोश	kʰäːn̪äːbəd̪oːʃ
ख़ानाबदोश	xäːn̪äːbəd̪oːʃ
ख़ामी	kʰäːmiː
ख़ामी	xäːmiː
ख़ारिज	kʰäːɾɪd͡ʒ
ख़ारिज	xäːɾɪd͡ʒ
ख़ाला	kʰäːl̪äː
ख़ाला	xäːl̪äː
ख़ालिक़	kʰäːl̪ɪk
ख़ालिक़	xäːl̪ɪq
ख़ालिस	kʰäːl̪ɪs̪
ख़ालिस	xäːl̪ɪs̪
ख़ालिस्तान	kʰäːl̪ɪs̪t̪ä̃ːn̪
ख़ालिस्तान	xäːl̪ɪs̪t̪ä̃ːn̪
ख़ाली	kʰäːl̪iː
ख़ाली	xäːl̪iː
ख़ावंद	kʰäːʋə̃n̪d̪
ख़ावंद	xäːʋə̃n̪d̪
ख़ास	kʰäːs̪
ख़ास	xäːs̪
ख़ासियत	kʰäːs̪ijət̪
ख़ासियत	xäːs̪ijət̪
ख़िताब	kʰɪt̪äːb
ख़िताब	xɪt̪äːb
ख़िताबी	kʰɪt̪äːbiː
ख़िताबी	xɪt̪äːbiː
ख़िदमतगार	kʰɪd̪mət̪ɡäːɾ
ख़िदमतगार	xɪd̪mət̪ɡäːɾ
ख़िलाफ़	kʰɪl̪äːpʰ
ख़िलाफ़	xɪl̪äːf
ख़ुदा	kʰʊd̪äː
ख़ुदा	xʊd̪äː
ख़ुदावंद	kʰʊd̪äːʋə̃n̪d̪
ख़ुदावंद	xʊd̪äːʋə̃n̪d̪
ख़ुफ़िया	kʰʊpʰijäː
ख़ुफ़िया	xʊfijäː
ख़ुराफ़ात	kʰʊɾäːpʰäːt̪
ख़ुराफ़ात	xʊɾäːfäːt̪
ख़ुलासा	kʰʊl̪äːs̪äː
ख़ुलासा	xʊl̪äːs̪äː
ख़ुशआमदीद	kʰʊʃəä̃ːmd̪iːd̪
ख़ुशआमदीद	xʊʃəä̃ːmd̪iːd̪
ख़ुशक़िस्मत	kʰʊʃkɪs̪mət̪
ख़ुशक़िस्मत	xʊʃqɪs̪mət̪
ख़ुशनसीब	kʰʊʃn̪əs̪iːb
ख़ुशनसीब	xʊʃn̪əs̪iːb
ख़ुशबूदार	kʰʊʃbuːd̪äːɾ
ख़ुशबूदार	xʊʃbuːd̪äːɾ
ख़ुशमिज़ाज	kʰʊʃmɪd͡ʒäːd͡ʒ
ख़ुशमिज़ाज	xʊʃmɪzäːd͡ʒ
ख़ुशहाल	kʰʊʃɦäːl̪
ख़ुशहाल	xʊʃɦäːl̪
ख़ुशहाली	kʰʊʃɦäːl̪iː
ख़ुशहाली	xʊʃɦäːl̪iː
ख़ुशाब	kʰʊʃäːb
ख़ुशाब	xʊʃäːb
ख़ुशामद	kʰʊʃäːməd̪
ख़ुशामद	xʊʃäːməd̪
ख़ूँख़ार	kʰũːkʰäːɾ
ख़ूँख़ार	xũːxäːɾ
ख़ून	kʰũːn̪
ख़ून	xũːn̪
ख़ूनी	kʰuːn̪iː
ख़ूनी	xuːn̪iː
ख़ूबसूरत	kʰuːbs̪uːɾət̪
ख़ूबसूरत	xuːbs̪uːɾət̪
ख़ूबसूरती	kʰuːbs̪uːɾt̪iː
ख़ूबसूरती	xuːbs̪uːɾt̪iː
ख़ूबानी	kʰuːbäːn̪iː
ख़ूबानी	xuːbäːn̪iː
ख़ैरात	kʰɛːɾäːt̪
ख़ैरात	xɛːɾäːt̪
ख़ैरियत	kʰɛːɾijət̪
ख़ैरियत	xɛːɾijət̪
ख़्याल	kʰjäːl̪
ख़्याल	xjäːl̪
ख़्वाजा	kʰʋäːd͡ʒäː
ख़्वाजा	xʋäːd͡ʒäː
ख़्वाब	kʰʋäːb
ख़्वाब	xʋäːb
ख़्वाबगाह	kʰʋäːbɡäːɦ
ख़्वाबगाह	xʋäːbɡäːɦ
ख़्वाहिश	kʰäːɦɪʃ
ख़्वाहिश	kʰʋäːɦɪʃ
ख़्वाहिश	xäːɦɪʃ
ख़्वाहिश	xʋäːɦɪʃ
खाँग	kʰä̃ːŋɡ
खाँसना	kʰä̃ːs̪n̪äː
खाँसी	kʰä̃ːs̪iː
खांसना	kʰä̃ːn̪s̪n̪äː
खाई	kʰäːiː
खाट	kʰäːʈ
खाड़ी	kʰäːɽiː
खाता	kʰäːt̪äː
खाद	kʰäːd̪
खादन	kʰäːd̪ə̃n̪
खादी	kʰäːd̪iː
खाद्य	kʰäːd̪jə
खान	kʰä̃ːn̪
खाना	kʰäːn̪äː
खानि	kʰäːn̪iː
खाने	kʰäːn̪eː
खाप	kʰäːp
खारा	kʰäːɾäː
खाली	kʰäːl̪iː
खाली	xäːl̪iː
खिंचाव	kʰɪ̃n̪t͡ʃäːʋ
खिन्न	kʰɪ̃n̪n̪ᵊ
खिलना	kʰɪl̪n̪äː
खिलवाना	kʰɪl̪ʋäːn̪äː
खिलाड़ी	kʰɪl̪äːɽiː
खिलाना	kʰɪl̪äːn̪äː
खिलौना	kʰɪl̪ɔːn̪äː
खिसकना	kʰɪs̪əkn̪äː
खींचतान	kʰĩːt͡ʃt̪ä̃ːn̪
खींचना	kʰĩːt͡ʃn̪äː
खीरा	kʰiːɾäː
खील	kʰiːl̪
खीसा	kʰiːs̪äː
खुजलाना	kʰʊd͡ʒl̪äːn̪äː
खुजली	kʰʊd͡ʒl̪iː
खुदरा	kʰʊd̪ɾäː
खुदाई	kʰʊd̪äːiː
खुबानी	kʰuːbäːn̪iː
खुबानी	xuːbäːn̪iː
खुरपा	kʰʊɾpäː
खुलकर	kʰʊl̪kəɾ
खुलना	kʰʊl̪n̪äː
खुला	kʰʊl̪äː
खुलापन	kʰʊl̪äːpə̃n̪
खुलेआम	kʰʊl̪eːä̃ːm
खेना	kʰeːn̪äː
खेल	kʰeːl̪
खेलकूद	kʰeːl̪kuːd̪
खेलना	kʰeːl̪n̪äː
खेला	kʰeːl̪äː
खैरात	kʰɛːɾäːt̪
खैरात	xɛːɾäːt̪
खोंसना	kʰõːn̪s̪n̪äː
खोआ	kʰoːäː
खोका	kʰoːkäː
खोजना	kʰoːd͡ʒn̪äː
खोटा	kʰoːʈaː
खोदना	kʰoːd̪̚n̪äː
खोना	kʰoːn̪äː
खोया	kʰoːjäː
खोलना	kʰoːl̪n̪äː
खोला	kʰoːl̪äː
ख्वाब	kʰʋäːb
ख्वाब	xʋäːb
गँवाना	ɡə̃ʋäːn̪äː
गंगई	ɡə̃ŋɡəiː
गंगाजल	ɡə̃ŋɡäːd͡ʒəl̪
गंजा	ɡə̃n̪d͡ʒäː
गंजी	ɡə̃n̪d͡ʒiː
गंतव्य	ɡə̃n̪t̪əʋjᵊ
गंदगी	ɡə̃n̪d̪əɡiː
गंदा	ɡə̃n̪d̪äː
गंध	ɡə̃n̪d̪ʱ
गंभीर	ɡə̃mbʱiːɾ
गंवाना	ɡə̃mwäːn̪äː
गगन	ɡəɡə̃n̪
गगनचुंबी	ɡəɡə̃n̪t͡ʃʊ̃mbiː
गगनभेदी	ɡəɡə̃n̪bʱeːd̪iː
गठन	ɡəʈʰə̃n̪
गठबंधन	ɡəʈʰbə̃n̪d̪ʱə̃n̪
गड़गड़ाना	ɡəɽɡəɽäːn̪äː
गड़गड़ाहट	ɡəɽɡəɽäːɦəʈ
गड़बड़झाला	ɡəɽbəɽd͡ʒʱäːl̪äː
गड्ढा	ɡəɖ̚ɖʱäː
गढ़ना	ɡəɽʱn̪äː
गढ़वाल	ɡəɽʱʋäːl̪
गण	ɡə̃ɳ
गणतंत्र	ɡə̃ɳt̪ə̃n̪t̪ɾᵊ
गणना	ɡə̃ɳn̪äː
गणराज्य	ɡə̃ɳɾäːd͡ʒjᵊ
गतिमान	ɡət̪ɪmä̃ːn̪
गत्ता	ɡət̪̚t̪äː
गदा	ɡəd̪äː
गधा	ɡəd̪ʱäː
गनी	ɡən̪iː
गन्दा	ɡə̃n̪d̪äː
गन्ना	ɡə̃n̪n̪äː
गमछा	ɡə̃mt͡ʃʰäː
गमन	ɡəmə̃n̪
गमला	ɡə̃ml̪äː
गम्भीर	ɡə̃mbʱiːɾ
गया	ɡəjäː
गरिमा	ɡəɾɪmäː
गरेबान	ɡəɾeːbä̃ːn̪
गर्दन	ɡəɾd̪ə̃n̪
गर्भपात	ɡəɾbʱpäːt̪
गर्भावस्था	ɡəɾbʱäːʋəs̪t̪ʰäː
गर्भाशय	ɡəɾbʱäːʃəj
गर्म	ɡəɾə̃m
गर्मागर्म	ɡəɾmäːɡəɾm
गलत	ɡəl̪ət̪
गलत	ɣəl̪ət̪
गलना	ɡəl̪n̪äː
गलबाँही	ɡəl̪bä̃ːɦiː
गलसुआ	ɡəl̪s̪ʊäː
गला	ɡəl̪äː
गलियारा	ɡəl̪ijäːɾäː
गली	ɡəl̪iː
गवारा	ɡəʋäːɾäː
गवाह	ɡəʋäːɦ
गवाही	ɡəʋäːɦiː
गहन	ɡɛɦɛ̃n̪
गहना	ɡɛɦn̪äː
गहरा	ɡɛɦɾäː
गहराई	ɡɛɦɾäːiː
ग़द्दार	ɡəd̪̚d̪äːɾ
ग़द्दार	ɣəd̪̚d̪äːɾ
ग़नीमत	ɡən̪iːmət̪
ग़नीमत	ɣən̪iːmət̪
ग़बन	ɡəbə̃n̪
ग़बन	ɣəbə̃n̪
ग़म	ɡə̃m
ग़म	ɣə̃m
ग़मज़दा	ɡəməd͡ʒd̪äː
ग़मज़दा	ɣəməzd̪äː
ग़रारा	ɡəɾäːɾäː
ग़रारा	ɣəɾäːɾäː
ग़लत	ɡəl̪ət̪
ग़लत	ɣəl̪ət̪
ग़लतफ़हमी	ɡəl̪ət̪pʰɛɦmiː
ग़लतफ़हमी	ɣəl̪ət̪fɛɦmiː
ग़लती	ɡəl̪t̪iː
ग़लती	ɣəl̪t̪iː
ग़ाज़ियाबाद	ɡäːd͡ʒijäːbäːd̪
ग़ाज़ियाबाद	ɣäːzijäːbäːd̪
ग़ायब	ɡäːjb
ग़ायब	ɡäːjəb
ग़ायब	ɣäːjb
ग़ायब	ɣäːjəb
ग़ुब्बारा	ɡʊb̚bäːɾäː
ग़ुब्बारा	ɣʊb̚bäːɾäː
ग़ुसल	ɡʊs̪əl̪
ग़ुसल	ɣʊs̪əl̪
ग़ुसलख़ाना	ɡʊs̪əl̪kʰäːn̪äː
ग़ुसलख़ाना	ɣʊs̪əl̪xäːn̪äː
ग़ुस्ल	ɡʊs̪l̪
ग़ुस्ल	ɣʊs̪l̪
ग़ुस्लख़ाना	ɡʊs̪l̪kʰäːn̪äː
ग़ुस्लख़ाना	ɣʊs̪l̪xäːn̪äː
ग़ुस्सा	ɡʊs̪s̪äː
ग़ुस्सा	ɣʊs̪s̪äː
ग़ुस्साना	ɡʊs̪s̪äːn̪äː
ग़ुस्साना	ɣʊs̪s̪äːn̪äː
ग़ैरक़ानूनी	ɡɛːɾkäːn̪uːn̪iː
ग़ैरक़ानूनी	ɣɛːɾqäːn̪uːn̪iː
ग़ोता	ɡoːt̪äː
ग़ोता	ɣoːt̪äː
ग़ोताख़ोर	ɡoːt̪äːkʰoːɾ
ग़ोताख़ोर	ɣoːt̪äːxoːɾ
ग़ौरतलब	ɡɔːɾt̪əl̪əb
ग़ौरतलब	ɣɔːɾt̪əl̪əb
गाँजा	ɡä̃ːn̪d͡ʒäː
गाँठ	ɡä̃ːʈʰ
गाँठकट	ɡä̃ːʈʰkəʈ
गाँडू	ɡä̃ːɳɖuː
गाँधी	ɡä̃ːn̪d̪ʱiː
गाँधीनगर	ɡä̃ːn̪d̪ʱiːn̪əɡəɾ
गाँववाला	ɡä̃ːʋʋäːl̪äː
गांगुली	ɡä̃ːŋɡʊl̪iː
गांजा	ɡä̃ːn̪d͡ʒäː
गांड	ɡä̃ːɳɖ
गांडू	ɡä̃ːɳɖuː
गांधीगिरी	ɡä̃ːn̪d̪ʱiːɡɪɾiː
गांभीर्य	ɡä̃ːmbʱiːɾjᵊ
गांव	ɡä̃ːmw
गांसू	ɡä̃ːn̪s̪uː
गाउँ	ɡäːũː
गाजर	ɡäːd͡ʒəɾ
गाड़ना	ɡäːɽn̪äː
गाड़ा	ɡäːɽäː
गाढ़ा	ɡäːɽʱäː
गाण्डू	ɡä̃ːɳɖuː
गात्र	ɡäːt̪ɾᵊ
गान	ɡä̃ːn̪
गाना	ɡäːn̪äː
गाम	ɡä̃ːm
गाय	ɡäːj
गायक	ɡäːjək
गायकी	ɡäːjəkiː
गायन	ɡäːjə̃n̪
गायब	ɡäːjb
गायब	ɡäːjəb
गायब	ɣäːjb
गायब	ɣäːjəb
गायिका	ɡäːjɪkäː
गाल	ɡäːl̪
गाली	ɡäːl̪iː
गाहक	ɡäːɦək
गिनतारा	ɡɪ̃n̪t̪äːɾäː
गिनती	ɡɪ̃n̪t̪iː
गिनना	ɡɪ̃n̪n̪äː
गिनी	ɡɪn̪iː
गिरजा	ɡɪɾd͡ʒäː
गिरजाघर	ɡɪɾd͡ʒäːɡʱəɾ
गिरना	ɡɪɾn̪äː
गिरफ़्तार	ɡɪɾəft̪äːɾ
गिरफ़्तार	ɡɪɾəpʰt̪äːɾ
गिरफ़्तारी	ɡɪɾəft̪äːɾiː
गिरफ़्तारी	ɡɪɾəpʰt̪äːɾiː
गिरमिटिया	ɡɪɾmɪʈijäː
गिरा	ɡɪɾäː
गिराना	ɡɪɾäːn̪äː
गिलहरी	ɡɪl̪ɛɦɾiː
गिला	ɡɪl̪äː
गिलास	ɡɪl̪äːs̪
गीतकार	ɡiːt̪käːɾ
गीला	ɡiːl̪äː
गुंजाइश	ɡʊ̃n̪d͡ʒäːɪʃ
गुंटूर	ɡʊ̃ɳʈuːɾ
गुंडा	ɡʊ̃ɳɖäː
गुंडागर्दी	ɡʊ̃ɳɖäːɡəɾd̪iː
गुआम	ɡʊä̃ːm
गुओमिंदांग	ɡʊoːmɪ̃n̪d̪ä̃ːŋɡ
गुगल	ɡʊɡəl̪
गुच्छा	ɡʊt̚t͡ʃʰäː
गुजरांवाला	ɡʊd͡ʒɾä̃ːmwäːl̪äː
गुजरात	ɡʊd͡ʒɾäːt̪
गुजराती	ɡʊd͡ʒɾäːt̪iː
गुज़रना	ɡʊd͡ʒəɾn̪äː
गुज़रना	ɡʊzəɾn̪äː
गुज़श्ता	ɡʊd͡ʒəʃt̪äː
गुज़श्ता	ɡʊzəʃt̪äː
गुझिया	ɡʊd͡ʒʱijäː
गुठली	ɡʊʈʰl̪iː
गुड़ाकू	ɡʊɽäːkuː
गुड़िया	ɡʊɽijäː
गुण	ɡʊ̃ɳ
गुणधर्म	ɡʊ̃ɳd̪ʱəɾm
गुणसूत्रबिंदु	ɡʊ̃ɳs̪uːt̪ɾᵊbɪ̃n̪d̪uː
गुणा	ɡʊɳäː
गुणांक	ɡʊɳä̃ːk
गुदा	ɡʊd̪äː
गुदाद्वार	ɡʊd̪äːd̪wäːɾ
गुनगुनाना	ɡʊ̃n̪ɡʊn̪äːn̪äː
गुनना	ɡʊ̃n̪n̪äː
गुनाह	ɡʊn̪äːɦ
गुप्तचर	ɡʊpt̪̚t͡ʃəɾ
गुप्तांग	ɡʊpt̪ä̃ːŋɡ
गुफ़ा	ɡʊfäː
गुफ़्तार	ɡʊft̪äːɾ
गुफ़्तार	ɡʊpʰt̪äːɾ
गुफा	ɡʊfäː
गुफा	ɡʊpʰäː
गुबरैला	ɡʊbɾɛːl̪äː
गुब्बारा	ɡʊb̚bäːɾäː
गुब्बारा	ɣʊb̚bäːɾäː
गुम	ɡʊ̃m
गुमना	ɡʊ̃mn̪äː
गुमनाम	ɡʊ̃mn̪ä̃ːm
गुमशुदा	ɡʊ̃mʃʊd̪äː
गुमसुम	ɡʊ̃ms̪ʊ̃m
गुरबानी	ɡʊɾbäːn̪iː
गुरुकुल	ɡʊɾʊkʊl̪
गुरुत्व	ɡʊɾʊt̪wə
गुरुत्वीय	ɡʊɾʊt̪wiːjᵊ
गुरुद्वारा	ɡʊɾʊd̪wäːɾäː
गुरुवार	ɡʊɾʊʋäːɾ
गुर्जिस्तान	ɡʊɾd͡ʒɪs̪t̪ä̃ːn̪
गुर्दा	ɡʊɾd̪äː
गुल	ɡʊl̪
गुलज़ार	ɡʊl̪d͡ʒäːɾ
गुलज़ार	ɡʊl̪zäːɾ
गुलदस्ता	ɡʊl̪d̪əs̪t̪äː
गुलदान	ɡʊl̪d̪ä̃ːn̪
गुलशन	ɡʊl̪ʃə̃n̪
गुलाब	ɡʊl̪äːb
गुलाब	ɡʊl̪əb
गुलाबी	ɡʊl̪äːbiː
गुलाम	ɡʊl̪ä̃ːm
गुलाम	ɣʊl̪ä̃ːm
गुलूबंद	ɡʊl̪uːbə̃n̪d̪
गुलेल	ɡʊl̪eːl̪
गुल्लक	ɡʊl̪l̪ək
गुवाहाटी	ɡʊʋäːɦäːʈiː
गुस्ताख़	ɡʊs̪t̪äːkʰ
गुस्ताख़	ɡʊs̪t̪äːx
गुस्ताख़ी	ɡʊs̪t̪äːkʰiː
गुस्ताख़ी	ɡʊs̪t̪äːxiː
गुस्सा	ɡʊs̪s̪äː
गुस्सा	ɣʊs̪s̪äː
गुहा	ɡʊɦäː
गुहार	ɡʊɦäːɾ
गूंगा	ɡũːŋɡäː
गूंज	ɡũːn̪d͡ʒ
गूंजना	ɡũːn̪d͡ʒn̪äː
गूगल	ɡuːɡəl̪
गृहमंत्री	ɡɾɪɦmə̃n̪t̪ɾiː
गृहस्थ	ɡɾɪɦəs̪t̪ʰ
गेरुआ	ɡeːɾʊäː
गैंडा	ɡɛ̃ːɳɖäː
गैलन	ɡɛːl̪ə̃n̪
गैस	ɡæs̪
गैस	ɡɛːs̪
गॉर्डन	ɡɔɾɖə̃n̪
गोंद	ɡõːn̪d̪
गोड़ना	ɡoːɽn̪äː
गोधूम	ɡoːd̪ʱũːm
गोपनीयता	ɡoːpn̪iːjt̪äː
गोबरैला	ɡoːbɾɛːl̪äː
गोरक्षा	ɡoːɾəkʃäː
गोरखा	ɡoːɾkʰäː
गोरिल्ला	ɡoːɾɪl̪äː
गोल	ɡoːl̪
गोलंदाज़	ɡoːl̪ə̃n̪d̪äːd͡ʒ
गोलंदाज़	ɡoːl̪ə̃n̪d̪äːz
गोलगप्पा	ɡoːl̪ɡəp̚päː
गोलबंदी	ɡoːl̪bə̃n̪d̪iː
गोलमाल	ɡoːl̪mäːl̪
गोला	ɡoːl̪äː
गोली	ɡoːl̪iː
गोलीबारी	ɡoːl̪iːbäːɾiː
गोवा	ɡoːʋäː
गोष्ठी	ɡoːʃʈʰiː
गौरवशाली	ɡɔːɾəʋʃäːl̪iː
गौरवान्वित	ɡɔːɾəʋä̃ːn̪wɪt̪
गौरैया	ɡɔːɾə̯ijäː
गौशाला	ɡɔːʃäːl̪äː
ग्यारह	ɡjäːɾäː
ग्यारह	ɡjäːɾəɦ
ग्यारह	ɡjäːɾɛː
ग्रंथकार	ɡɾə̃n̪t̪ʰkäːɾ
ग्रंथालय	ɡɾə̃n̪t̪ʰäːl̪ɛː
ग्रथन	ɡɾət̪ʰə̃n̪
ग्राम	ɡɾä̃ːm
ग्रामचर्या	ɡɾä̃ːmt͡ʃəɾjäː
ग्रामीण	ɡɾäːmĩːɳ
ग्राहक	ɡɾäːɦək
ग्रीष्म	ɡɾiːʃmᵊ
ग्रीस	ɡɾiːs̪
ग्लासगो	ɡl̪äːs̪ɡoː
ग्वाटेमाला	ɡʋäːʈeːmäːl̪äː
ग्वार	ɡʋäːɾ
ग्वारपाठा	ɡʋäːɾpäːʈʰäː
ग्वाला	ɡʋäːl̪äː
ग्वालियर	ɡʋäːl̪ijəɾ
घंटा	ɡʱəɳʈaː
घटना	ɡʱəʈn̪äː
घटनास्थल	ɡʱəʈn̪äːs̪t̪ʰəl̪
घटाना	ɡʱəʈäːn̪äː
घटिया	ɡʱəʈijäː
घड़ियाल	ɡʱəɽijäːl̪
घन	ɡʱə̃n̪
घनचक्कर	ɡʱə̃n̪t͡ʃək̚kəɾ
घनत्व	ɡʱən̪ət̪wᵊ
घना	ɡʱən̪äː
घनीय	ɡʱən̪iːjᵊ
घबराना	ɡʱəbɾäːn̪äː
घबराहट	ɡʱəbɾäːɦəʈ
घमंड	ɡʱəmə̃ɳɖ
घमंडी	ɡʱəmə̃ɳɖiː
घमासान	ɡʱəmäːs̪ä̃ːn̪
घराना	ɡʱəɾäːn̪äː
घरेलू	ɡʱəɾeːl̪uː
घर्षण	ɡʱəɾʃə̃ɳ
घसियारा	ɡʱəs̪ijäːɾäː
घसीटना	ɡʱəs̪iːʈn̪äː
घाट	ɡʱäːʈ
घाटा	ɡʱäːʈäː
घाटी	ɡʱäːʈiː
घात	ɡʱäːt̪
घातीय	ɡʱäːt̪iːjᵊ
घाना	ɡʱäːn̪äː
घायल	ɡʱäːjəl̪
घाव	ɡʱäːʋ
घिरना	ɡʱɪɾn̪äː
घीया	ɡʱiːjäː
घुँघरू	ɡʱʊ̃ŋɡʱɾuː
घुंघरू	ɡʱʊ̃ŋɡʱɾuː
घुंडी	ɡʱʊ̃ɳɖiː
घुटना	ɡʱʊʈn̪äː
घुड़सवार	ɡʱʊɽs̪əʋäːɾ
घुड़सवारी	ɡʱʊɽs̪əʋäːɾɪː
घुसड़ना	ɡʱʊs̪əɽn̪äː
घुसपैठ	ɡʱʊs̪pɛːʈʰ
घुसपैठिया	ɡʱʊs̪pɛːʈʰijäː
घूँघट	ɡʱũːŋɡʱəʈ
घूम	ɡʱũːm
घूरना	ɡʱuːɾn̪äː
घूर्णन	ɡʱuːɾɳə̃n̪
घूर्णवायु	ɡʱuːɾɳəʋäːjuː
घूस	ɡʱuːs̪
घूसख़ोर	ɡʱuːs̪kʰoːɾ
घूसख़ोर	ɡʱuːs̪xoːɾ
घूसख़ोरी	ɡʱuːs̪kʰoːɾiː
घूसख़ोरी	ɡʱuːs̪xoːɾiː
घृणास्पद	ɡʱɾɪɳäːs̪pəd̪
घेरना	ɡʱeːɾn̪äː
घेरा	ɡʱeːɾäː
घेराव	ɡʱeːɾäːʋ
घोंगा	ɡʱõːŋɡäː
घोंघा	ɡʱõːŋɡʱäː
घोटाला	ɡʱoːʈäːl̪äː
घोड़ा	ɡʱoːɽäː
घोराही	ɡʱoːɾäːɦiː
घोल	ɡʱoːl̪
घोलना	ɡʱoːl̪n̪äː
घोषक	ɡʱoːʃək
घोषणा	ɡʱoːʃɳäː
घोषित	ɡʱoːʃɪt̪
चंकट	t͡ʃə̃ŋkəʈ
चंडीगढ़	t͡ʃə̃ɳɖiːɡəɽʱ
चंद	t͡ʃə̃n̪d̪
चंदा	t͡ʃə̃n̪d̪äː
चंद्र	t͡ʃə̃n̪d̪ɾᵊ
चंद्रगुप्त	t͡ʃə̃n̪d̪ɾəɡʊpt̪
चंद्रग्रहण	t͡ʃə̃n̪d̪ɾəɡɾɛɦɛ̃ɳ
चंद्रबिंदु	t͡ʃə̃n̪d̪ɾəbɪ̃n̪d̪uː
चंद्रमा	t͡ʃə̃n̪d̪ɾəmäː
चंद्रवार	t͡ʃə̃n̪d̪ɾəʋäːɾ
चंद्रिका	t͡ʃə̃n̪d̪ɾɪkäː
चंपा	t͡ʃə̃mpäː
चकाचौंध	t͡ʃəkäːt͡ʃɔ̃ːn̪d̪ʱ
चकोतरा	t͡ʃəkoːt̪ɾäː
चक्कर	t͡ʃək̚kəɾ
चक्का	t͡ʃək̚käː
चक्रवृद्धि	t͡ʃəkɾəʋɾɪd̪̚d̪ʱiː
चक्षु	t͡ʃəkʃuː
चक्षुदान	t͡ʃəkʃʊd̪ä̃ːn̪
चखना	t͡ʃəkʰn̪äː
चटकारा	t͡ʃəʈkäːɾäː
चटगांव	t͡ʃəʈɡä̃ːmw
चटनी	t͡ʃəʈn̪iː
चट्टान	t͡ʃəʈ̚ʈä̃ːn̪
चड्डी	t͡ʃəɖ̚ɖiː
चढ़ना	t͡ʃəɽʱn̪äː
चढ़ाई	t͡ʃəɽʱäːiː
चतुराई	t͡ʃət̪ʊɾäːiː
चना	t͡ʃən̪äː
चन्द	t͡ʃə̃n̪d̪
चन्द्र	t͡ʃə̃n̪d̪ɾᵊ
चन्द्रमा	t͡ʃə̃n̪d̪ɾəmäː
चन्द्रवार	t͡ʃə̃n̪d̪ɾəʋäːɾ
चन्द्रिका	t͡ʃə̃n̪d̪ɾɪkäː
चपरासी	t͡ʃəpɾäːs̪iː
चपाती	t͡ʃəpäːt̪iː
चप्पल	t͡ʃəp̚pəl̪
चबाना	t͡ʃəbäːn̪äː
चमकदार	t͡ʃəməkd̪äːɾ
चमकना	t͡ʃəməkn̪äː
चमगादड़	t͡ʃə̃mɡäːd̪əɽ
चमचमाना	t͡ʃə̃mt͡ʃəmäːn̪äː
चमचा	t͡ʃə̃mt͡ʃäː
चमची	t͡ʃə̃mt͡ʃiː
चमड़ा	t͡ʃə̃mɽäː
चमड़ी	t͡ʃə̃mɽiː
चमत्कार	t͡ʃəmət̪käːɾ
चमत्कारी	t͡ʃəmət̪käːɾiː
चमस	t͡ʃəməs̪
चयन	t͡ʃəjə̃n̪
चरख़ा	t͡ʃəɾkʰäː
चरख़ा	t͡ʃəɾxäː
चरखा	t͡ʃəɾkʰäː
चरखा	t͡ʃəɾxäː
चरण	t͡ʃəɾə̃ɳ
चरना	t͡ʃəɾn̪äː
चरमपंथी	t͡ʃəɾə̃mpə̃n̪t̪ʰiː
चरवाहा	t͡ʃəɾʋäːɦäː
चरागाह	t͡ʃəɾäːɡäːɦ
चर्चा	t͡ʃəɾt͡ʃäː
चल	t͡ʃəl̪
चलचित्र	t͡ʃəl̪t͡ʃɪt̪ɾᵊ
चलचित्रण	t͡ʃəl̪t͡ʃɪt̪ɾə̃ɳ
चलन	t͡ʃəl̪ə̃n̪
चलना	t͡ʃəl̪n̪äː
चलवाना	t͡ʃəl̪ʋäːn̪äː
चलाना	t͡ʃəl̪äːn̪äː
चवन्नी	t͡ʃəʋə̃n̪n̪iː
चवालीस	t͡ʃəʋäːl̪iːs̪
चव्वन	t͡ʃəʋʋə̃n̪
चश्मा	t͡ʃəʃmäː
चषक	t͡ʃəʃək
चाँटा	t͡ʃä̃ːʈäː
चाँद	t͡ʃä̃ːn̪d̪
चाँदनी	t͡ʃä̃ːn̪d̪n̪iː
चाँदी	t͡ʃä̃ːn̪d̪iː
चांद	t͡ʃä̃ːn̪d̪
चांदी	t͡ʃä̃ːn̪d̪iː
चांद्र	t͡ʃä̃ːn̪d̪ɾᵊ
चांपानेर	t͡ʃä̃ːpäːn̪eːɾ
चांसलर	t͡ʃä̃ːn̪s̪l̪əɾ
चाइना	t͡ʃäːɪn̪äː
चाक	t͡ʃäːk
चाकलेट	t͡ʃäːkl̪eːʈ
चाकू	t͡ʃäːkuː
चाचा	t͡ʃäːt͡ʃäː
चाची	t͡ʃäːt͡ʃiː
चाट	t͡ʃäːʈ
चाटना	t͡ʃäːʈn̪äː
चातुर्य	t͡ʃäːt̪ʊɾjᵊ
चान्द्र	t͡ʃä̃ːn̪d̪ɾᵊ
चाप	t͡ʃäːp
चाबी	t͡ʃäːbiː
चाभी	t͡ʃäːbʱiː
चाय	t͡ʃäːj
चायख़ाना	t͡ʃäːjkʰäːn̪äː
चायख़ाना	t͡ʃäːjxäːn̪äː
चायदान	t͡ʃäːjd̪ä̃ːn̪
चायदानी	t͡ʃäːjd̪äːn̪iː
चार	t͡ʃäːɾ
चारपाई	t͡ʃäːɾpäːiː
चारा	t͡ʃäːɾäː
चाल	t͡ʃäːl̪
चालक	t͡ʃäːl̪ək
चालकता	t͡ʃäːl̪əkt̪äː
चालान	t͡ʃäːl̪ä̃ːn̪
चालीस	t͡ʃäːl̪iːs̪
चालीसपद	t͡ʃäːl̪iːs̪pəd̪
चालुक्य	t͡ʃäːl̪ʊkjᵊ
चाव	t͡ʃäːʋ
चावल	t͡ʃäːʋəl̪
चाशनी	t͡ʃäːʃn̪iː
चाह	t͡ʃäːɦ
चाहत	t͡ʃäːɦət̪
चाहना	t͡ʃäːɦn̪äː
चाहे	t͡ʃäːɦeː
चिंगहई	t͡ʃɪ̃ŋɡʱəiː
चिंगारी	t͡ʃɪ̃ŋɡäːɾiː
चिंता	t͡ʃɪ̃n̪t̪äː
चिंताजनक	t͡ʃɪ̃n̪t̪äːd͡ʒən̪ək
चिकना	t͡ʃɪkn̪äː
चिकित्सक	t͡ʃɪkɪt̪s̪ək
चिकित्सालय	t͡ʃɪkɪt̪s̪äːl̪əj
चिट्टी	t͡ʃɪʈ̚ʈiː
चिट्ठी	t͡ʃɪʈ̚ʈʰiː
चिड़वा	t͡ʃɪɽʋäː
चिड़िया	t͡ʃɪɽijäː
चिढ़ना	t͡ʃɪɽʱn̪äː
चिढ़ाना	t͡ʃɪɽʱäːn̪äː
चित्ताकर्षक	t͡ʃɪt̪̚t̪äːkəɾʃək
चित्तूर	t͡ʃɪt̪̚t̪uːɾ
चित्रकला	t͡ʃɪt̪ɾᵊkəl̪äː
चित्रकार	t͡ʃɪt̪ɾəkäːɾ
चित्रकारी	t͡ʃɪt̪ɾəkäːɾiː
चित्रण	t͡ʃɪt̪ɾə̃ɳ
चिथड़ा	t͡ʃɪt̪ʰɽäː
चिनिया	t͡ʃɪn̪ijäː
चिपकना	t͡ʃɪpəkn̪äː
चिपचिपा	t͡ʃɪpt͡ʃɪpäː
चिमटा	t͡ʃɪ̃mʈäː
चिमनी	t͡ʃɪ̃mn̪iː
चिरंजीव	t͡ʃɪɾə̃n̪d͡ʒiːʋ
चिरस्थायित्व	t͡ʃɪɾs̪t̪ʰäːjɪt̪wᵊ
चिरस्थायी	t͡ʃɪɾs̪t̪ʰäːjiː
चिराग़	t͡ʃɪɾäːɡ
चिराग़	t͡ʃɪɾäːɣ
चिलम	t͡ʃɪl̪ə̃m
चिलवन	t͡ʃɪl̪ʋə̃n̪
चिली	t͡ʃɪl̪iː
चींटा	t͡ʃĩːʈäː
चीख़ना	t͡ʃiːkʰn̪äː
चीख़ना	t͡ʃiːxn̪äː
चीज़बस्त	t͡ʃiːd͡ʒbəs̪t̪
चीज़बस्त	t͡ʃiːzbəs̪t̪
चीता	t͡ʃiːt̪äː
चीन	t͡ʃĩːn̪
चीना	t͡ʃiːn̪äː
चीनिया	t͡ʃiːn̪ijäː
चीनी	t͡ʃiːn̪iː
चीरना	t͡ʃiːɾn̪äː
चील	t͡ʃiːl̪
चीला	t͡ʃiːl̪äː
चुंबक	t͡ʃʊ̃mbək
चुंबकत्व	t͡ʃʊ̃mbəkət̪wᵊ
चुंबकीय	t͡ʃʊ̃mbəkiːjᵊ
चुंबन	t͡ʃʊ̃mbə̃n̪
चुकंदर	t͡ʃʊkə̃n̪d̪əɾ
चुकंदर	t͡ʃʊqə̃n̪d̪əɾ
चुकना	t͡ʃʊkn̪äː
चुक़ंदर	t͡ʃʊkə̃n̪d̪əɾ
चुक़ंदर	t͡ʃʊqə̃n̪d̪əɾ
चुक़न्दर	t͡ʃʊkə̃n̪d̪əɾ
चुक़न्दर	t͡ʃʊqə̃n̪d̪əɾ
चुकाना	t͡ʃʊkäːn̪äː
चुगना	t͡ʃʊɡn̪äː
चुटकुला	t͡ʃʊʈkʊl̪äː
चुड़ैल	t͡ʃʊɽɛːl̪
चुदना	t͡ʃʊd̪̚n̪äː
चुदवाना	t͡ʃʊd̪wäːn̪äː
चुदाना	t͡ʃʊd̪äːn̪äː
चुनाव	t͡ʃʊn̪äːʋ
चुनौती	t͡ʃʊn̪ɔːt̪iː
चुपचाप	t͡ʃʊpt͡ʃäːp
चुपड़ना	t͡ʃʊpəɽn̪äː
चुप्पी	t͡ʃʊp̚piː
चुभना	t͡ʃʊbʱn̪äː
चुम्मा	t͡ʃʊ̃mmäː
चुलबुल	t͡ʃʊl̪bʊl̪
चुल्ल	t͡ʃʊl̪l̪
चुसकी	t͡ʃʊs̪kiː
चुसना	t͡ʃʊs̪n̪äː
चूकना	t͡ʃuːkn̪äː
चूज़ा	t͡ʃuːd͡ʒäː
चूज़ा	t͡ʃuːzäː
चूतिया	t͡ʃuːt̪ijäː
चूना	t͡ʃuːn̪äː
चूमना	t͡ʃũːmn̪äː
चूल्हा	t͡ʃuːl̪ɦäː
चूहा	t͡ʃuːɦäː
चेचेन	t͡ʃeːt͡ʃẽːn̪
चेतना	t͡ʃeːt̪̚n̪äː
चेताना	t͡ʃeːt̪äːn̪äː
चेतावनी	t͡ʃeːt̪äːʋn̪iː
चेना	t͡ʃeːn̪äː
चेन्नई	t͡ʃẽːn̪n̪əiː
चेरापूंजी	t͡ʃeːɾäːpũːn̪d͡ʒiː
चेला	t͡ʃeːl̪äː
चेहरा	t͡ʃeːɦɾäː
चैन	t͡ʃɛ̃ːn̪
चॉकलेट	t͡ʃɔkl̪eːʈ
चॉकलेट	t͡ʃɔkəl̪eːʈ
चोंच	t͡ʃõːn̪t͡ʃ
चोखा	t͡ʃoːkʰäː
चोग़ा	t͡ʃoːɡäː
चोग़ा	t͡ʃoːɣäː
चोदना	t͡ʃoːd̪̚n̪äː
चोरना	t͡ʃoːɾn̪äː
चोल	t͡ʃoːl̪
चोला	t͡ʃoːl̪äː
चोली	t͡ʃoːl̪iː
चौंकना	t͡ʃɔ̃ːŋkn̪äː
चौंकाना	t͡ʃɔ̃ːŋkäːn̪äː
चौंतीस	t͡ʃɔ̃ːn̪t̪iːs̪
चौंसठ	t͡ʃɔ̃ːn̪s̪əʈʰ
चौकस	t͡ʃɔːkəs̪
चौका	t͡ʃɔːkäː
चौकीदार	t͡ʃɔːkiːd̪äːɾ
चौड़ा	t͡ʃɔːɽaː
चौड़ाई	t͡ʃɔːɽäːiː
चौताल	t͡ʃɔːt̪äːl̪
चौथा	t͡ʃɔːt̪ʰäː
चौथाई	t͡ʃɔːt̪ʰäːiː
चौपाई	t͡ʃɔːpäːiː
चौबीस	t͡ʃɔːbiːs̪
चौरानवे	t͡ʃɔːɾä̃ːn̪weː
चौरासी	t͡ʃɔːɾäːs̪iː
चौराहा	t͡ʃɔːɾäːɦäː
चौवन	t͡ʃə̯uʋə̃n̪
चौहत्तर	t͡ʃɔːɦət̪̚t̪əɾ
च्यवनप्राश	t͡ʃjəʋə̃n̪pɾäːʃ
च्वॉइस	t͡ʃʋɔɪs̪
छंटना	t͡ʃʰə̃ɳʈn̪äː
छंद	t͡ʃʰə̃n̪d̪
छक्का	t͡ʃʰək̚käː
छटपटाना	t͡ʃʰəʈpəʈäːn̪äː
छटा	t͡ʃʰəʈäː
छठवाँ	t͡ʃʰəʈʰʋä̃ː
छत्तीस	t͡ʃʰət̪̚t̪iːs̪
छत्तीसगढ़	t͡ʃʰət̪̚t̪iːs̪ɡəɽʱ
छद्मनाम	t͡ʃʰəd̪mən̪ä̃ːm
छन	t͡ʃʰə̃n̪
छननी	t͡ʃʰə̃n̪n̪iː
छप्पन	t͡ʃʰəp̚pə̃n̪
छब्बीस	t͡ʃʰəb̚biːs̪
छब्बीस	t͡ʃʰəb̚bɪs̪
छमाही	t͡ʃʰəmäːɦiː
छरहरा	t͡ʃʰəɾɛɦɾäː
छर्रा	t͡ʃʰəɾɾäː
छल	t͡ʃʰəl̪
छलकना	t͡ʃʰəl̪əkn̪äː
छलना	t͡ʃʰəl̪n̪äː
छलाँग	t͡ʃʰəl̪ä̃ːŋɡ
छलाँगना	t͡ʃʰəl̪ä̃ːŋɡn̪äː
छलावा	t͡ʃʰəl̪äːʋäː
छलिया	t͡ʃʰəl̪ijäː
छली	t͡ʃʰəl̪iː
छाँव	t͡ʃʰä̃ːʋ
छांटना	t͡ʃʰä̃ːʈn̪äː
छाई	t͡ʃʰäːiː
छाछ	t͡ʃʰäːt͡ʃʰ
छाती	t͡ʃʰäːt̪iː
छात्र	t͡ʃʰäːt̪ɾᵊ
छात्रवृत्ति	t͡ʃʰäːt̪ɾəʋɾɪt̪̚t̪iː
छात्रसंघ	t͡ʃʰäːt̪ɾəs̪ə̃ŋɡʱ
छात्रा	t͡ʃʰäːt̪ɾäː
छात्रावास	t͡ʃʰäːt̪ɾäːʋäːs̪
छानना	t͡ʃʰä̃ːn̪n̪äː
छाप	t͡ʃʰäːp
छापशाला	t͡ʃʰäːpʃäːl̪äː
छापा	t͡ʃʰäːpäː
छापाख़ाना	t͡ʃʰäːpäːkʰäːn̪äː
छापाख़ाना	t͡ʃʰäːpäːxäːn̪äː
छापामार	t͡ʃʰäːpäːmäːɾ
छापाशाला	t͡ʃʰäːpäːʃäːl̪äː
छापेख़ाना	t͡ʃʰäːpeːkʰäːn̪äː
छापेख़ाना	t͡ʃʰäːpeːxäːn̪äː
छाया	t͡ʃʰäːjäː
छायाकार	t͡ʃʰäːjäːkäːɾ
छायावाद	t͡ʃʰäːjäːʋäːd̪
छाल	t͡ʃʰäːl̪
छाला	t͡ʃʰäːl̪äː
छावनी	t͡ʃʰäːʋn̪iː
छिटकना	t͡ʃʰɪʈəkn̪äː
छिड़काव	t͡ʃʰɪɽkäːʋ
छितराना	t͡ʃʰɪt̪ɾäːn̪äː
छिन	t͡ʃʰɪ̃n̪
छिपकली	t͡ʃʰɪpkəl̪iː
छिपाना	t͡ʃʰɪpäːn̪äː
छियानवे	t͡ʃʰijä̃ːn̪weː
छियालीस	t͡ʃʰijäːl̪iːs̪
छियासठ	t͡ʃʰijäːs̪əʈʰ
छियासी	t͡ʃʰijäːs̪iː
छिलका	t͡ʃʰɪl̪käː
छिहत्तर	t͡ʃʰɪɦət̪̚t̪əɾ
छीनाझपटी	t͡ʃʰiːn̪äːd͡ʒʱəpʈiː
छुआछूत	t͡ʃʰʊäːt͡ʃʰuːt̪
छुट्टी	t͡ʃʰʊʈ̚ʈiː
छुपना	t͡ʃʰʊpn̪äː
छुपा	t͡ʃʰʊpäː
छुपाना	t͡ʃʰʊpäːn̪äː
छुरा	t͡ʃʰʊɾäː
छूटना	t͡ʃʰuːʈn̪äː
छूना	t͡ʃʰuːn̪äː
छेड़छाड़	t͡ʃʰeːɽt͡ʃʰäːɽ
छेदना	t͡ʃʰeːd̪̚n̪äː
छेना	t͡ʃʰeːn̪äː
छोग्याल	t͡ʃʰoːɡjäːl̪
छोटा	t͡ʃʰoːʈäː
छोड़ना	t͡ʃʰoːɽn̪äː
छोरा	t͡ʃʰoːɾäː
छोला	t͡ʃʰoːl̪äː
छोले	t͡ʃʰoːl̪eː
छौंक	t͡ʃʰɔ̃ːŋk
जँभाई	d͡ʒə̃mbʱäːiː
जंग	d͡ʒə̃ŋɡ
जंगजू	d͡ʒə̃ŋɡd͡ʒuː
जंगम	d͡ʒə̃ŋɡə̃m
जंगल	d͡ʒə̃ŋɡəl̪
जंगी	d͡ʒə̃ŋɡiː
जंतर	d͡ʒə̃n̪t̪əɾ
जंभ	d͡ʒə̃mbʱ
जकार्ता	d͡ʒəkäːɾt̪äː
जगमगाना	d͡ʒəɡməɡäːn̪äː
जगह	d͡ʒəɡäː
जगाना	d͡ʒəɡäːn̪äː
जज़ा	d͡ʒəd͡ʒäː
जज़ा	d͡ʒəzäː
जज़ीरा	d͡ʒəd͡ʒiːɾäː
जज़ीरा	d͡ʒəziːɾäː
जज़्बात	d͡ʒəd͡ʒbäːt̪
जज़्बात	d͡ʒəzbäːt̪
जज्बा	d͡ʒəd͡ʒbäː
जज्बा	d͡ʒəzbäː
जटा	d͡ʒəʈäː
जटिल	d͡ʒəʈɪl̪
जड़त्व	d͡ʒəɽət̪wᵊ
जताना	d͡ʒət̪äːn̪äː
जन	d͡ʒə̃n̪
जनक	d͡ʒən̪ək
जनकपुर	d͡ʒən̪əkpʊɾ
जनजाति	d͡ʒə̃n̪d͡ʒäːt̪iː
जनतंत्र	d͡ʒə̃n̪t̪ə̃n̪t̪ɾᵊ
जनता	d͡ʒə̃n̪t̪äː
जनना	d͡ʒə̃n̪n̪äː
जननी	d͡ʒə̃n̪n̪iː
जनपद	d͡ʒə̃n̪pəd̪
जनप्रतिनिधि	d͡ʒə̃n̪pɾət̪ɪn̪ɪd̪ʱiː
जनप्रतिनिधित्व	d͡ʒə̃n̪pɾət̪ɪn̪ɪd̪ʱɪt̪wᵊ
जनभाषा	d͡ʒə̃n̪bʱäːʃäː
जनमतसंग्रह	d͡ʒə̃n̪mət̪s̪ə̃ŋɡɾəɦ
जनरल	d͡ʒə̃n̪ɾəl̪
जनवरी	d͡ʒə̃n̪wəɾiː
जनवादी	d͡ʒə̃n̪wäːd̪iː
जनसंख्या	d͡ʒə̃n̪s̪ə̃ŋkʰjäː
जनसांख्यिकी	d͡ʒə̃n̪s̪ä̃ːkʰjɪkiː
जनसेवक	d͡ʒə̃n̪s̪eːʋək
जनाज़ा	d͡ʒən̪äːd͡ʒäː
जनाज़ा	d͡ʒən̪äːzäː
जनाधार	d͡ʒən̪äːd̪ʱäːɾ
जनाब	d͡ʒən̪äːb
जनूब	d͡ʒən̪uːb
जनूबी	d͡ʒən̪uːbiː
जनेऊ	d͡ʒən̪eːuː
जन्नत	d͡ʒə̃n̪n̪ət̪
जन्म	d͡ʒə̃n̪mᵊ
जन्मदिन	d͡ʒən̪ə̃md̪ɪ̃n̪
जन्मदिन	d͡ʒə̃n̪md̪ɪ̃n̪
जन्मना	d͡ʒə̃n̪mn̪äː
जन्मभूमि	d͡ʒə̃n̪mᵊbʱuːmiː
जपना	d͡ʒəpn̪äː
जबड़ा	d͡ʒəbɽäː
जबलपुर	d͡ʒəbəl̪pʊɾ
जमना	d͡ʒə̃mn̪äː
जमवाना	d͡ʒə̃mwäːn̪äː
जमशेदपुर	d͡ʒə̃mʃeːd̪pʊɾ
जमाअत	d͡ʒəmäːət̪
जमाई	d͡ʒəmäːiː
जमाकर्ता	d͡ʒəmäːkəɾt̪äː
जमाख़ोरी	d͡ʒəmäːkʰoːɾiː
जमाख़ोरी	d͡ʒəmäːxoːɾiː
जमात	d͡ʒəmäːt̪
जमाना	d͡ʒəmäːn̪äː
जमाना	zəmäːn̪äː
जमाव	d͡ʒəmäːʋ
जमीन	d͡ʒəmĩːn̪
जमीन	zəmĩːn̪
जमैका	d͡ʒəmɛːkäː
जम्मू	d͡ʒə̃mmuː
जम्हूरियत	d͡ʒə̃mɦuːɾijət̪
जयकार	d͡ʒəjkäːɾ
जर्मन	d͡ʒəɾmə̃n̪
जर्मनी	d͡ʒəɾmən̪iː
जर्राह	d͡ʒəɾɾäːɦ
जल	d͡ʒəl̪
जलचालित	d͡ʒəl̪t͡ʃäːl̪ɪt̪
जलज	d͡ʒəl̪əd͡ʒ
जलजनित	d͡ʒəl̪d͡ʒən̪ɪt̪
जलजमाव	d͡ʒəl̪d͡ʒəmäːʋ
जलना	d͡ʒəl̪n̪äː
जलपान	d͡ʒəl̪pä̃ːn̪
जलमार्ग	d͡ʒəl̪mäːɾɡ
जलवा	d͡ʒəl̪ʋäː
जलसा	d͡ʒəl̪s̪äː
जलसिंह	d͡ʒəl̪s̪ɪ̃ɦ
जलाऊ	d͡ʒəl̪äːuː
जलाना	d͡ʒəl̪äːn̪äː
जलारेख	d͡ʒəl̪äːɾeːkʰ
जलाल	d͡ʒəl̪äːl̪
जलालाबाद	d͡ʒəl̪äːl̪äːbäːd̪
जलाशय	d͡ʒəl̪äːʃəj
जलित	d͡ʒəl̪ɪt̪
जलीय	d͡ʒəl̪iːjᵊ
जलेबी	d͡ʒəl̪eːbiː
जल्द	d͡ʒəl̪d̪
जल्दबाज़ी	d͡ʒəl̪d̪bäːd͡ʒiː
जल्दबाज़ी	d͡ʒəl̪d̪bäːziː
जल्दी	d͡ʒəl̪d̪iː
जल्लाद	d͡ʒəl̪l̪äːd̪
जवा	d͡ʒəʋäː
जवान	d͡ʒəʋä̃ːn̪
जवानी	d͡ʒəʋäːn̪iː
जवाब	d͡ʒəʋäːb
जवार	d͡ʒəʋäːɾ
जवारी	d͡ʒəʋäːɾiː
जशन	d͡ʒəʃə̃n̪
जस्ता	d͡ʒəs̪t̪äː
जहन्नम	d͡ʒɛɦɛ̃n̪n̪ə̃m
जहन्नुम	d͡ʒɛɦɛ̃n̪n̪ʊ̃m
जहर	d͡ʒɛɦɛɾ
जहर	zɛɦɛɾ
जहाँगीर	d͡ʒəɦä̃ːŋɡiːɾ
जहाज	d͡ʒəɦäːd͡ʒ
जहाज	d͡ʒəɦäːz
जहाज़	d͡ʒəɦäːd͡ʒ
जहाज़	d͡ʒəɦäːz
जहान	d͡ʒəɦä̃ːn̪
ज़ंजीर	d͡ʒə̃n̪d͡ʒiːɾ
ज़ंजीर	zə̃n̪d͡ʒiːɾ
ज़कात	d͡ʒəkäːt̪
ज़कात	zəkäːt̪
ज़ख़ीरा	d͡ʒəkʰiːɾäː
ज़ख़ीरा	zəxiːɾäː
ज़नाना	d͡ʒən̪äːn̪äː
ज़नाना	zən̪äːn̪äː
ज़बान	d͡ʒəbä̃ːn̪
ज़बान	zəbä̃ːn̪
ज़बानी	d͡ʒəbäːn̪iː
ज़बानी	zəbäːn̪iː
ज़मानत	d͡ʒəmäːn̪ət̪
ज़मानत	zəmäːn̪ət̪
ज़माना	d͡ʒəmäːn̪äː
ज़माना	zəmäːn̪äː
ज़मीन	d͡ʒəmĩːn̪
ज़मीन	zəmĩːn̪
ज़मीनी	d͡ʒəmiːn̪iː
ज़मीनी	zəmiːn̪iː
ज़रिया	d͡ʒəɾijäː
ज़रिया	zəɾijäː
ज़र्रा	d͡ʒəɾɾäː
ज़र्रा	zəɾɾäː
ज़लज़ला	d͡ʒəl̪d͡ʒəl̪äː
ज़लज़ला	zəl̪zəl̪äː
ज़हर	d͡ʒɛɦɛɾ
ज़हर	zɛɦɛɾ
ज़हरीला	d͡ʒɛɦɾiːl̪äː
ज़हरीला	zɛɦɾiːl̪äː
ज़हरीली	d͡ʒɛɦɾiːl̪iː
ज़हरीली	zɛɦɾiːl̪iː
ज़ात	d͡ʒäːt̪
ज़ात	zäːt̪
ज़ायक़ा	d͡ʒäːjkäː
ज़ायक़ा	zäːjqäː
ज़ाया	d͡ʒäːjäː
ज़ाया	zäːjäː
ज़ालिम	d͡ʒäːl̪ɪ̃m
ज़ालिम	zäːl̪ɪ̃m
ज़ाहिर	d͡ʒäːɦɪɾ
ज़ाहिर	zäːɦɪɾ
ज़िंदगी	d͡ʒɪ̃n̪d̪əɡiː
ज़िंदगी	zɪ̃n̪d̪əɡiː
ज़िंदा	d͡ʒɪ̃n̪d̪äː
ज़िंदा	zɪ̃n̪d̪äː
ज़िंदाबाद	d͡ʒɪ̃n̪d̪äːbäːd̪
ज़िंदाबाद	zɪ̃n̪d̪äːbäːd̪
ज़िंबाब्वे	d͡ʒɪ̃mbäːbweː
ज़िंबाब्वे	zɪ̃mbäːbweː
ज़िन्दगी	d͡ʒɪ̃n̪d̪əɡiː
ज़िन्दगी	zɪ̃n̪d̪əɡiː
ज़िम्बाब्वे	d͡ʒɪ̃mbäːbweː
ज़िम्बाब्वे	zɪ̃mbäːbweː
ज़िला	d͡ʒɪl̪äː
ज़िला	zɪl̪äː
ज़िलाधीश	d͡ʒɪl̪äːd̪ʱiːʃ
ज़िलाधीश	zɪl̪äːd̪ʱiːʃ
ज़ीना	d͡ʒiːn̪äː
ज़ीना	ziːn̪äː
ज़ीरा	d͡ʒiːɾäː
ज़ीरा	ziːɾäː
ज़ुकाम	d͡ʒʊkä̃ːm
ज़ुकाम	zʊkä̃ːm
ज़ुल्फ़	d͡ʒʊl̪pʰ
ज़ुल्फ़	zʊl̪f
ज़ुल्म	d͡ʒʊl̪m
ज़ुल्म	zʊl̪m
ज़ेहन	d͡ʒɛɦɛ̃n̪
ज़ेहन	zɛɦɛ̃n̪
ज़ैतून	d͡ʒɛːt̪ũːn̪
ज़ैतून	zɛːt̪ũːn̪
ज़ोरदार	d͡ʒoːɾd̪äːɾ
ज़ोरदार	zoːɾd̪äːɾ
ज़्यादती	d͡ʒjäːd̪ət̪iː
ज़्यादती	zjäːd̪ət̪iː
ज़्यादातर	d͡ʒjäːd̪äːt̪əɾ
ज़्यादातर	zjäːd̪äːt̪əɾ
जा	d͡ʒäː
जाँघ	d͡ʒä̃ːŋɡʱ
जाँघिया	d͡ʒä̃ːŋɡʱijäː
जाँच	d͡ʒä̃ːt͡ʃ
जाँचना	d͡ʒä̃ːt͡ʃn̪äː
जाँबाज़	d͡ʒä̃ːmbäːd͡ʒ
जाँबाज़	d͡ʒä̃ːmbäːz
जांघ	d͡ʒä̃ːŋɡʱ
जाएगा	d͡ʒäːeːɡäː
जागना	d͡ʒäːɡn̪äː
जागरूकता	d͡ʒäːɡɾuːkt̪äː
जाट	d͡ʒäːʈ
जाड़ा	d͡ʒäːɽäː
जाति	d͡ʒäːt̪iː
जातिगत	d͡ʒäːt̪ɪɡət̪
जातिवाद	d͡ʒäːt̪ɪʋäːd̪
जातिवादी	d͡ʒäːt̪iːʋäːd̪iː
जातीय	d͡ʒäːt̪iːjᵊ
जादू	d͡ʒäːd̪uː
जादूगर	d͡ʒäːd̪uːɡəɾ
जादूगरनी	d͡ʒäːd̪uːɡəɾn̪iː
जान	d͡ʒä̃ːn̪
जानकार	d͡ʒä̃ːn̪käːɾ
जानकारी	d͡ʒä̃ːn̪käːɾiː
जानना	d͡ʒä̃ːn̪n̪äː
जानबूझकर	d͡ʒä̃ːn̪buːd͡ʒʱkəɾ
जानलेवा	d͡ʒä̃ːn̪l̪eːʋäː
जानवर	d͡ʒä̃ːn̪wəɾ
जानवरो	d͡ʒä̃ːn̪wəɾoː
जानवरों	d͡ʒä̃ːn̪wəɾõː
जाना	d͡ʒäːn̪äː
जानी	d͡ʒäːn̪iː
जापान	d͡ʒäːpä̃ːn̪
जापानी	d͡ʒäːpäːn̪iː
जाम	d͡ʒä̃ːm
जामन	d͡ʒäːmə̃n̪
जामनी	d͡ʒä̃ːmn̪iː
जामाता	d͡ʒäːmäːt̪äː
जामुन	d͡ʒäːmʊ̃n̪
जायज़	d͡ʒäːjəd͡ʒ
जायज़	d͡ʒäːjəz
जायज़ा	d͡ʒäːjd͡ʒäː
जायज़ा	d͡ʒäːjzäː
जायदाद	d͡ʒäːjd̪äːd̪
जायफल	d͡ʒäːjpʰəl̪
जारक	d͡ʒäːɾək
जारी	d͡ʒäːɾiː
जाल	d͡ʒäːl̪
जालपृष्ठ	d͡ʒäːl̪pɾɪʂʈʰ
जाला	d͡ʒäːl̪äː
जावा	d͡ʒäːʋäː
जावित्री	d͡ʒäːʋɪt̪ɾiː
जासूस	d͡ʒäːs̪uːs̪
जासूसी	d͡ʒäːs̪uːs̪iː
जाहिल	d͡ʒäːɦɪl̪
जिंस	d͡ʒɪ̃n̪s̪
जिजीविषा	d͡ʒɪd͡ʒiːʋɪʃäː
जिज्ञासा	d͡ʒɪɡjäːs̪äː
जितना	d͡ʒɪt̪̚n̪äː
जिताना	d͡ʒɪt̪äːn̪äː
जिन	d͡ʒɪ̃n̪
जिनका	d͡ʒɪ̃n̪käː
जिना	d͡ʒɪn̪äː
जिना	zɪn̪äː
जिन्न	d͡ʒɪ̃n̪n̪ᵊ
जिन्हें	d͡ʒɪ̃n̪ɦẽː
जिन्होंने	d͡ʒɪ̃n̪ɦõːn̪n̪eː
जिमीकंद	d͡ʒɪmiːkə̃n̪d̪
जियरा	d͡ʒɪjɾäː
जिल्द	d͡ʒɪl̪d̪
जिस	d͡ʒɪs̪
जिसका	d͡ʒɪs̪käː
जिसको	d͡ʒɪs̪koː
जिसने	d͡ʒɪs̪n̪eː
जिसमें	d͡ʒɪs̪mẽː
जिससे	d͡ʒɪs̪s̪eː
जिसे	d͡ʒɪs̪eː
जीजा	d͡ʒiːd͡ʒäː
जीतना	d͡ʒiːt̪̚n̪äː
जीन	d͡ʒĩːn̪
जीना	d͡ʒiːn̪äː
जीरा	d͡ʒiːɾäː
जीवन	d͡ʒiːʋə̃n̪
जीवनी	d͡ʒiːʋn̪iː
जीवाश्म	d͡ʒiːʋäːʃmᵊ
जुआ	d͡ʒʊäː
जुआरी	d͡ʒʊäːɾiː
जुगनू	d͡ʒʊɡn̪uː
जुगलबंदी	d͡ʒʊɡəl̪bə̃n̪d̪iː
जुटाना	d͡ʒʊʈäːn̪äː
जुड़ना	d͡ʒʊɽn̪äː
जुड़वाँ	d͡ʒʊɽʋä̃ː
जुताई	d͡ʒʊt̪äːiː
जुदा	d͡ʒʊd̪äː
जुदाई	d͡ʒʊd̪äːiː
जुनहार	d͡ʒʊ̃n̪ɦäːɾ
जुनून	d͡ʒʊn̪ũːn̪
जुन्हाई	d͡ʒʊ̃n̪ɦäːiː
जुमला	d͡ʒʊ̃ml̪äː
जुमा	d͡ʒʊmäː
जुमेरात	d͡ʒʊmeːɾäːt̪
जुर्माना	d͡ʒʊɾmäːn̪äː
जुलना	d͡ʒʊl̪n̪äː
जुलाई	d͡ʒʊl̪äːiː
जुलूस	d͡ʒʊl̪uːs̪
जुस्तजू	d͡ʒʊs̪t̪əd͡ʒuː
जूझना	d͡ʒuːd͡ʒʱn̪äː
जूड़ा	d͡ʒuːɽäː
जूता	d͡ʒuːt̪äː
जून	d͡ʒũːn̪
जूलाई	d͡ʒuːl̪äːiː
जेठानी	d͡ʒeːʈʰäːn̪iː
जेद्दा	d͡ʒeːd̪̚d̪äː
जेल	d͡ʒeːl̪
जैकबाबाद	d͡ʒɛːkbäːbäːd̪
जैगुआर	d͡ʒɛːɡʊäːɾ
जैतून	d͡ʒɛːt̪ũːn̪
जैतून	zɛːt̪ũːn̪
जैसा	d͡ʒɛːs̪äː
जॉर्जिया	d͡ʒɔɾd͡ʒijäː
जॉर्डन	d͡ʒɔɾɖə̃n̪
जोंक	d͡ʒõːŋk
जोखना	d͡ʒoːkʰn̪äː
जोखिम	d͡ʒoːkʰɪ̃m
जोड़ना	d͡ʒoːɽn̪äː
जोतना	d͡ʒoːt̪̚n̪äː
जोबन	d͡ʒoːbə̃n̪
जोरदार	d͡ʒoːɾd̪äːɾ
जोरदार	zoːɾd̪äːɾ
जोर्जिया	d͡ʒoːɾd͡ʒijäː
जोशीला	d͡ʒoːʃiːl̪äː
जोहना	d͡ʒoːɦn̪äː
जोहानसबर्ग	d͡ʒoːɦäːn̪əs̪bəɾɡ
ज्ञात	ɡjäːt̪
ज्ञाता	ɡjäːt̪äː
ज्ञातृत्व	ɡjäːt̪ɾɪt̪wᵊ
ज्ञान	ɡjä̃ːn̪
ज्ञानकोष	ɡjä̃ːn̪koːʃ
ज्ञानमीमांसा	ɡjä̃ːn̪miːmä̃ːn̪s̪äː
ज्ञानवर्धन	ɡjä̃ːn̪wəɾd̪ʱə̃n̪
ज्ञानी	ɡjäːn̪iː
ज्यादा	d͡ʒjäːd̪äː
ज्यादा	zjäːd̪äː
ज्योतिरिंगण	d͡ʒjoːt̪ɪɾɪ̃ŋɡə̃ɳ
ज्योतिष	d͡ʒjoːt̪ɪʃ
ज्वार	d͡ʒʋäːɾ
ज्वालामुखी	d͡ʒʋäːl̪äːmʊkʰiː
झंझट	d͡ʒʱə̃n̪d͡ʒʱəʈ
झंडा	d͡ʒʱə̃ɳɖäː
झक्कड़	d͡ʒʱək̚kəɽ
झगड़ना	d͡ʒʱəɡəɽn̪äː
झगड़ा	d͡ʒʱəɡɽäː
झगड़ालू	d͡ʒʱəɡɽäːl̪uː
झटका	d͡ʒʱəʈkäː
झनझन	d͡ʒʱə̃n̪d͡ʒʱə̃n̪
झमेला	d͡ʒʱəmeːl̪äː
झरना	d͡ʒʱəɾn̪äː
झरोखा	d͡ʒʱəɾoːkʰäː
झलना	d͡ʒʱəl̪n̪äː
झा	d͡ʒʱäː
झाँसी	d͡ʒʱä̃ːs̪iː
झाग	d͡ʒʱäːɡ
झाड़	d͡ʒʱäːɽ
झाड़ी	d͡ʒʱäːɽiː
झाड़ू	d͡ʒʱäːɽuː
झापड़	d͡ʒʱäːpəɽ
झामुमो	d͡ʒʱäːmʊmoː
झारखंड	d͡ʒʱäːɾkʰə̃ɳɖ
झारखण्ड	d͡ʒʱäːɾkʰə̃ɳɖ
झालर	d͡ʒʱäːl̪əɾ
झिझकना	d͡ʒʱɪd͡ʒʱəkn̪äː
झींगा	d͡ʒʱĩːŋɡäː
झील	d͡ʒʱiːl̪
झुकना	d͡ʒʱʊkn̪äː
झुकाव	d͡ʒʱʊkäːʋ
झुठलाना	d͡ʒʱʊʈʰl̪äːn̪äː
झुमका	d͡ʒʱʊ̃mkäː
झुर्रियाँ	d͡ʒʱʊɾɾijä̃ː
झुलसना	d͡ʒʱʊl̪əs̪n̪äː
झूठा	d͡ʒʱuːʈʰäː
झूम	d͡ʒʱũːm
झूलना	d͡ʒʱuːl̪n̪äː
झेलना	d͡ʒʱeːl̪n̪äː
झोंकना	d͡ʒʱõːŋkn̪äː
झोंका	d͡ʒʱõːŋkäː
झोंपड़ा	d͡ʒʱõːmpɽäː
झोली	d͡ʒʱoːl̪iː
टँगना	ʈə̃ŋɡn̪äː
टंकक	ʈə̃ŋkək
टंकण	ʈə̃ŋkə̃ɳ
टकराना	ʈəkɾäːn̪äː
टकराव	ʈəkɾäːʋ
टक्कर	ʈək̚kəɾ
टखना	ʈəkʰn̪äː
टटोलना	ʈəʈoːl̪n̪äː
टट्टी	ʈəʈ̚ʈiː
टनेल	ʈən̪eːl̪
टपकना	ʈəpəkn̪äː
टमटम	ʈə̃mʈə̃m
टर्मिनल	ʈəɾmɪn̪əl̪
टलना	ʈəl̪n̪äː
टहलना	ʈɛɦɛl̪n̪äː
टाँग	ʈä̃ːŋɡ
टाँगना	ʈä̃ːŋɡn̪äː
टांकण	ʈä̃ːkə̃ɳ
टांग	ʈä̃ːŋɡ
टापना	ʈäːpn̪äː
टापू	ʈäːpuː
टिंडा	ʈɪ̃ɳɖäː
टिंडिश	ʈɪ̃ɳɖɪʃ
टिकना	ʈɪkn̪äː
टिकाऊ	ʈɪkäːuː
टिकाऊपन	ʈɪkäːuːpə̃n̪
टिक्का	ʈɪk̚käː
टिड्डा	ʈɪɖ̚ɖäː
टिड्डी	ʈɪɖ̚ɖiː
टिण्डा	ʈɪ̃ɳɖäː
टिप्पणी	ʈɪp̚pəɳiː
टिमटिमाना	ʈɪ̃mʈɪmäːn̪äː
टीका	ʈiːkäː
टीकाकरण	ʈiːkäːkəɾə̃ɳ
टीम	ʈĩːm
टीस	ʈiːs̪
टुकड़ा	ʈʊkɽäː
टूटना	ʈuːʈn̪äː
टूथपेस्ट	ʈuːt̪ʰpeːs̪ʈ
टूर्नामेंट	ʈuːɾn̪äːmẽːɳʈ
टेकना	ʈeːkn̪äː
टेढ़ा	ʈeːɽʱäː
टेढ़ापन	ʈeːɽʱäːpə̃n̪
टेबल	ʈeːbəl̪
टेलिफ़ोन	ʈeːl̪ɪfõːn̪
टेलिफ़ोन	ʈeːl̪ɪpʰõːn̪
टेलिफोन	ʈeːl̪ɪfõːn̪
टेलिफोन	ʈeːl̪ɪpʰõːn̪
टेलिविजन	ʈeːl̪ɪʋɪd͡ʒə̃n̪
टेलिविजन	ʈeːl̪ɪʋɪzə̃n̪
टेलिविज़न	ʈeːl̪ɪʋɪd͡ʒə̃n̪
टेलिविज़न	ʈeːl̪ɪʋɪzə̃n̪
टेलीफ़ोन	ʈeːl̪iːfõːn̪
टेलीफ़ोन	ʈeːl̪iːpʰõːn̪
टेलीफोन	ʈeːl̪iːfõːn̪
टेलीफोन	ʈeːl̪iːpʰõːn̪
टेलीविज़न	ʈeːl̪iːʋɪd͡ʒə̃n̪
टेलीविज़न	ʈeːl̪iːʋɪzə̃n̪
टैंकर	ʈɛ̃ːŋkəɾ
टैक्स	ʈɛːks̪
टैक्सी	ʈɛːks̪iː
टोकना	ʈoːkn̪äː
टोकरा	ʈoːkɾäː
टोना	ʈoːn̪äː
टोरंटो	ʈoːɾə̃ɳʈoː
टोली	ʈoːl̪iː
टोस्ट	ʈoːs̪ʈ
ट्यूनिशिया	ʈjuːn̪ɪʃijäː
ट्रंप	ʈɾə̃mp
ट्राइटियम	ʈɾäːɪʈijə̃m
ट्रेन	ʈɾẽːn̪
ट्वीट	ʈwiːʈ
ठंड	ʈʰə̃ɳɖ
ठंडक	ʈʰə̃ɳɖək
ठंडा	ʈʰə̃ɳɖäː
ठकुराई	ʈʰəkʊɾäːiː
ठठेरा	ʈʰəʈʰeːɾäː
ठपना	ʈʰəpn̪äː
ठहरना	ʈʰɛɦɛɾn̪äː
ठहराना	ʈʰɛɦɾäːn̪äː
ठहराव	ʈʰɛɦɾäːʋ
ठहाका	ʈʰəɦäːkäː
ठाणे	ʈʰäːɳeː
ठिंगना	ʈʰɪ̃ŋɡn̪äː
ठिकाना	ʈʰɪkäːn̪äː
ठिठुरना	ʈʰɪʈʰʊɾn̪äː
ठुकराना	ʈʰʊkɾäːn̪äː
ठुमकना	ʈʰʊməkn̪äː
ठूँसना	ʈʰũːs̪n̪äː
ठेंगा	ʈʰẽːŋɡäː
ठेका	ʈʰeːkäː
ठेकुआ	ʈʰeːkʊäː
ठेकेदार	ʈʰeːkeːd̪äːɾ
ठेलना	ʈʰeːl̪n̪äː
ठेला	ʈʰeːl̪äː
ठोकना	ʈʰoːkn̪äː
ठोस	ʈʰoːs̪
डंठल	ɖə̃ɳʈʰəl̪
डंडा	ɖə̃ɳɖäː
डकार	ɖəkäːɾ
डबलिन	ɖəbl̪ɪ̃n̪
डमरू	ɖə̃mɾuː
डरबन	ɖəɾbə̃n̪
डसना	ɖəs̪n̪äː
डाइनोसर	ɖäːɪn̪oːs̪əɾ
डाउनलोड	ɖäːʊ̃n̪l̪oːɖ
डाक	ɖäːk
डाकख़ाना	ɖäːkxäːn̪äː
डाकख़ाना	ɖäːk̚kʰäːn̪äː
डाकघर	ɖäːkɡʱəɾ
डाकू	ɖäːkuː
डाक्टर	ɖäːkʈəɾ
डायनासोर	ɖäːjn̪äːs̪oːɾ
डायनोसोर	ɖäːjn̪oːs̪oːɾ
डायरी	ɖäːjəɾiː
डायरी	ɖäːjɾiː
डार्विन	ɖäːɾʋɪ̃n̪
डाल	ɖäːl̪
डालना	ɖäːl̪n̪äː
डिंभ	ɖɪ̃mbʱ
डिक्की	ɖɪk̚kiː
डिजिटल	ɖɪd͡ʒɪʈəl̪
डिजिटलीकृत	ɖɪd͡ʒɪʈəl̪iːkɾɪt̪
डिब्बा	ɖɪb̚bäː
डिमांड	ɖɪmä̃ːɳɖ
डिल्डो	ɖɪl̪ɖoː
डीज़ल	ɖiːd͡ʒəl̪
डीज़ल	ɖiːzəl̪
डील	ɖiːl̪
डुबोना	ɖʊboːn̪äː
डुलना	ɖʊl̪n̪äː
डूंगर	ɖũːŋɡəɾ
डेटा	ɖeːʈäː
डेनमार्क	ɖẽːn̪mäːɾk
डेरा	ɖeːɾäː
डॉलर	ɖɔl̪əɾ
डोनट	ɖoːn̪əʈ
डोलना	ɖoːl̪n̪äː
डोला	ɖoːl̪äː
डोली	ɖoːl̪iː
ढंग	ɖʱə̃ŋɡ
ढकना	ɖʱəkn̪äː
ढलना	ɖʱəl̪n̪äː
ढाँचा	ɖʱä̃ːt͡ʃäː
ढांचा	ɖʱä̃ːt͡ʃäː
ढाई	ɖʱäːiː
ढाका	ɖʱäːkäː
ढाबा	ɖʱäːbäː
ढाल	ɖʱäːl̪
ढालना	ɖʱäːl̪n̪äː
ढिशूम	ɖʱɪʃũːm
ढील	ɖʱiːl̪
ढूँढना	ɖʱũːɳɖʱn̪äː
ढूँढ़ना	ɖʱũːɽʱn̪äː
ढूंढ	ɖʱũːɳɖʱ
ढेला	ɖʱeːl̪äː
ढोंग	ɖʱõːŋɡ
ढोकला	ɖʱoːkl̪äː
ढोका	ɖʱoːkäː
ढोटा	ɖʱoːʈäː
ढोना	ɖʱoːn̪äː
ढोल	ɖʱoːl̪
तंग	t̪ə̃ŋɡ
तंज़ानिया	t̪ə̃d͡ʒäːn̪ijäː
तंज़ानिया	t̪ə̃zäːn̪ijäː
तंज़ीम	t̪ə̃d͡ʒĩːm
तंज़ीम	t̪ə̃zĩːm
तंदुरुस्त	t̪ə̃n̪d̪ʊɾʊs̪t̪
तंदुरुस्ती	t̪ə̃n̪d̪ʊɾʊs̪t̪iː
तंदूरी	t̪ə̃n̪d̪uːɾiː
तंबाकु	t̪ə̃mbäːkuː
तंबू	t̪ə̃mbuː
तंबोल	t̪ə̃mboːl̪
तंबोला	t̪ə̃mboːl̪äː
तकरार	t̪əkɾäːɾ
तकलीफ़	t̪əkl̪iːf
तकलीफ़	t̪əkl̪iːpʰ
तकलीफ़देह	t̪əkl̪iːfd̪eːɦ
तकलीफ़देह	t̪əkl̪iːpʰd̪eːɦ
तकल्लुफ़	t̪əkəl̪l̪ʊf
तकल्लुफ़	t̪əkəl̪l̪ʊpʰ
तक़रीबन	t̪əkɾiːbə̃n̪
तक़रीबन	t̪əqɾiːbə̃n̪
तक़सीम	t̪əks̪ĩːm
तक़सीम	t̪əqs̪ĩːm
तक़ाज़ा	t̪əkäːd͡ʒäː
तक़ाज़ा	t̪əqäːzäː
तकिया	t̪əkijäː
तक्षशिला	t̪əkʃəʃɪl̪äː
तख़लिया	t̪əkʰl̪ijäː
तख़लिया	t̪əxl̪ijäː
तख़ल्लुस	t̪əkʰəl̪l̪ʊs̪
तख़ल्लुस	t̪əxəl̪l̪ʊs̪
तख़्तापलट	t̪əkʰt̪äːpəl̪əʈ
तख़्तापलट	t̪əxt̪äːpəl̪əʈ
तगड़ा	t̪əɡɽäː
तग़ाफ़ुल	t̪əɡäːpʰʊl̪
तग़ाफ़ुल	t̪əɣäːfʊl̪
तजना	t̪əd͡ʒn̪äː
तजुर्बा	t̪əd͡ʒʊɾbäː
तटस्थ	t̪əʈəs̪t̪ʰ
तटस्थीकरण	t̪əʈəs̪t̪ʰiːkəɾə̃ɳ
तड़का	t̪əɽkäː
तड़पना	t̪əɽəpn̪äː
तत्कालीन	t̪ət̪käːl̪ĩːn̪
तत्क्षण	t̪ət̪kʃə̃ɳ
तत्त्व	t̪ət̪̚t̪wᵊ
तत्परता	t̪ət̪pəɾt̪äː
तत्पश्चात्	t̪ət̪pəʃt͡ʃäːt̪
तत्व	t̪ət̪wᵊ
तत्वज्ञान	t̪ət̪wəɡjä̃ːn̪
तत्सम	t̪ət̪s̪ə̃m
तथा	t̪ət̪ʰäː
तथापि	t̪ət̪ʰäːpiː
तदुपरांत	t̪əd̪ʊpɾä̃ːn̪t̪
तन	t̪ə̃n̪
तनख़्वाह	t̪ə̃n̪kʰäːɦ
तनख़्वाह	t̪ə̃n̪kʰʋäːɦ
तनख़्वाह	t̪ə̃n̪xäːɦ
तनख़्वाह	t̪ə̃n̪xʋäːɦ
तनना	t̪ə̃n̪n̪äː
तनहाई	t̪ə̃n̪ɦäːiː
तना	t̪ən̪äː
तनाव	t̪ən̪äːʋ
तनावपूर्ण	t̪ən̪äːʋpuːɾɳ
तन्दूरी	t̪ə̃n̪d̪uːɾiː
तपना	t̪əpn̪äː
तपस्वी	t̪əpəs̪ʋiː
तबदील	t̪əbd̪iːl̪
तबला	t̪əbl̪äː
तबादला	t̪əbäːd̪l̪äː
तबाशीर	t̪əbäːʃiːɾ
तबाह	t̪əbäːɦ
तबाही	t̪əbäːɦiː
तबेला	t̪əbeːl̪äː
तमंचा	t̪əmə̃n̪t͡ʃäː
तमग़ा	t̪ə̃mɡäː
तमग़ा	t̪ə̃mɣäː
तमन्ना	t̪əmə̃n̪n̪äː
तमाचा	t̪əmäːt͡ʃäː
तमाम	t̪əmä̃ːm
तमिल	t̪əmɪl̪
तरंग	t̪əɾə̃ŋɡ
तरक़्क़ी	t̪əɾək̚kiː
तरकारी	t̪əɾkäːɾiː
तरक्की	t̪əɾək̚kiː
तरण	t̪əɾə̃ɳ
तरणक्रीड़ा	t̪əɾɳəkɾiːɽäː
तरणताल	t̪əɾə̃ɳt̪äːl̪
तरफ़दार	t̪əɾəfd̪äːɾ
तरफ़दार	t̪əɾəpʰd̪äːɾ
तरबूज़ा	t̪əɾbuːd͡ʒäː
तरबूज़ा	t̪əɾbuːzäː
तरल	t̪əɾəl̪
तरस्विनी	t̪əɾəs̪ʋɪn̪iː
तराई	t̪əɾäːiː
तराज़ू	t̪əɾäːd͡ʒuː
तराज़ू	t̪əɾäːzuː
तराना	t̪əɾäːn̪äː
तराशना	t̪əɾäːʃn̪äː
तराशा	t̪əɾäːʃäː
तरीक़ा	t̪əɾiːkäː
तरीक़ा	t̪əɾiːqäː
तरीका	t̪əɾiːkäː
तरीका	t̪əɾiːqäː
तरेरना	t̪əɾeːɾn̪äː
तरोताज़ा	t̪əɾoːt̪äːd͡ʒäː
तरोताज़ा	t̪əɾoːt̪äːzäː
तर्कशास्त्र	t̪əɾkʃäːs̪t̪ɾᵊ
तर्जनी	t̪əɾd͡ʒən̪iː
तर्जुमा	t̪əɾd͡ʒʊmäː
तर्जुमान	t̪əɾd͡ʒʊmä̃ːn̪
तल	t̪əl̪
तलक	t̪əl̪ək
तलना	t̪əl̪n̪äː
तलब	t̪əl̪əb
तलवा	t̪əl̪ʋäː
तलवार	t̪əl̪ʋäːɾ
तलहटी	t̪əl̪ɛɦʈiː
तला	t̪əl̪äː
तलाव	t̪əl̪äːʋ
तलाश	t̪əl̪äːʃ
तलाशी	t̪əl̪äːʃiː
तले	t̪əl̪eː
तल्ख़	t̪əl̪kʰ
तल्ख़	t̪əl̪x
तल्ख़ी	t̪əl̪kʰiː
तल्ख़ी	t̪əl̪xiː
तवारीख़	t̪əʋäːɾiːkʰ
तवारीख़	t̪əʋäːɾiːx
तशद्दुद	t̪əʃəd̪̚d̪ʊd̪
तसमा	t̪əs̪mäː
तसला	t̪əs̪l̪äː
तसल्ली	t̪əs̪əl̪l̪iː
तसव्वुर	t̪əs̪əʋʋʊɾ
तस्कर	t̪əs̪kəɾ
तस्करी	t̪əs̪kəɾiː
तस्दीक़	t̪əs̪d̪iːk
तस्दीक़	t̪əs̪d̪iːq
तस्वीर	t̪əs̪ʋiːɾ
तहज़ीब	t̪ɛɦd͡ʒiːb
तहज़ीब	t̪ɛɦziːb
तहत	t̪ɛɦɛt̪
तहरी	t̪ɛɦɾiː
तहलका	t̪ɛɦɛl̪käː
तहसील	t̪ɛɦs̪iːl̪
ता	t̪äː
ताँबा	t̪ä̃ːmbäː
ताइवान	t̪äːɪʋä̃ːn̪
ताई	t̪äːiː
ताउम्र	t̪äːʊ̃mɾᵊ
ताऊ	t̪äːuː
ताक	t̪äːk
ताकना	t̪äːkn̪äː
ताक़त	t̪äːkət̪
ताक़त	t̪äːqət̪
ताक़तवर	t̪äːkət̪wəɾ
ताक़तवर	t̪äːqət̪wəɾ
ताकि	t̪äːkiː
ताज	t̪äːd͡ʒ
ताजपोशी	t̪äːd͡ʒpoːʃiː
ताज़ा	t̪äːd͡ʒäː
ताज़ा	t̪äːzäː
ताजिकिस्तान	t̪äːd͡ʒɪkɪs̪t̪ä̃ːn̪
ताड़	t̪äːɽ
ताड़ी	t̪äːɽiː
तातार	t̪äːt̪äːɾ
तात्क्षणिक	t̪äːt̪kʃəɳɪk
तादाद	t̪äːd̪äːd̪
तान	t̪ä̃ːn̪
तानना	t̪ä̃ːn̪n̪äː
तानाशाह	t̪äːn̪äːʃäːɦ
ताप	t̪äːp
तापक्रम	t̪äːpəkɾə̃m
तापना	t̪äːpn̪äː
ताबीर	t̪äːbiːɾ
तामील	t̪äːmiːl̪
ताम्र	t̪ä̃ːmɾᵊ
ताया	t̪äːjäː
तारख़ाना	t̪äːɾkʰäːn̪äː
तारख़ाना	t̪äːɾxäːn̪äː
तारपीन	t̪äːɾpĩːn̪
तारा	t̪äːɾäː
तारीख़	t̪äːɾiːkʰ
तारीख़	t̪äːɾiːx
तारीफ	t̪äːɾiːf
तारीफ	t̪äːɾiːpʰ
तारीफ़	t̪äːɾiːf
तारीफ़	t̪äːɾiːpʰ
ताल	t̪äːl̪
तालमेल	t̪äːl̪meːl̪
तालव्य	t̪äːl̪əʋjə
तालाब	t̪äːl̪äːb
तालाबंदी	t̪äːl̪äːbə̃n̪d̪iː
तालिका	t̪äːl̪ɪkäː
तालिब	t̪äːl̪ɪb
तालियों	t̪äːl̪ijõː
तालीम	t̪äːl̪ĩːm
तालु	t̪äːl̪uː
ताल्लुक	t̪äːl̪l̪ʊk
ताल्लुक	t̪äːl̪l̪ʊq
ताल्लुक़	t̪äːl̪l̪ʊk
ताल्लुक़	t̪äːl̪l̪ʊq
तावीज़	t̪äːʋiːd͡ʒ
तावीज़	t̪äːʋiːz
ताश	t̪äːʃ
ताशकंद	t̪äːʃkə̃n̪d̪
तासीर	t̪äːs̪iːɾ
तिंदिश	t̪ɪ̃n̪d̪ɪʃ
तिकड़म	t̪ɪkɽə̃m
तिक्की	t̪ɪk̚kiː
तितली	t̪ɪt̪l̪iː
तिनका	t̪ɪ̃n̪käː
तिनसुकिया	t̪ɪ̃n̪s̪ʊkijäː
तिपहिया	t̪ɪpəiːjäː
तिपहिया	t̪ɪpəɦijäː
तिब्बत	t̪ɪb̚bət̪
तिब्बती	t̪ɪb̚bət̪iː
तिमाही	t̪ɪmäːɦiː
तिरंगा	t̪ɪɾə̃ŋɡäː
तिरछा	t̪ɪɾt͡ʃʰäː
तिरपन	t̪ɪɾpə̃n̪
तिरपाल	t̪ɪɾpäːl̪
तिरसठ	t̪ɪɾs̪əʈʰ
तिरस्कार	t̪ɪɾəs̪käːɾ
तिरानवे	t̪ɪɾä̃ːn̪weː
तिरासी	t̪ɪɾäːs̪iː
तिरुचिरापल्ली	t̪ɪɾʊt͡ʃɪɾäːpəl̪l̪iː
तिरुवनंतपुरम	t̪ɪɾʊʋən̪ə̃n̪t̪əpʊɾə̃m
तिल	t̪ɪl̪
तिलंगा	t̪ɪl̪ə̃ŋɡäː
तिलक	t̪ɪl̪ək
तिलचट्टा	t̪ɪl̪t͡ʃəʈ̚ʈäː
तिलहन	t̪ɪl̪ɦə̃n̪
तिल्ली	t̪ɪl̪l̪iː
तिहत्तर	t̪ɪɦət̪̚t̪əɾ
तीखा	t̪iːkʰäː
तीन	t̪ĩːn̪
तीरंदाज़	t̪iːɾə̃n̪d̪äːd͡ʒ
तीरंदाज़	t̪iːɾə̃n̪d̪äːz
तीरंदाज़ी	t̪iːɾə̃n̪d̪äːd͡ʒiː
तीरंदाज़ी	t̪iːɾə̃n̪d̪äːziː
तीली	t̪iːl̪iː
तीव्रता	t̪iːʋɾət̪äː
तीस	t̪iːs̪
तीसरा	t̪iːs̪ɾäː
तुंग	t̪ʊ̃ŋɡ
तुकांत	t̪ʊkä̃ːn̪t̪
तुक्का	t̪ʊk̚käː
तुग़लक़	t̪ʊɡl̪ək
तुग़लक़	t̪ʊɣl̪əq
तुफ़ंग	t̪ʊfə̃ŋɡ
तुफ़ंग	t̪ʊpʰə̃ŋɡ
तुम	t̪ʊ̃m
तुमने	t̪ʊ̃mn̪eː
तुम्हारा	t̪ʊ̃mɦäːɾäː
तुम्हें	t̪ʊ̃mɦẽː
तुरन्त	t̪ʊɾə̃n̪t̪
तुर्कमेनिस्तान	t̪ʊɾkmeːn̪ɪs̪t̪ä̃ːn̪
तुर्किस्तान	t̪ʊɾkɪs̪t̪ä̃ːn̪
तुलनात्मक	t̪ʊl̪ən̪äːt̪mək
तुलसी	t̪ʊl̪s̪iː
तुलसीदास	t̪ʊl̪s̪iːd̪äːs̪
तुलित	t̪ʊl̪ɪt̪
तुल्य	t̪ʊl̪jᵊ
तुष्टीकरण	t̪ʊʃʈiːkəɾə̃ɳ
तूने	t̪uːn̪eː
तूफ़ान	t̪uːfä̃ːn̪
तूफ़ान	t̪uːpʰä̃ːn̪
तृण	t̪ɾɪ̃ɳ
तृष्णा	t̪ɾɪʃɳäː
तेंदुआ	t̪eːn̪d̪ʊaː
तेईस	t̪eːiːs̪
तेजपत्ता	t̪eːd͡ʒpət̪̚t̪äː
तेज़ाब	t̪eːd͡ʒäːb
तेज़ाब	t̪eːzäːb
तेरह	t̪eːɾäː
तेरा	t̪eːɾäː
तेल	t̪eːl̪
तेलंगाना	t̪eːl̪ə̃ŋɡäːn̪äː
तेलुगू	t̪eːl̪ʊɡuː
तेहरान	t̪eːɦɾä̃ːn̪
तैंतालीस	t̪ɛ̃ːn̪t̪äːl̪iːs̪
तैंतीस	t̪ɛ̃ːn̪t̪iːs̪
तैनात	t̪ɛːn̪äːt̪
तैनाती	t̪ɛːn̪äːt̪iː
तोंदी	t̪õːn̪d̪iː
तोता	t̪oːt̪äː
तोहफ़ा	t̪oːɦfäː
तोहफ़ा	t̪oːɦpʰäː
तौबा	t̪ɔːbäː
तौबा	t̪əʊbäː
तौल	t̪ɔːl̪
तौलिया	t̪ɔːl̪ijäː
तौहीन	t̪ɔːɦĩːn̪
त्यागना	t̪jäːɡn̪äː
त्यागपत्र	t̪jäːɡpət̪ɾᵊ
त्यौहार	t̪jɔːɦäːɾ
त्रासद	t̪ɾäːs̪əd̪
त्रासदी	t̪ɾäːs̪d̪iː
त्रिकोणमितीय	t̪ɾɪkõːɳmɪt̪iːjᵊ
त्रिज्या	t̪ɾɪd͡ʒjäː
त्रिपुरा	t̪ɾɪpʊɾäː
त्वचा	t̪wət͡ʃäː
त्वरण	t̪wəɾə̃ɳ
त्वरित	t̪wəɾɪt̪
थकना	t̪ʰəkn̪äː
थकान	t̪ʰəkä̃ːn̪
थकावट	t̪ʰəkäːʋəʈ
थन	t̪ʰə̃n̪
थपथपाना	t̪ʰəpət̪ʰpäːn̪äː
थप्पड़	t̪ʰəp̚pəɽ
थमना	t̪ʰə̃mn̪äː
थमाना	t̪ʰəmäːn̪äː
थरथराना	t̪ʰəɾt̪ʰəɾäːn̪äː
थर्राना	t̪ʰəɾɾäːn̪äː
था	t̪ʰäː
थाइलैंड	t̪ʰäːɪl̪ɛ̃ːɳɖ
थाई	t̪ʰäːiː
थाईलैंड	t̪ʰäːiːl̪ɛ̃ːɳɖ
थाना	t̪ʰäːn̪äː
थानेदार	t̪ʰäːn̪eːd̪äːɾ
थापना	t̪ʰäːpn̪äː
थापा	t̪ʰäːpäː
थामना	t̪ʰä̃ːmn̪äː
थाली	t̪ʰäːl̪iː
थूकना	t̪ʰuːkn̪äː
थूथन	t̪ʰuːt̪ʰə̃n̪
थैंक्स	t̪ʰɛ̃ːŋks̪
थैला	t̪ʰɛːl̪äː
थोड़ा	t̪ʰoːɽäː
थोपना	t̪ʰoːpn̪äː
दंग	d̪ə̃ŋɡ
दंगल	d̪ə̃ŋɡəl̪
दंगा	d̪ə̃ŋɡäː
दंड	d̪ə̃ɳɖ
दंत	d̪ə̃n̪t̪
दंतकथा	d̪ə̃n̪t̪kət̪ʰäː
दंतमंजन	d̪ə̃n̪t̪mə̃n̪d͡ʒə̃n̪
दंत्य	d̪ə̃n̪t̪jᵊ
दंदान	d̪ə̃n̪d̪ä̃ːn̪
दंपति	d̪ə̃mpət̪iː
दंपती	d̪ə̃mpət̪iː
दंभ	d̪ə̃mbʱ
दंश	d̪ə̃n̪ʃ
दक्खिन	d̪ək̚kʰɪ̃n̪
दक्खिनी	d̪ək̚kʰɪn̪iː
दक्ष	d̪əkʃ
दक्षिण	d̪əkʃɪ̃ɳ
दक्षिणपंथ	d̪əkʃɪ̃ɳpə̃n̪t̪ʰ
दक्षिणपंथी	d̪əkʃɪ̃ɳpə̃n̪t̪ʰiː
दक्षिणा	d̪əkʃɪɳäː
दक्षिणापथ	d̪əkʃɪɳäːpət̪ʰ
दख़ल	d̪əkʰəl̪
दख़ल	d̪əxəl̪
दगला	d̪əɡl̪äː
दग़ा	d̪əɡäː
दग़ा	d̪əɣäː
दग़ाबाज़	d̪əɡäːbäːd͡ʒ
दग़ाबाज़	d̪əɣäːbäːz
दफ़न	d̪əfn̪
दफ़न	d̪əfə̃n̪
दफ़न	d̪əpʰn̪
दफ़न	d̪əpʰə̃n̪
दफ़नाना	d̪əfn̪äːn̪äː
दफ़नाना	d̪əpʰn̪äːn̪äː
दफ़ा	d̪əfäː
दफ़ा	d̪əpʰäː
दफ़्तरशाह	d̪əft̪əɾʃäːɦ
दफ़्तरशाह	d̪əpʰt̪əɾʃäːɦ
दबंग	d̪əbə̃ŋɡ
दबदबा	d̪əbd̪əbäː
दबाना	d̪əbäːn̪äː
दबाव	d̪əbäːʋ
दबोचना	d̪əboːt͡ʃn̪äː
दम	d̪ə̃m
दमन	d̪əmə̃n̪
दम्पति	d̪ə̃mpət̪iː
दम्पती	d̪ə̃mpət̪iː
दया	d̪əjäː
दरअसल	d̪əɾəs̪əl̪
दरख़ास्त	d̪əɾkʰäːs̪t̪
दरख़ास्त	d̪əɾxäːs̪t̪
दरगाह	d̪əɾɡäːɦ
दरबार	d̪əɾbäːɾ
दरमियान	d̪əɾmijä̃ːn̪
दरमियानी	d̪əɾmijäːn̪iː
दरवाज़ा	d̪əɾʋäːd͡ʒäː
दरवाज़ा	d̪əɾʋäːzäː
दरांती	d̪əɾä̃ːn̪t̪iː
दराज़	d̪əɾäːd͡ʒ
दराज़	d̪əɾäːz
दरार	d̪əɾäːɾ
दरिंदा	d̪əɾɪ̃n̪d̪äː
दरियाई	d̪əɾijäːiː
दरोग़ा	d̪əɾoːɡäː
दरोग़ा	d̪əɾoːɣäː
दर्जा	d̪əɾd͡ʒäː
दर्दनाक	d̪əɾd̪̚n̪äːk
दर्पण	d̪əɾpə̃ɳ
दर्शन	d̪əɾʃə̃n̪
दर्शनीय	d̪əɾʃən̪iːjᵊ
दर्शाना	d̪əɾʃäːn̪äː
दल	d̪əl̪
दलदल	d̪əl̪d̪əl̪
दलबदलू	d̪əl̪bəd̪l̪uː
दलहन	d̪əl̪ɦə̃n̪
दलाल	d̪əl̪äːl̪
दलित	d̪əl̪ɪt̪
दलील	d̪əl̪iːl̪
दवा	d̪əʋäː
दवाई	d̪əʋäːiː
दवाख़ाना	d̪əʋäːkʰäːn̪äː
दवाख़ाना	d̪əʋäːxäːn̪äː
दवाखाना	d̪əʋäːkʰäːn̪äː
दवाखाना	d̪əʋäːxäːn̪äː
दवात	d̪əʋäːt̪
दशम	d̪əʃə̃m
दशमलव	d̪əʃə̃ml̪əʋ
दशहरा	d̪əʃɛɦɾäː
दस	d̪əs̪
दस्यु	d̪əs̪juː
दहन	d̪ɛɦɛ̃n̪
दहना	d̪ɛɦn̪äː
दहलना	d̪ɛɦɛl̪n̪äː
दहला	d̪ɛɦl̪äː
दहलीज़	d̪ɛɦl̪iːd͡ʒ
दहलीज़	d̪ɛɦl̪iːz
दहशत	d̪ɛɦʃət̪
दाँत	d̪ä̃ːt̪
दाँव	d̪ä̃ːʋ
दांत	d̪ä̃ːn̪t̪
दांत	d̪ä̃ːt̪
दाई	d̪äːiː
दाएँ	d̪äːẽː
दाक्षिण्य	d̪äːkʃɪ̃ɳjᵊ
दाख़िल	d̪äːkʰɪl̪
दाख़िल	d̪äːxɪl̪
दाख़िला	d̪äːkʰɪl̪äː
दाख़िला	d̪äːxɪl̪äː
दाग़	d̪äːɡ
दाग़	d̪äːɣ
दाग़ना	d̪äːɡn̪äː
दाग़ना	d̪äːɣn̪äː
दाड़िम	d̪äːɽɪ̃m
दाढ़	d̪äːɽʱ
दाढ़ी	d̪äːɽʱiː
दाता	d̪äːt̪äː
दाताओ	d̪äːt̪äːoː
दाताओं	d̪äːt̪äːõː
दादरा	d̪äːd̪ɾäː
दादस	d̪äːd̪əs̪
दादसरा	d̪äːd̪əs̪ɾäː
दादा	d̪äːd̪äː
दादी	d̪äːd̪iː
दादुर	d̪äːd̪ʊɾ
दान	d̪ä̃ːn̪
दाना	d̪äːn̪äː
दाब	d̪äːb
दाम	d̪ä̃ːm
दामन	d̪äːmə̃n̪
दामाद	d̪äːmäːd̪
दायर	d̪äːjəɾ
दायाँ	d̪äːjä̃ː
दायित्व	d̪äːjɪt̪wᵊ
दायित्ववान	d̪äːjɪt̪wəʋä̃ːn̪
दायित्ववान्	d̪äːjɪt̪wəʋä̃ːn̪
दायित्वशील	d̪äːjɪt̪wəʃiːl̪
दायित्वहीन	d̪äːjɪt̪wəɦĩːn̪
दायी	d̪äːjiː
दार	d̪äːɾ
दारचीनी	d̪äːɾt͡ʃiːn̪iː
दारु	d̪äːɾuː
दारुलहुकूमत	d̪äːɾʊl̪ɦʊkuːmət̪
दारू	d̪äːɾuː
दाल	d̪äːl̪
दालचीनी	d̪äːl̪t͡ʃiːn̪iː
दावत	d̪äːʋət̪
दावा	d̪äːʋäː
दावेदार	d̪äːʋeːd̪äːɾ
दास	d̪äːs̪
दासप्रथा	d̪äːs̪pɾət̪ʰäː
दास्तान	d̪äːs̪t̪ä̃ːn̪
दाहिना	d̪äːɦɪn̪äː
दाहिने	d̪äːɦɪn̪eː
दिक़्क़त	d̪ɪk̚kət̪
दिक्पात	d̪ɪkpäːt̪
दिखाई	d̪ɪkʰäːiː
दिखाऊ	d̪ɪkʰäːuː
दिखाना	d̪ɪkʰäːn̪äː
दिखावा	d̪ɪkʰäːʋäː
दिगंबर	d̪ɪɡə̃mbəɾ
दिन	d̪ɪ̃n̪
दिनभर	d̪ɪ̃n̪bʱəɾ
दिनांकित	d̪ɪn̪ä̃ːkɪt̪
दिनेश	d̪ɪn̪eːʃ
दिमाग़	d̪ɪmäːɡ
दिमाग़	d̪ɪmäːɣ
दिया	d̪ijäː
दिरम	d̪ɪɾə̃m
दिल	d̪ɪl̪
दिलचस्प	d̪ɪl̪t͡ʃəs̪p
दिलचस्पी	d̪ɪl̪t͡ʃəs̪piː
दिलबर	d̪ɪl̪bəɾ
दिलरुबा	d̪ɪl̪ɾʊbäː
दिलासा	d̪ɪl̪äːs̪äː
दिली	d̪ɪl̪iː
दिलेरी	d̪ɪl̪eːɾiː
दिल्ली	d̪ɪl̪l̪iː
दिल्लीवाला	d̪ɪl̪l̪iːʋäːl̪äː
दिवस	d̪ɪʋəs̪
दिवसीय	d̪ɪʋs̪iːjᵊ
दिवाली	d̪ɪʋäːl̪iː
दिव्यांग	d̪ɪʋjä̃ːŋɡ
दिशानिर्देश	d̪ɪʃäːn̪ɪɾd̪eːʃ
दिसंबर	d̪ɪs̪ə̃mbəɾ
दिहाड़ी	d̪ɪɦäːɽiː
दीदार	d̪iːd̪äːɾ
दीन	d̪ĩːn̪
दीनार	d̪iːn̪äːɾ
दीपावली	d̪iːpäːʋl̪iː
दीपिका	d̪iːpɪkäː
दीया	d̪iːjäː
दीवान	d̪iːʋä̃ːn̪
दीवानगी	d̪iːʋä̃ːn̪ɡiː
दीवाना	d̪iːʋäːn̪äː
दीवार	d̪iːʋäːɾ
दुःस्वप्न	d̪ʊs̪ʋəpn̪ə
दुःस्वप्न	d̪ʊɦs̪ʋəpn̪ə
दुअन्नी	d̪ʊə̃n̪n̪iː
दुआ	d̪ʊäː
दुकान	d̪ʊkä̃ːn̪
दुक्की	d̪ʊk̚kiː
दुगना	d̪ʊɡn̪äː
दुग्धाग्र	d̪ʊɡd̪ʱäːɡɾᵊ
दुनाली	d̪ʊn̪äːl̪iː
दुनिया	d̪ʊn̪ijäː
दुनियाएँ	d̪ʊn̪ijäːẽː
दुपट्टा	d̪ʊpəʈ̚ʈäː
दुपहिया	d̪ʊpəiːjäː
दुपहिया	d̪ʊpəɦijäː
दुभाषिया	d̪ʊbʱäːʃijäː
दुमन	d̪ʊmə̃n̪
दुराघ्री	d̪ʊɾäːɡʱɾiː
दुरुस्त	d̪ʊɾʊs̪t̪
दुर्गंध	d̪ʊɾɡə̃n̪d̪ʱ
दुर्गन्ध	d̪ʊɾɡə̃n̪d̪ʱ
दुर्घटनाग्रस्त	d̪ʊɾɡʱəʈn̪äːɡɾəs̪t̪
दुर्भाग्य	d̪ʊɾbʱäːɡjᵊ
दुर्भाग्यवश	d̪ʊɾbʱäːɡjəʋəʃ
दुर्भावना	d̪ʊɾbʱäːʋn̪äː
दुर्भावनापूर्ण	d̪ʊɾbʱäːʋn̪äːpuːɾɳ
दुर्मना	d̪ʊɾmən̪äː
दुर्व्यवहार	d̪ʊɾʋjəʋɦäːɾ
दुश्मन	d̪ʊʃmə̃n̪
दुश्वार	d̪ʊʃʋäːɾ
दुष्चक्र	d̪ʊʃt͡ʃəkɾᵊ
दुष्परिणाम	d̪ʊʃpəɾɪɳä̃ːm
दुस्साहस	d̪ʊs̪s̪äːɦəs̪
दुहाई	d̪ʊɦäːiː
दूँगा	d̪ũːŋɡäː
दूकान	d̪uːkä̃ːn̪
दूतावास	d̪uːt̪äːʋäːs̪
दूधमुँहा	d̪uːd̪ʱmʊ̃ɦäː
दूधिया	d̪uːd̪ʱijäː
दूना	d̪uːn̪äː
दूरदर्शन	d̪uːɾd̪əɾʃə̃n̪
दूरदर्शिता	d̪uːɾd̪əɾʃɪt̪äː
दूरबीन	d̪uːɾbĩːn̪
दूरभाष	d̪uːɾbʱäːʃ
दूरलेख	d̪uːɾl̪eːkʰ
दूरीकरण	d̪uːɾiːkəɾə̃ɳ
दूल्हा	d̪uːl̪ɦäː
दूसरा	d̪uːs̪ɾäː
दूसरे	d̪uːs̪ɾeː
दृढ़तापूर्वक	d̪ɾɪɽʱt̪äːpuːɾʋək
दृढ़संकल्प	d̪ɾɪɽʱs̪ə̃ŋkəl̪p
दृष्टि	d̪ɾɪʃʈiː
दृष्टिपटल	d̪ɾɪʃʈɪpʈəl̪
देखना	d̪eːkʰn̪äː
देखने	d̪eːkʰn̪eː
देखनेवाला	d̪eːkʰn̪eːʋäːl̪äː
देखभाल	d̪eːkʰbʱäːl̪
देखादेखी	d̪eːkʰäːd̪eːkʰiː
देन	d̪ẽːn̪
देना	d̪eːn̪äː
देने	d̪eːn̪eː
देवता	d̪eːʋt̪äː
देवदार	d̪eːʋd̪äːɾ
देवनागरी	d̪eːʋn̪äːɡɾiː
देवभाषा	d̪eːʋbʱäːʃäː
देवल	d̪eːʋəl̪
देशव्यापी	d̪eːʃəʋjäːpiː
देसी	d̪eːs̪iː
देहकान	d̪eːɦkä̃ːn̪
देहरा	d̪eːɦɾäː
देहरादून	d̪eːɦɾäːd̪ũːn̪
देहली	d̪eːɦl̪iː
देहांत	d̪eːɦä̃ːn̪t̪
देहात	d̪eːɦäːt̪
देहाती	d̪eːɦäːt̪iː
दैत्य	d̪ɛːt̪jaː
दैनिक	d̪ɛːn̪ɪk
दोआब	d̪oːäːb
दोगुना	d̪oːɡʊn̪äː
दोपहर	d̪oːpɛɦɛɾ
दोष	d̪oːʃ
दोषपूर्ण	d̪oːʃpuːɾɳ
दोषमुक्ति	d̪oːʃmʊkt̪iː
दोषी	d̪oːʃiː
दोस्त	d̪oːs̪t̪
दोहरना	d̪oːɦəɾn̪äː
दोहा	d̪oːɦäː
दौड़ाई	d̪ɔːɽäːiː
दौड़ाना	d̪ɔːɽäːn̪äː
दौरा	d̪ɔːɾäː
दौरान	d̪ɔːɾä̃ːn̪
दौलतमंद	d̪ɔːl̪ət̪mə̃n̪d̪
द्रव्यमान	d̪ɾəʋjəmä̃ːn̪
द्रष्टव्य	d̪ɾəʃʈəʋjᵊ
द्राक्षिरा	d̪ɾäːkʃɪɾäː
द्रुतगामी	d̪ɾʊt̪ɡäːmiː
द्वंद्व	d̪wə̃n̪d̪wə
द्वार	d̪wäːɾ
द्वारा	d̪wäːɾäː
द्विध्रुव	d̪wɪd̪ʱɾʊʋ
द्विपक्षीय	d̪wɪpəkʃiːjᵊ
द्विर	d̪wɪɾ
द्विरेफ	d̪wɪɾeːpʰ
धँसना	d̪ʱə̃s̪n̪äː
धंधा	d̪ʱə̃n̪d̪ʱäː
धकेलना	d̪ʱəkeːl̪n̪äː
धज्जी	d̪ʱəd̚d͡ʒiː
धड़कन	d̪ʱəɽkə̃n̪
धड़ल्ला	d̪ʱəɽəl̪l̪äː
धन	d̪ʱə̃n̪
धनगढी	d̪ʱən̪əɡɖʱiː
धनतेरस	d̪ʱə̃n̪t̪eːɾəs̪
धनबाद	d̪ʱə̃n̪bäːd̪
धनराशि	d̪ʱə̃n̪ɾäːʃiː
धनवान	d̪ʱə̃n̪wä̃ːn̪
धनाग्र	d̪ʱən̪äːɡɾᵊ
धनाढ्य	d̪ʱən̪äːɖʱjᵊ
धनादेश	d̪ʱən̪äːd̪eːʃ
धनायन	d̪ʱən̪äːjə̃n̪
धनिया	d̪ʱən̪ijäː
धनी	d̪ʱən̪iː
धनुर्विद्या	d̪ʱən̪ʊɾʋɪd̪jäː
धन्य	d̪ʱə̃n̪jᵊ
धन्यवाद	d̪ʱə̃n̪jəʋäːd̪
धब्बा	d̪ʱəb̚bäː
धमकाना	d̪ʱə̃mkäːn̪äː
धमकी	d̪ʱə̃mkiː
धमनी	d̪ʱə̃mn̪iː
धमाका	d̪ʱəmäːkäː
धरना	d̪ʱəɾn̪äː
धरातल	d̪ʱəɾäːt̪əl̪
धरान	d̪ʱəɾä̃ːn̪
धर्मनिरपेक्ष	d̪ʱəɾmn̪ɪɾpeːkʃ
धर्मनिरपेक्षता	d̪ʱəɾmn̪ɪɾpeːkʃt̪äː
धर्मपरायण	d̪ʱəɾmpəɾäːjə̃ɳ
धर्मशाला	d̪ʱəɾmʃäːl̪äː
धर्मशास्त्र	d̪ʱəɾməʃäːs̪t̪ɾᵊ
धर्मस्थल	d̪ʱəɾms̪t̪ʰəl̪
धर्मस्थलो	d̪ʱəɾməs̪t̪ʰəl̪oː
धर्मस्थलों	d̪ʱəɾməs̪t̪ʰəl̪õː
धर्मार्थ	d̪ʱəɾmäːɾt̪ʰ
धाकड़	d̪ʱäːkəɽ
धातुकर्म	d̪ʱäːt̪ʊkəɾm
धान	d̪ʱä̃ːn̪
धान्य	d̪ʱä̃ːn̪jə
धाम	d̪ʱä̃ːm
धारणा	d̪ʱäːɾɳäː
धारा	d̪ʱäːɾäː
धारित	d̪ʱäːɾɪt̪
धार्मिक	d̪ʱäːɾmɪk
धावा	d̪ʱäːʋäː
धीरा	d̪ʱiːɾäː
धुंध	d̪ʱʊ̃n̪d̪ʱ
धुंधला	d̪ʱʊ̃n̪d̪ʱl̪äː
धुन्नी	d̪ʱʊ̃n̪n̪iː
धुलना	d̪ʱʊl̪n̪äː
धूआँ	d̪ʱuːä̃ː
धूम	d̪ʱũːm
धूर्तता	d̪ʱuːɾt̪ət̪äː
धूल	d̪ʱuːl̪
धूलि	d̪ʱuːl̪iː
धोखा	d̪ʱoːkʰäː
धोखाधड़ी	d̪ʱoːkʰäːd̪ʱəɽiː
धोखेबाज़	d̪ʱoːkʰeːbäːd͡ʒ
धोखेबाज़	d̪ʱoːkʰeːbäːz
धोना	d̪ʱoːn̪äː
धोबिन	d̪ʱoːbɪ̃n̪
ध्यान	d̪ʱjä̃ːn̪
ध्यानपूर्वक	d̪ʱjä̃ːn̪puːɾʋək
ध्रुवीकरण	d̪ʱɾʊʋiːkəɾə̃ɳ
ध्वंसावशेष	d̪ʱʋə̃n̪s̪äːʋʃeːʃ
ध्वजा	d̪ʱʋəd͡ʒäː
ध्वनि	d̪ʱʋən̪iː
ध्वनी	d̪ʱʋən̪iː
ध्वन्यात्मक	d̪ʱʋə̃n̪jäːt̪mək
ध्वस्त	d̪ʱʋəs̪t̪
न	n̪äː
न	n̪ə
नंगा	n̪ə̃ŋɡäː
नंगापन	n̪ə̃ŋɡäːpə̃n̪
नंदिनी	n̪ə̃n̪d̪ɪn̪iː
नंबर	n̪ə̃mbəɾ
नई	n̪əiː
नक़द	n̪əkəd̪
नक़द	n̪əqəd̪
नक़दी	n̪əkd̪iː
नक़दी	n̪əqd̪iː
नक़ल	n̪əkəl̪
नक़ल	n̪əqəl̪
नक़ली	n̪əkl̪iː
नक़ली	n̪əql̪iː
नक़ाब	n̪əkäːb
नक़ाब	n̪əqäːb
नक़ाबपोश	n̪əkäːb̚poːʃ
नक़ाबपोश	n̪əqäːb̚poːʃ
नक़्क़ारा	n̪ək̚käːɾäː
नक़्क़ारा	n̪əqqäːɾäː
नक़्क़ाशी	n̪ək̚käːʃiː
नक़्क़ाशी	n̪əqqäːʃiː
नक़्शा	n̪əkʃäː
नक़्शा	n̪əqʃäː
नकार	n̪əkäːɾ
नकारात्मक	n̪əkäːɾäːt̪mək
नकेल	n̪əkeːl̪
नक्शा	n̪əkʃäː
नक्शा	n̪əqʃäː
नक्षत्र	n̪əkʃət̪ɾᵊ
नख	n̪əkʰ
नखलिस्तान	n̪əkʰl̪ɪs̪t̪ä̃ːn̪
नखलिस्तान	n̪əxl̪ɪs̪t̪ä̃ːn̪
नख़लिस्तान	n̪əkʰl̪ɪs̪t̪ä̃ːn̪
नख़लिस्तान	n̪əxl̪ɪs̪t̪ä̃ːn̪
नगण्य	n̪əɡə̃ɳjᵊ
नगर	n̪əɡəɾ
नगरीकरण	n̪əɡəɾiːkəɾə̃ɳ
नगरीकरण	n̪əɡɾiːkəɾə̃ɳ
नगरीकृत	n̪əɡəɾiːkɾɪt̪
नगरीकृत	n̪əɡɾiːkɾɪt̪
नग़मा	n̪əɡmäː
नग़मा	n̪əɣmäː
नगाड़ा	n̪əɡäːɽäː
नचाना	n̪ət͡ʃäːn̪äː
नजर	n̪əd͡ʒəɾ
नजर	n̪əzəɾ
नज़र	n̪əd͡ʒəɾ
नज़र	n̪əzəɾ
नज़रअंदाज़	n̪əd͡ʒəɾə̃n̪d̪äːd͡ʒ
नज़रअंदाज़	n̪əzəɾə̃n̪d̪äːz
नज़रबंदी	n̪əd͡ʒəɾbə̃n̪d̪iː
नज़रबंदी	n̪əzəɾbə̃n̪d̪iː
नज़रिया	n̪əd͡ʒəɾijäː
नज़रिया	n̪əzəɾijäː
नज़ारा	n̪əd͡ʒäːɾäː
नज़ारा	n̪əzäːɾäː
नजीबाबाद	n̪əd͡ʒiːbäːbäːd̪
नजूमी	n̪əd͡ʒuːmiː
नज्द	n̪əd͡ʒd̪
नटखट	n̪əʈkʰəʈ
नत	n̪ət̪
नति	n̪ət̪iː
नतीजतन	n̪ət̪iːd͡ʒt̪ə̃n̪
नतीजा	n̪ət̪iːd͡ʒäː
नत्थी	n̪ət̪̚t̪ʰiː
नदारद	n̪əd̪äːɾəd̪
नदियाँ	n̪əd̪ijä̃ː
नदियो	n̪əd̪ijoː
नदियों	n̪əd̪ijõː
नदी	n̪əd̪iː
ननद	n̪ən̪əd̪
नन्हा	n̪ə̃n̪ɦäː
नपुंसक	n̪əpʊ̃n̪s̪ək
नपुंसकता	n̪əpʊ̃n̪s̪əkt̪äː
नफ़रत	n̪əfɾət̪
नफ़रत	n̪əpʰɾət̪
नब्ज	n̪əbd͡ʒ
नब्ज	n̪əbz
नब्ज़	n̪əbd͡ʒ
नब्ज़	n̪əbz
नब्बे	n̪əb̚beː
नमक	n̪əmək
नमश्कार	n̪əməʃkäːɾ
नमस्कार	n̪əməs̪käːɾ
नमस्कार	n̪əməʃkäːɾ
नमस्ते	n̪əməs̪t̪eː
नमाज़	n̪əmäːd͡ʒ
नमाज़	n̪əmäːz
नमाज़गाह	n̪əmäːd͡ʒɡäːɦ
नमाज़गाह	n̪əmäːzɡäːɦ
नमी	n̪əmiː
नमूना	n̪əmuːn̪äː
नम्र	n̪ə̃mɾᵊ
नम्रता	n̪ə̃mɾət̪äː
नयन	n̪əjə̃n̪
नया	n̪əjaː
नयी	n̪əjiː
नर	n̪əɾ
नरक	n̪əɾək
नरगिस	n̪əɾɡɪs̪
नरभक्षी	n̪əɾbʱəkʃiː
नरम	n̪əɾə̃m
नरवृषभ	n̪əɾʋɾɪʃəbʱ
नरसंहार	n̪əɾs̪ə̃ŋɦäːɾ
नरसंहार	n̪əɾs̪ə̃ɦäːɾ
नरसिंह	n̪əɾs̪ɪ̃ŋɡʱ
नरेश	n̪əɾeːʃ
नर्तक	n̪əɾt̪ək
नर्तकी	n̪əɾt̪əkiː
नर्मदा	n̪əɾməd̪äː
नर्स	n̪əɾs̪
नल्ला	n̪əl̪l̪äː
नवंबर	n̪əʋə̃mbəɾ
नवजात	n̪əʋd͡ʒäːt̪
नवजीवन	n̪əʋd͡ʒiːʋə̃n̪
नवनी	n̪əʋn̪iː
नवनीत	n̪əʋn̪iːt̪
नवरत्न	n̪əʋɾət̪̚n̪ᵊ
नवरात्रि	n̪əʋɾäːt̪ɾiː
नवविवाहित	n̪əʋʋɪʋäːɦɪt̪
नवशास्त्रीय	n̪əʋʃäːs̪t̪ɾiːjᵊ
नवाज़	n̪əʋäːd͡ʒ
नवाज़	n̪əʋäːz
नवाज़ना	n̪əʋäːd͡ʒn̪äː
नवाज़ना	n̪əʋäːzn̪äː
नवाना	n̪əʋäːn̪äː
नवाब	n̪əʋäːb
नवाबशाह	n̪əʋäːbʃäːɦ
नवासी	n̪əʋäːs̪iː
नवीन	n̪əviːn̪
नशा	n̪əʃäː
नशेड़ी	n̪əʃeːɽiː
नष्ट	n̪əʂʈ
नस	n̪əs̪
नसबंदी	n̪əs̪bə̃n̪d̪iː
नसीब	n̪əs̪iːb
नसीहत	n̪əs̪iːɦət̪
नस्तालीक़	n̪əs̪t̪äːl̪iːk
नस्तालीक़	n̪əs̪t̪äːl̪iːq
नस्ल	n̪əs̪l̪ᵊ
नस्लभेद	n̪əs̪l̪bʱeːd̪
नस्लीय	n̪əs̪l̪iːjᵊ
नहर	n̪ɛɦɛɾ
नहला	n̪ɛɦl̪äː
नहलाना	n̪ɛɦl̪äːn̪äː
नहान	n̪əɦä̃ːn̪
नहाना	n̪əɦäːn̪äː
नहि	n̪əɦiː
नहीं	n̪əɦĩː
ना	n̪äː
नाइजीरिया	n̪äːɪd͡ʒiːɾijäː
नाइनसाफ़ी	n̪äːɪ̃n̪s̪äːfiː
नाइनसाफ़ी	n̪äːɪ̃n̪s̪äːpʰiː
नाई	n̪äːiː
नाईं	n̪äːĩː
नाक	n̪äːk
नाकाम	n̪äːkä̃ːm
नाख़ून	n̪äːkʰũːn̪
नाख़ून	n̪äːxũːn̪
नाखुन	n̪äːkʰʊ̃n̪
नाखुन	n̪äːxʊ̃n̪
नाखून	n̪äːkʰũːn̪
नाखून	n̪äːxũːn̪
नाग	n̪äːɡ
नागपुर	n̪äːɡpʊɾ
नागरिक	n̪äːɡəɾɪk
नागरिक	n̪äːɡɾɪk
नागरिकता	n̪äːɡɾɪkt̪äː
नागवार	n̪äːɡəʋäːɾ
नागालैंड	n̪äːɡäːl̪ɛ̃ːɳɖ
नागालैण्ड	n̪äːɡäːl̪ɛ̃ːɳɖ
नाच	n̪äːt͡ʃ
नाचना	n̪äːt͡ʃn̪äː
नाज़	n̪äːd͡ʒ
नाज़	n̪äːz
नाज़ुकी	n̪äːd͡ʒʊkiː
नाज़ुकी	n̪äːzʊkiː
नाजायज़	n̪äːd͡ʒäːjəd͡ʒ
नाजायज़	n̪äːd͡ʒäːjəz
नाटक	n̪äːʈək
नाटककार	n̪äːʈək̚käːɾ
नाटा	n̪äːʈäː
नाड़ी	n̪äːɽiː
नाडु	n̪äːɖuː
नाता	n̪äːt̪äː
नाती	n̪äːt̪iː
नाथ	n̪äːt̪ʰ
नादान	n̪äːd̪ä̃ːn̪
नादानी	n̪äːd̪äːn̪iː
नादिरशाही	n̪äːd̪ɪɾʃäːɦiː
नान	n̪ä̃ːn̪
नानस	n̪äːn̪əs̪
नानसरा	n̪äːn̪əs̪ɾäː
नाना	n̪äːn̪äː
नानी	n̪äːn̪iː
नानू	n̪äːn̪uː
नाप	n̪äːp
नापना	n̪äːpn̪äː
नापसंद	n̪äːpəs̪ə̃n̪d̪
नाफ़	n̪äːf
नाफ़	n̪äːpʰ
नाभि	n̪äːbʱiː
नाभिक	n̪äːbʱɪk
नाभिकीय	n̪äːbʱɪkiːjᵊ
नाम	n̪ä̃ːm
नामंज़ूर	n̪äːmə̃d͡ʒuːɾ
नामंज़ूर	n̪äːmə̃zuːɾ
नामक	n̪äːmək
नामकरण	n̪ä̃ːmkəɾə̃ɳ
नामनिर्देशिती	n̪ä̃ːmn̪ɪɾd̪eːʃɪt̪iː
नामवर	n̪ä̃ːmwəɾ
नामांकन	n̪äːmä̃ːkə̃n̪
नामीबिया	n̪äːmiːbijäː
नामोत्पत्ति	n̪äːmoːt̪pət̪̚t̪iː
नायब	n̪äːjəb
नायाब	n̪äːjäːb
नायिका	n̪äːjɪkäː
नारंगी	n̪äːɾə̃ŋɡiː
नारा	n̪äːɾäː
नाराज़	n̪äːɾäːd͡ʒ
नाराज़	n̪äːɾäːz
नारायण	n̪äːɾäːjə̃ɳ
नारियल	n̪äːɾijəl̪
नारी	n̪äːɾiː
नारीत्व	n̪äːɾiːt̪wᵊ
नारीवाद	n̪äːɾiːʋäːd̪
नाल	n̪äːl̪
नाला	n̪äːl̪äː
नालायक	n̪äːl̪äːjək
नालायक	n̪äːl̪äːjəq
नाव	n̪äːʋ
नाविक	n̪äːʋɪk
नाशपाती	n̪äːʃpäːt̪iː
नाश्ता	n̪äːʃt̪äː
नासरत	n̪äːs̪əɾət̪
नासिक	n̪äːs̪ɪk
नास्तिक	n̪äːs̪t̪ɪk
नास्तिकता	n̪äːs̪t̪ɪkt̪äː
नाहर	n̪äːɦəɾ
निंदा	n̪ɪ̃n̪d̪äː
निंदासा	n̪ɪ̃n̪d̪äːs̪äː
निःशब्द	n̪ɪɦʃəbd̪
निःशुल्क	n̪ɪɦʃʊl̪k
निकट	n̪ɪkəʈ
निकम्मा	n̪ɪkə̃mmäː
निकम्मापन	n̪ɪkə̃mmäːpə̃n̪
निकर	n̪ɪkəɾ
निकलना	n̪ɪkəl̪n̪äː
निकलवाना	n̪ɪkəl̪ʋäːn̪äː
निक़ाब	n̪ɪkäːb
निक़ाब	n̪ɪqäːb
निकारागुआ	n̪ɪkäːɾäːɡʊäː
निकालना	n̪ɪkäːl̪n̪äː
निकास	n̪ɪkäːs̪
निकाह	n̪ɪkäːɦ
निकोबार	n̪ɪkoːbäːɾ
निखरना	n̪ɪkʰəɾn̪äː
निखारना	n̪ɪkʰäːɾn̪äː
निगम	n̪ɪɡə̃m
निगमन	n̪ɪɡəmə̃n̪
निगरानी	n̪ɪɡɾäːn̪iː
निगलना	n̪ɪɡəl̪n̪äː
निगाह	n̪ɪɡäːɦ
निचला	n̪ɪt͡ʃl̪äː
निचोड़	n̪ɪt͡ʃoːɽ
निचोड़ना	n̪ɪt͡ʃoːɽn̪äː
निज	n̪ɪd͡ʒ
निज़ाम	n̪ɪd͡ʒä̃ːm
निज़ाम	n̪ɪzä̃ːm
निज़ामाबाद	n̪ɪd͡ʒäːmäːbäːd̪
निज़ामाबाद	n̪ɪzäːmäːbäːd̪
निजात	n̪ɪd͡ʒäːt̪
निजी	n̪ɪd͡ʒiː
निजीकरण	n̪ɪd͡ʒiːkəɾə̃ɳ
नितंब	n̪ɪt̪ə̃mb
नित्य	n̪ɪt̪jᵊ
नित्यप्रति	n̪ɪt̪jəpɾət̪iː
निदेशक	n̪ɪd̪eːʃək
निद्र	n̪ɪd̪ɾᵊ
निनानवे	n̪ɪn̪ä̃ːn̪weː
निन्यानवे	n̪ɪ̃n̪jä̃ːn̪weː
निपुण	n̪ɪpʊ̃ɳ
निपूता	n̪ɪpuːt̪äː
निबंध	n̪ɪbə̃n̪d̪ʱ
निभाना	n̪ɪbʱäːn̪äː
निमंत्रण	n̪ɪmə̃n̪t̪ɾə̃ɳ
निमय	n̪ɪməj
निम्न	n̪ɪ̃mn̪ᵊ
निम्नलिखित	n̪ɪ̃mn̪əl̪ɪkʰɪt̪
नियंत्रित	n̪ijə̃n̪t̪ɾɪt̪
नियत	n̪ijət̪
नियति	n̪ijət̪iː
नियम	n̪ijə̃m
नियमावली	n̪ijəmäːʋəl̪iː
नियमित	n̪ijəmɪt̪
नियामक	n̪ijäːmək
नियुक्त	n̪ijʊkt̪
नियुक्ति	n̪ijʊkt̪iː
निरंकुश	n̪ɪɾə̃ŋkʊʃ
निरंकुशवाद	n̪ɪɾə̃ŋkʊʃʋäːd̪
निरंतर	n̪ɪɾə̃n̪t̪əɾ
निरपेक्ष	n̪ɪɾpeːkʃ
निरभिमान	n̪ɪɾəbʱɪmä̃ːn̪
निरस्त	n̪ɪɾəs̪t̪
निरस्त्रीकरण	n̪ɪɾəs̪t̪ɾiːkəɾə̃ɳ
निराला	n̪ɪɾäːl̪äː
निरावेशित	n̪ɪɾäːʋeːʃɪt̪
निराश	n̪ɪɾäːʃ
निराशा	n̪ɪɾäːʃäː
निराहार	n̪ɪɾäːɦäːɾ
निरीक्षक	n̪ɪɾiːkʃək
निरीक्षण	n̪ɪɾiːkʃə̃ɳ
निरूपण	n̪ɪɾuːpə̃ɳ
निरोग	n̪ɪɾoːɡ
निरोध	n̪ɪɾoːd̪ʱ
निर्घोष	n̪ɪɾɡʱoːʃ
निर्जन	n̪ɪɾd͡ʒə̃n̪
निर्जलित	n̪ɪɾd͡ʒəl̪ɪt̪
निर्जीव	n̪ɪɾd͡ʒiːʋ
निर्णय	n̪ɪɾɳəj
निर्णायक	n̪ɪɾɳäːjək
निर्दिष्ट	n̪ɪɾd̪ɪʂʈ
निर्देश	n̪ɪɾd̪eːʃ
निर्देशक	n̪ɪɾd̪eːʃək
निर्देशन	n̪ɪɾd̪eːʃə̃n̪
निर्देशांक	n̪ɪɾd̪eːʃä̃ːk
निर्धन	n̪ɪɾd̪ʱə̃n̪
निर्धनता	n̪ɪɾd̪ʱə̃n̪t̪äː
निर्धारण	n̪ɪɾd̪ʱäːɾə̃ɳ
निर्धारिती	n̪ɪɾd̪ʱäːɾɪt̪iː
निर्बल	n̪ɪɾbəl̪
निर्भर	n̪ɪɾbʱəɾ
निर्मल	n̪ɪɾməl̪
निर्माण	n̪ɪɾmä̃ːɳ
निर्माता	n̪ɪɾmäːt̪äː
निर्मित	n̪ɪɾmɪt̪
निर्मेघ	n̪ɪɾmeːɡʱ
निर्यात	n̪ɪɾjäːt̪
निर्वाचन	n̪ɪɾʋäːt͡ʃə̃n̪
निर्वाचित	n̪ɪɾʋäːt͡ʃɪt̪
निलंबित	n̪ɪl̪ə̃mbɪt̪
निवाला	n̪ɪʋäːl̪äː
निवास	n̪ɪʋäːs̪
निवासी	n̪ɪʋäːs̪iː
निवृत्त	n̪ɪʋɾɪt̪t̪
निवेदन	n̪ɪʋeːd̪ə̃n̪
निवेश	n̪ɪʋeːʃ
निशान	n̪ɪʃä̃ːn̪
निशानेबाज़ी	n̪ɪʃäːn̪eːbäːd͡ʒiː
निशानेबाज़ी	n̪ɪʃäːn̪eːbäːziː
निश्चय	n̪ɪʃt͡ʃəj
निश्चित	n̪ɪʃt͡ʃɪt̪
निषेचन	n̪ɪʃeːt͡ʃə̃n̪
निषेधन	n̪ɪʃeːd̪ʱə̃n̪
निषेधात्मक	n̪ɪʃeːd̪ʱäːt̪mək
निष्कर्ष	n̪ɪʃkəɾʃ
निष्कासन	n̪ɪʃkäːs̪ə̃n̪
निष्कासित	n̪ɪʃkäːs̪ɪt̪
निष्क्रिय	n̪ɪʃkɾɪj
निष्क्रियता	n̪ɪʃkɾɪjt̪äː
निष्ठा	n̪ɪʃʈʰäː
निष्ठुर	n̪ɪʃʈʰʊɾ
निष्पक्ष	n̪ɪʃpəkʃ
निष्फल	n̪ɪʃpʰəl̪
निसार	n̪ɪs̪äːɾ
निस्संदेह	n̪ɪs̪s̪ə̃n̪d̪eːɦ
निस्सार	n̪ɪs̪s̪äːɾ
निहत्था	n̪ɪɦət̪̚t̪ʰäː
निहाई	n̪ɪɦäːiː
निहारना	n̪ɪɦäːɾn̪äː
निहारिका	n̪ɪɦäːɾɪkäː
निहित	n̪ɪɦɪt̪
नी	n̪iː
नींबू	n̪ĩːmbuː
नींव	n̪ĩːmw
नीच	n̪iːt͡ʃ
नीचा	n̪iːt͡ʃäː
नीड़ज	n̪iːɽəd͡ʒ
नीत	n̪iːt̪
नीति	n̪iːt̪iː
नीतिगत	n̪iːt̪ɪɡət̪
नीदरलैंड	n̪iːd̪əɾl̪ɛ̃ːɳɖ
नीदरलैण्ड	n̪iːd̪əɾl̪ɛ̃ːɳɖ
नीयत	n̪iːjət̪
नीर	n̪iːɾ
नील	n̪iːl̪
नीलगाय	n̪iːl̪ɡäːj
नीलम	n̪iːl̪ə̃m
नीला	n̪iːl̪äː
नीलाम	n̪iːl̪ä̃ːm
नीवि	n̪iːʋiː
नीहारिका	n̪iːɦäːɾɪkäː
नुकसान	n̪ʊks̪ä̃ːn̪
नुकसान	n̪ʊqs̪ä̃ːn̪
नुक़्ता	n̪ʊkt̪äː
नुक़्ता	n̪ʊqt̪äː
नुमाइंदगी	n̪ʊmäːɪ̃d̪əɡiː
नुमाइंदा	n̪ʊmäːɪ̃n̪d̪äː
नुमाइश	n̪ʊmäːɪʃ
नुसख़ा	n̪ʊs̪kʰäː
नुसख़ा	n̪ʊs̪xäː
नुस्ख़ा	n̪ʊs̪kʰäː
नुस्ख़ा	n̪ʊs̪xäː
नुस्खा	n̪ʊs̪kʰäː
नुस्खा	n̪ʊs̪xäː
नूर	n̪uːɾ
नूह	n̪uːɦ
नृत्त	n̪ɾɪt̪t̪
नृत्य	n̪ɾɪt̪jə
ने	n̪eː
नेक	n̪eːk
नेकटाई	n̪eːkʈäːiː
नेकदिल	n̪eːkd̪ɪl̪
नेकी	n̪eːkiː
नेटवर्क	n̪eːʈwəɾk
नेतन्याहू	n̪eːt̪ə̃n̪jäːɦuː
नेता	n̪eːt̪äː
नेतृत्व	n̪eːt̪ɾɪt̪wᵊ
नेत्र	n̪eːt̪ɾ
नेत्रदान	n̪eːt̪ɾəd̪ä̃ːn̪
नेत्रिका	n̪eːt̪ɾɪkäː
नेत्री	n̪eːt̪ɾiː
नेत्रोपम	n̪eːt̪ɾoːpə̃m
नेपथ्य	n̪eːpət̪ʰjᵊ
नेपाल	n̪eːpäːl̪
नेपालगंज	n̪eːpäːl̪ɡə̃n̪d͡ʒ
नेपाली	n̪eːpäːl̪iː
नेम	n̪ẽːm
नेल्लोर	n̪eːl̪l̪oːɾ
नेवला	n̪eːʋl̪äː
नेस्तनाबूद	n̪eːs̪t̪ən̪äːbuːd̪
नैचा	n̪ɛːt͡ʃäː
नैन	n̪ɛ̃ːn̪
नैना	n̪ɛːn̪äː
नॉर्वे	n̪ɔɾʋeː
नोएडा	n̪oːeːɖäː
नोचना	n̪oːt͡ʃn̪äː
नोट	n̪oːʈ
नोटबंदी	n̪oːʈbə̃n̪d̪iː
नोटबुक	n̪oːʈbʊk
नोटिस	n̪oːʈɪs̪
नोनी	n̪oːn̪iː
नौ	n̪ɔː
नौकर	n̪ɔːkəɾ
नौकरशाही	n̪ɔːkəɾʃäːɦiː
नौका	n̪ɔːkäː
नौजवान	n̪ɔːd͡ʒəʋä̃ːn̪
नौटंकी	n̪ɔːʈə̃ŋkiː
नौबत	n̪ɔːbət̪
नौसिखिया	n̪ɔːs̪ɪkʰijäː
नौसेना	n̪ɔːs̪eːn̪äː
न्याय	n̪jäːj
न्यायपालिका	n̪jäːjpäːl̪ɪkäː
न्यायशास्त्र	n̪jäːjʃäːs̪t̪ɾᵊ
न्यायाधीश	n̪jäːjäːd̪ʱiːʃ
न्यायिक	n̪jäːjɪk
न्यायोचित	n̪jäːjoːt͡ʃɪt̪
न्यारा	n̪jäːɾäː
न्यास	n̪jäːs̪
न्यूज़	n̪juːd͡ʒ
न्यूज़	n̪juːz
न्यूज़ीलैंड	n̪juːd͡ʒiːl̪ɛ̃ːɳɖ
न्यूज़ीलैंड	n̪juːziːl̪ɛ̃ːɳɖ
न्यूज़ीलैण्ड	n̪juːd͡ʒiːl̪ɛ̃ːɳɖ
न्यूज़ीलैण्ड	n̪juːziːl̪ɛ̃ːɳɖ
न्यून	n̪jũːn̪
न्यूनतम	n̪jũːn̪t̪ə̃m
न्यूयॉर्क	n̪juːjɔɾk
न्योता	n̪joːt̪äː
पंक्ति	pə̃ŋkt̪iː
पंख	pə̃ŋkʰ
पंखा	pə̃ŋkʰäː
पंखावाला	pə̃ŋkʰäːʋäːl̪äː
पंगु	pə̃ŋɡuː
पंचशील	pə̃n̪t͡ʃʃiːl̪
पंचायत	pə̃n̪t͡ʃäːjət̪
पंचायती	pə̃n̪t͡ʃäːjət̪iː
पंछी	pə̃n̪t͡ʃʰiː
पंजा	pə̃n̪d͡ʒäː
पंजाब	pə̃n̪d͡ʒäːb
पंजाबी	pə̃n̪d͡ʒäːbiː
पंजीकरण	pə̃n̪d͡ʒiːkəɾə̃ɳ
पंजीकृत	pə̃n̪d͡ʒiːkɾɪt̪
पंडाल	pə̃ɳɖäːl̪
पंडिताई	pə̃ɳɖɪt̪äːiː
पंद्रह	pə̃n̪d̪ɾəɦ
पंसारी	pə̃n̪s̪äːɾiː
पकड़ना	pəkəɽn̪äː
पकवान	pəkwä̃ːn̪
पकाना	pəkäːn̪äː
पकोड़ा	pəkoːɽäː
पक्का	pək̚käː
पक्ष	pəkʃ
पक्षधर	pəkʃd̪ʱəɾ
पक्षपात	pəkʃpäːt̪
पक्षपातपूर्ण	pəkʃpäːt̪puːɾɳ
पखवाड़ा	pəkʰʋäːɽäː
पगडंडी	pəɡɖə̃ɳɖiː
पगला	pəɡl̪äː
पगली	pəɡl̪iː
पगोडा	pəɡoːɖäː
पचना	pət͡ʃn̪äː
पचपन	pət͡ʃpə̃n̪
पचहत्तर	pət͡ʃʰət̪̚t̪əɾ
पचानवे	pət͡ʃä̃ːn̪weː
पचाना	pət͡ʃäːn̪äː
पचास	pət͡ʃäːs̪
पचासी	pət͡ʃäːs̪iː
पच्चीस	pət̚t͡ʃiːs̪
पच्चीस	pət̚t͡ʃɪs̪
पछताना	pət͡ʃʰt̪äːn̪äː
पछत्तर	pət͡ʃʰət̪̚t̪əɾ
पछाँई	pət͡ʃʰä̃ːiː
पछाड़	pət͡ʃʰäːɽ
पछाड़ना	pət͡ʃʰäːɽn̪äː
पटकना	pəʈəkn̪äː
पटका	pəʈkäː
पटना	pəʈn̪äː
पटरा	pəʈɾäː
पटल	pəʈəl̪
पटवारी	pəʈwäːɾiː
पटाका	pəʈäːkäː
पटाखा	pəʈäːkʰäː
पटेल	pəʈeːl̪
पटोल	pəʈoːl̪
पट्टा	pəʈ̚ʈäː
पट्टिका	pəʈ̚ʈɪkäː
पट्टी	pəʈ̚ʈiː
पट्ठा	pəʈ̚ʈʰäː
पठान	pəʈʰä̃ːn̪
पठानकोट	pəʈʰä̃ːn̪koːʈ
पड़ताल	pəɽt̪äːl̪
पड़ना	pəɽn̪äː
पड़ाना	pəɽäːn̪äː
पड़ोस	pəɽoːs̪
पड़ोसिन	pəɽoːs̪ɪ̃n̪
पढ़ना	pəɽʱn̪äː
पढ़ाई	pəɽʱäːiː
पणजी	pə̃ɳd͡ʒiː
पतंग	pət̪ə̃ŋɡ
पतंगबाज़	pət̪ə̃ŋɡbäːd͡ʒ
पतंगबाज़	pət̪ə̃ŋɡbäːz
पतंगबाज़ी	pət̪ə̃ŋɡbäːd͡ʒiː
पतंगबाज़ी	pət̪ə̃ŋɡbäːziː
पतला	pət̪l̪äː
पतलू	pət̪l̪uː
पतलून	pət̪l̪ũːn̪
पता	pət̪äː
पताका	pət̪äːkäː
पतित्व	pət̪ɪt̪wᵊ
पतीला	pət̪iːl̪äː
पत्ता	pət̪̚t̪äː
पत्ती	pət̪̚t̪iː
पत्तीदार	pət̪̚t̪iːd̪äːɾ
पत्थर	pət̪̚t̪ʰəɾ
पत्थरबाज़	pət̪̚t̪ʰəɾbäːd͡ʒ
पत्थरबाज़	pət̪̚t̪ʰəɾbäːz
पत्थरबाज़ी	pət̪̚t̪ʰəɾbäːd͡ʒiː
पत्थरबाज़ी	pət̪̚t̪ʰəɾbäːziː
पत्नी	pət̪̚n̪iː
पत्रकार	pət̪ɾəkäːɾ
पत्रवाहक	pət̪ɾəʋäːɦək
पत्रिका	pət̪ɾɪkäː
पथरीला	pət̪ʰɾiːl̪äː
पदक	pəd̪ək
पदयात्रा	pəd̪jäːt̪ɾäː
पदवी	pəd̪wiː
पदाधिकारी	pəd̪äːd̪ʱɪkäːɾiː
पदोन्नत	pəd̪õːn̪n̪ət̪
पद्धति	pəd̪̚d̪ʱət̪iː
पद्मावत	pəd̪mäːʋət̪
पधारना	pəd̪ʱäːɾn̪äː
पनडुब्बी	pə̃n̪ɖʊb̚biː
पनपना	pən̪əpn̪äː
पनस	pən̪əs̪
पनामा	pən̪äːmäː
पनाह	pən̪äːɦ
पनाहगाह	pən̪äːɦɡäːɦ
पनीर	pən̪iːɾ
पन्द्रह	pə̃n̪d̪ɾəɦ
पन्ना	pə̃n̪n̪äː
पपनी	pəpn̪iː
पपीता	pəpiːt̪äː
पपीहा	pəpiːɦäː
पयाम	pəjä̃ːm
परंतु	pəɾə̃n̪t̪uː
परंदा	pəɾə̃n̪d̪äː
परंपरागत	pəɾə̃pəɾäːɡət̪
परखना	pəɾəkʰn̪äː
परगना	pəɾɡən̪äː
परचम	pəɾt͡ʃə̃m
परछाई	pəɾt͡ʃʰäːiː
परछाईं	pəɾt͡ʃʰäːĩː
परजन	pəɾd͡ʒə̃n̪
परदादा	pəɾd̪äːd̪äː
परदादी	pəɾd̪äːd̪iː
परनाना	pəɾn̪äːn̪äː
परनानी	pəɾn̪äːn̪iː
परनिंदा	pəɾn̪ɪ̃n̪d̪äː
परन्दा	pəɾə̃n̪d̪äː
परमाणविक	pəɾmä̃ːɳwɪk
परमाणु	pəɾmäːɳuː
परवल	pəɾʋəl̪
परवाज़	pəɾʋäːd͡ʒ
परवाज़	pəɾʋäːz
परवानगी	pəɾʋä̃ːn̪ɡiː
परवाना	pəɾʋäːn̪äː
परवाह	pəɾʋäːɦ
परसर्ग	pəɾs̪əɾɡ
परस्पर	pəɾəs̪pəɾ
पराकाष्ठा	pəɾäːkäːʃʈʰäː
पराक्रमी	pəɾäːkɾəmiː
पराठा	pəɾäːʈʰäː
परात	pəɾäːt̪
परामर्श	pəɾäːməɾʃ
पराया	pəɾäːjäː
परावर्तन	pəɾäːʋəɾt̪ə̃n̪
परास्त	pəɾäːs̪t̪
परिंदा	pəɾɪ̃n̪d̪äː
परिकलित	pəɾɪkl̪ɪt̪
परिकलित्र	pəɾɪkəl̪ɪt̪ɾᵊ
परिक्रमा	pəɾɪkɾəmäː
परिचालन	pəɾɪt͡ʃäːl̪ə̃n̪
परिच्छेद	pəɾɪt̚t͡ʃʰeːd̪
परिणाम	pəɾɪɳä̃ːm
परिणामस्वरूप	pəɾɪɳä̃ːms̪ʋəɾuːp
परिपाटी	pəɾɪpäːʈiː
परिभाषा	pəɾɪbʱäːʃäː
परिभाषित	pəɾɪbʱäːʃɪt̪
परिमाप	pəɾɪmäːp
परिमार्जित	pəɾɪmäːɾd͡ʒɪt̪
परियोजना	pəɾijoːd͡ʒn̪äː
परिवर्तन	pəɾɪʋəɾt̪ə̃n̪
परिवार	pəɾɪʋäːɾ
परिवारवाद	pəɾɪʋäːɾʋäːd̪
परिषद	pəɾɪʃəd̪
परिसंघ	pəɾɪs̪ə̃ŋɡʱ
परिसंपत्ति	pəɾɪs̪ə̃mpət̪̚t̪iː
परिसमापन	pəɾɪs̪mäːpə̃n̪
परिसर	pəɾɪs̪əɾ
परिस्थिति	pəɾɪs̪t̪ʰɪt̪iː
परीक्षण	pəɾiːkʃə̃ɳ
परीक्षा	pəɾiːkʃäː
परेशानी	pəɾeːʃäːn̪iː
परोपकार	pəɾoːpkäːɾ
परोसा	pəɾoːs̪äː
पर्चा	pəɾt͡ʃäː
पर्यटन	pəɾjəʈə̃n̪
पर्याप्त	pəɾjaːpt̪
पर्याय	pəɾjäːj
पर्यावरण	pəɾjäːʋəɾə̃ɳ
पर्युषण	pəɾjʊʃə̃ɳ
पल	pəl̪
पलंग	pəl̪ə̃ŋɡ
पलक	pəl̪ək
पलटन	pəl̪ʈə̃n̪
पलटवाना	pəl̪əʈwäːn̪äː
पलटवार	pəl̪əʈwäːɾ
पलटाना	pəl̪ʈäːn̪äː
पलस्तर	pəl̪əs̪t̪əɾ
पलाण्डु	pəl̪ä̃ːɳɖuː
पलायन	pəl̪äːjə̃n̪
पलित	pəl̪ɪt̪
पलीता	pəl̪iːt̪äː
पल्लव	pəl̪l̪əʋ
पल्ला	pəl̪l̪äː
पवन	pəʋə̃n̪
पशुपालक	pəʃʊpäːl̪ək
पश्चात्	pəʃt͡ʃäːt̪
पश्चिम	pəʃt͡ʃɪ̃m
पश्मीना	pəʃmiːn̪äː
पसंद	pəs̪ə̃n̪d̪
पसंदगी	pəs̪ə̃n̪d̪ɡiː
पसंदीदा	pəs̪ə̃n̪d̪iːd̪äː
पसरना	pəs̪əɾn̪äː
पसली	pəs̪l̪iː
पसार	pəs̪äːɾ
पसीजना	pəs̪iːd͡ʒn̪äː
पसीना	pəs̪iːn̪äː
पसेरी	pəs̪eːɾiː
पहचान	pɛɦt͡ʃä̃ːn̪
पहचानकर्ता	pɛɦt͡ʃä̃ːn̪kəɾt̪äː
पहनना	pɛɦɛ̃n̪n̪äː
पहनाना	pɛɦn̪äːn̪äː
पहनावा	pɛɦn̪äːʋäː
पहर	pɛɦɛɾ
पहरा	pɛɦɾäː
पहरेदार	pɛɦɾeːd̪äːɾ
पहल	pɛɦɛl̪
पहलवानी	pɛɦɛl̪ʋäːn̪iː
पहला	pɛɦl̪äː
पहलू	pɛɦl̪uː
पहले	pɛɦl̪eː
पहाड़	pəɦäːɽ
पहाड़ी	pəɦäːɽiː
पहिया	pəiːjäː
पहिया	pəɦijäː
पहुँचना	pɔɦɔ̃n̪t͡ʃn̪äː
पहुँचाना	pɔɦɔ̃n̪t͡ʃäːn̪äː
पहेली	pəɦeːl̪iː
पाँच	pä̃ːt͡ʃ
पाँचवाँ	pä̃ːt͡ʃʋä̃ː
पाँव	pä̃ːʋ
पांच	pä̃ːt͡ʃ
पाई	päːiː
पाउंड	päːʊ̃ɳɖ
पाक	päːk
पाकपत्तन	päːkpət̪̚t̪ə̃n̪
पाकिस्तान	päːkɪs̪t̪ä̃ːn̪
पाकिस्तानी	päːkɪs̪t̪äːn̪iː
पागल	päːɡəl̪
पागलख़ाना	päːɡəl̪kʰäːn̪äː
पागलख़ाना	päːɡəl̪xäːn̪äː
पागलपन	päːɡəl̪pə̃n̪
पाचन	päːt͡ʃə̃n̪
पाजामा	päːd͡ʒäːmäː
पाजी	päːd͡ʒiː
पाटन	päːʈə̃n̪
पाठक	päːʈʰək
पाठशाला	päːʈʰʃäːl̪äː
पाठ्य	päːʈʰjᵊ
पाठ्यक्रम	päːʈʰjəkɾə̃m
पाठ्यपुस्तक	päːʈʰjəpʊs̪t̪ək
पात	päːt̪
पात्र	päːt̪ɾᵊ
पाथना	päːt̪ʰn̪äː
पाद	päːd̪
पादत्र	päːd̪ət̪ɾᵊ
पादत्राण	päːd̪ət̪ɾä̃ːɳ
पादना	päːd̪̚n̪äː
पादप	päːd̪əp
पादरी	päːd̪ɾiː
पादावरण	päːd̪äːʋɾə̃ɳ
पान	pä̃ːn̪
पाना	päːn̪äː
पानी	päːn̪iː
पाप	päːp
पापड़	päːpəɽ
पापड़ी	päːpɽiː
पापा	päːpäː
पाबंद	päːbə̃n̪d̪
पाबंदी	päːbə̃n̪d̪iː
पायदान	päːjd̪ä̃ːn̪
पायल	päːjəl̪
पायलट	päːjl̪əʈ
पायस	päːjəs̪
पाया	päːjäː
पार	päːɾ
पारगम्य	päːɾɡə̃mjᵊ
पारगम्यता	päːɾɡə̃mjət̪äː
पारदर्शी	päːɾd̪əɾʃiː
पारसी	päːɾs̪iː
पारसेक	päːɾs̪eːk
पारित	päːɾɪt̪
पारिवारिक	päːɾɪʋäːɾɪk
पारिश्रमिक	päːɾɪʃɾəmɪk
पारी	päːɾiː
पार्क	päːɾk
पार्थिव	päːɾt̪ʰɪʋ
पार्श्वसरट	päːɾʃʋᵊs̪əɾəʈ
पाल	päːl̪
पालक	päːl̪ək
पालकी	päːl̪kiː
पालतू	päːl̪t̪uː
पालथी	päːl̪t̪ʰiː
पालना	päːl̪n̪äː
पालिका	päːl̪ɪkäː
पाशा	päːʃäː
पाशुपत	päːʃʊpət̪
पाश्चात्य	päːʃt͡ʃäːt̪jᵊ
पाषाण	päːʃä̃ːɳ
पास	päːs̪
पासपोर्ट	päːs̪poːɾʈ
पास्ता	päːs̪t̪äː
पाहन	päːɦə̃n̪
पाहुना	päːɦʊn̪äː
पिंजड़ा	pɪ̃n̪d͡ʒɽäː
पिंजरा	pɪ̃n̪d͡ʒɾäː
पिघलना	pɪɡʱəl̪n̪äː
पिघलाना	pɪɡʱl̪äːn̪äː
पिचकना	pɪt͡ʃəkn̪äː
पिछड़ा	pɪt͡ʃʰɽäː
पिज़्ज़ा	pɪd̚d͡ʒäː
पिज़्ज़ा	pɪzzäː
पिता	pɪt̪äː
पिपासा	pɪpäːs̪äː
पिपीलिका	pɪpiːl̪ɪkäː
पियक्कड़	pijək̚kəɽ
पिया	pijäː
पिलाना	pɪl̪äːn̪äː
पिलास	pɪl̪äːs̪
पिल्ला	pɪl̪l̪äː
पिशाच	pɪʃäːt͡ʃ
पिसना	pɪs̪n̪äː
पिसाई	pɪs̪äːiː
पिस्ता	pɪs̪t̪äː
पिस्तौल	pɪs̪t̪ɔːl̪
पीएम	piːẽːm
पीतल	piːt̪əl̪
पीतस	piːt̪əs̪
पीतसरा	piːt̪əs̪ɾäː
पीन	pĩːn̪
पीनस	piːn̪əs̪
पीना	piːn̪äː
पीपल	piːpəl̪
पीपा	piːpäː
पीरियड	piːɾijəɖ
पीला	piːl̪äː
पीलापन	piːl̪äːpə̃n̪
पीसना	piːs̪n̪äː
पुंडरी	pʊ̃ɳɖɾiː
पुकारना	pʊkäːɾn̪äː
पुखराज	pʊkʰɾäːd͡ʒ
पुख़्ता	pʊkʰt̪äː
पुख़्ता	pʊxt̪äː
पुच्छ	pʊt̚t͡ʃʰ
पुच्छल	pʊt̚t͡ʃʰəl̪
पुजारी	pʊd͡ʒäːɾiː
पुट्ठा	pʊʈ̚ʈʰäː
पुड़िया	pʊɽijäː
पुण्डरी	pʊ̃ɳɖɾiː
पुण्य	pʊ̃ɳjᵊ
पुण्यतिथि	pʊ̃ɳjət̪ɪt̪ʰiː
पुतना	pʊt̪̚n̪äː
पुतला	pʊt̪l̪äː
पुतली	pʊt̪l̪iː
पुत्रजया	pʊt̪ɾᵊd͡ʒəjäː
पुदीना	pʊd̪iːn̪äː
पुनः	pʊn̪əɦ
पुनःप्रवेश	pʊn̪əɦpɾəʋeːʃ
पुनरुत्थान	pʊn̪əɾʊt̪̚t̪ʰä̃ːn̪
पुनर्गठन	pʊn̪əɾɡəʈʰə̃n̪
पुनर्जन्म	pʊn̪əɾd͡ʒən̪ə̃m
पुनर्जन्म	pʊn̪əɾd͡ʒə̃n̪m
पुनर्जीवित	pʊn̪əɾd͡ʒiːʋɪt̪
पुनर्दर्शनाय	pʊn̪əɾd̪əɾʃən̪äːj
पुनर्निर्धारण	pʊn̪əɾn̪ɪɾd̪ʱäːɾə̃ɳ
पुनर्निर्माण	pʊn̪əɾn̪ɪɾmä̃ːɳ
पुनश्च	pʊn̪əʃt͡ʃə
पुरज़ा	pʊɾd͡ʒäː
पुरज़ा	pʊɾzäː
पुरस्कार	pʊɾəs̪käːɾ
पुरा	pʊɾäː
पुराण	pʊɾä̃ːɳ
पुरातत्व	pʊɾäːt̪ət̪wᵊ
पुरातत्वज्ञ	pʊɾäːt̪ət̪wəɡj
पुरातात्विक	pʊɾäːt̪äːt̪wɪk
पुराना	pʊɾäːn̪äː
पुरुष	pʊɾʊʃ
पुरुषोचित	pʊɾʊʃoːt͡ʃɪt̪
पुर्तगाल	pʊɾt̪əɡäːl̪
पुर्तगाली	pʊɾt̪əɡäːl̪iː
पुल	pʊl̪
पुलिंदा	pʊl̪ɪ̃n̪d̪äː
पुलिस	pʊl̪ɪs̪
पुलिसकर्मी	pʊl̪ɪs̪kəɾmiː
पुल्लिंग	pʊl̪l̪ɪ̃ŋɡ
पुश्तैनी	pʊʃt̪ɛːn̪iː
पुष्कलावती	pʊʃkəl̪äːʋət̪iː
पुष्टीकरण	pʊʃʈiːkəɾə̃ɳ
पुष्प	pʊʃp
पुस्तक	pʊs̪t̪ək
पुस्तकालय	pʊs̪t̪əkäːl̪əj
पुस्तकीय	pʊs̪t̪əkiːjᵊ
पुस्तिका	pʊs̪t̪ɪkäː
पूंजी	pũːn̪d͡ʒiː
पूंजीवाद	pũːn̪d͡ʒiːʋäːd̪
पूंडरी	pũːɳɖɾiː
पूछताछ	puːt͡ʃʰt̪äːt͡ʃʰ
पूछना	puːt͡ʃʰn̪äː
पूजना	puːd͡ʒn̪äː
पूजा	puːd͡ʒäː
पूनम	puːn̪ə̃m
पूरा	puːɾäː
पूर्णकालिक	puːɾɳkäːl̪ɪk
पूर्णबंदी	puːɾɳbə̃n̪d̪iː
पूर्णांक	puːɾɳä̃ːk
पूर्णिमा	puːɾɳɪmäː
पूर्वकथन	puːɾʋəkt̪ʰə̃n̪
पूर्वस्नातक	puːɾʋs̪n̪äːt̪ək
पूर्वाग्रह	puːɾʋäːɡɾəɦ
पूर्वानुमान	puːɾʋäːn̪ʊmä̃ːn̪
पृथक्करण	pɾɪt̪ʰək̚kəɾə̃ɳ
पृष्ठभूमि	pɾɪʃʈʰbʱuːmiː
पेंशन	pẽːn̪ʃə̃n̪
पेंसिल	pẽːn̪s̪ɪl̪
पेचकस	peːt͡ʃkəs̪
पेचीदा	peːt͡ʃiːd̪äː
पेटेंट	peːʈẽːɳʈ
पेट्रोल	peːʈɾoːl̪
पेठा	peːʈʰäː
पेड़ा	peːɽäː
पेन	pẽːn̪
पेन्सिलवेनिया	pẽːn̪s̪ɪl̪ʋeːn̪ijäː
पेप्सी	peːps̪iː
पेय	peː
पेरिस	peːɾɪs̪
पेशवा	peːʃʋäː
पेशा	peːʃäː
पेशाब	peːʃäːb
पेशावर	peːʃäːʋəɾ
पैंट	pɛ̃ːɳʈ
पैंतरा	pɛ̃ːn̪t̪ɾäː
पैंतालीस	pɛ̃ːn̪t̪äːl̪iːs̪
पैंतीस	pɛ̃ːn̪t̪iːs̪
पैंसठ	pɛ̃ːn̪s̪əʈʰ
पैकार	pɛːkäːɾ
पैग़ाम	pɛːɡä̃ːm
पैग़ाम	pɛːɣä̃ːm
पैदाइश	pɛːd̪äːɪʃ
पैदाइशी	pɛːd̪äːɪʃiː
पैदावार	pɛːd̪äːʋäːɾ
पैना	pɛːn̪äː
पैमाना	pɛːmäːn̪äː
पैराग्वे	pɛːɾäːɡʋeː
पैरोकार	pɛːɾoːkäːɾ
पैसा	pɛːs̪äː
पोंछना	põːn̪t͡ʃʰn̪äː
पोका	poːkaː
पोखरा	poːkʰɾäː
पोतना	poːt̪̚n̪äː
पोता	poːt̪äː
पोपला	poːpl̪äː
पोलिश	poːl̪ɪʃ
पोलैंड	poːl̪ɛ̃ːɳɖ
पोशाक	poːʃäːk
पौंड	pɔ̃ːɳɖ
पौदा	pɔːd̪äː
पौधा	pɔːd̪ʱäː
पौन	pɔ̃ːn̪
पौना	pɔːn̪äː
पौने	pɔːn̪eː
पौराणिक	pɔːɾäːɳɪk
पौरुष	pɔːɾʊʃ
पौष	pɔːʃ
पौष्टिक	pɔːʃʈɪk
प्याऊ	pjäːuː
प्याज	pjäːd͡ʒ
प्याज	pjäːz
प्याज़	pjäːd͡ʒ
प्याज़	pjäːz
प्यादा	pjäːd̪äː
प्यार	pjäːɾ
प्यास	pjäːs̪
प्यासा	pjäːs̪äː
प्योंगचांग	pjõːŋɡt͡ʃä̃ːŋɡ
प्योंगचैंग	pjõːŋɡt͡ʃɛ̃ːŋɡ
प्योंगयांग	pjõːŋɡjä̃ːŋɡ
प्रकांड	pɾəkä̃ːɳɖ
प्रकार	pɾəkäːɾ
प्रकार्यात्मक	pɾəkäːɾjäːt̪mək
प्रकाश	pɾəkäːʃ
प्रकाशक	pɾəkäːʃək
प्रकाशन	pɾəkäːʃə̃n̪
प्रकासम	pɾəkäːs̪ə̃m
प्रकीर्णन	pɾəkiːɾɳə̃n̪
प्रक्रम	pɾəkɾə̃m
प्रक्रिया	pɾəkɾijäː
प्रक्षेपास्त्र	pɾəkʃeːpäːs̪t̪ɾᵊ
प्रक्षेप्य	pɾəkʃeːpjᵊ
प्रगतिवाद	pɾəɡət̪ɪʋäːd̪
प्रगतिवादी	pɾəɡət̪ɪʋäːd̪iː
प्रगतिशील	pɾəɡət̪ɪʃiːl̪
प्रचंड	pɾət͡ʃə̃ɳɖ
प्रचलित	pɾət͡ʃəl̪ɪt̪
प्रचार	pɾət͡ʃäːɾ
प्रचारक	pɾət͡ʃäːɾək
प्रचारिणी	pɾət͡ʃäːɾɪɳiː
प्रचारित	pɾət͡ʃäːɾɪt̪
प्रचारी	pɾət͡ʃäːɾiː
प्रजनन	pɾəd͡ʒən̪ə̃n̪
प्रजा	pɾəd͡ʒäː
प्रजातंत्र	pɾəd͡ʒäːt̪ə̃n̪t̪ɾᵊ
प्रजातंत्रवाद	pɾəd͡ʒäːt̪ə̃n̪t̪ɾəʋäːd̪
प्रज्वलित	pɾəd͡ʒʋəl̪ɪt̪
प्रण	pɾə̃ɳ
प्रणाम	pɾəɳä̃ːm
प्रणाली	pɾəɳäːl̪iː
प्रताड़ित	pɾət̪äːɽɪt̪
प्रताप	pɾət̪äːp
प्रतापी	pɾət̪äːpiː
प्रतिकर्षण	pɾət̪ɪkəɾʃə̃ɳ
प्रतिकर्षी	pɾət̪ɪkəɾʃiː
प्रतिक्रमण	pɾət̪ɪkɾəmə̃ɳ
प्रतिक्रिया	pɾət̪ɪkɾijäː
प्रतिक्रियावादी	pɾət̪ɪkɾijäːʋäːd̪iː
प्रतिच्छेद	pɾət̪ɪt̚t͡ʃʰeːd̪
प्रतिज्ञा	pɾət̪ɪɡjäː
प्रतिज्ञापन	pɾət̪ɪɡjäːpə̃n̪
प्रतिध्वनि	pɾət̪ɪd̪ʱʋən̪iː
प्रतिनिधि	pɾət̪ɪn̪ɪd̪ʱiː
प्रतिनिधित्व	pɾət̪ɪn̪ɪd̪ʱɪt̪wᵊ
प्रतिफल	pɾət̪ɪpʰəl̪
प्रतिबंध	pɾət̪ɪbə̃n̪d̪ʱ
प्रतिबंधित	pɾət̪ɪbə̃n̪d̪ʱɪt̪
प्रतिबिंब	pɾət̪ɪbɪ̃mb
प्रतिभा	pɾət̪ɪbʱäː
प्रतिमा	pɾət̪ɪmäː
प्रतिमाह	pɾət̪ɪmäːɦ
प्रतियोगिता	pɾət̪ijoːɡɪt̪äː
प्रतिरोधकता	pɾət̪ɪɾoːd̪ʱəkt̪äː
प्रतिलोम	pɾət̪ɪl̪õːm
प्रतिश्याय	pɾət̪ɪʃjäːj
प्रतिस्पर्धा	pɾət̪ɪs̪pəɾd̪ʱäː
प्रतीकात्मक	pɾət̪iːkäːt̪mək
प्रत्यक्षदर्शी	pɾət̪jəkʃd̪əɾʃiː
प्रत्यक्षीकरण	pɾət̪jəkʃiːkəɾə̃ɳ
प्रत्यर्पण	pɾət̪jəɾpə̃ɳ
प्रत्याशा	pɾət̪jäːʃäː
प्रत्याशी	pɾət̪jäːʃiː
प्रथमतः	pɾət̪ʰə̃mt̪əɦ
प्रदर्शन	pɾəd̪əɾʃə̃n̪
प्रदाता	pɾəd̪äːt̪äː
प्रदान	pɾəd̪ä̃ːn̪
प्रदूषण	pɾəd̪uːʃə̃ɳ
प्रधान	pɾəd̪ʱä̃ːn̪
प्रधानाचार्य	pɾəd̪ʱäːn̪äːt͡ʃäːɾjᵊ
प्रधानाध्यापक	pɾəd̪ʱäːn̪äːd̪ʱjäːpək
प्रबंध	pɾəbə̃n̪d̪ʱ
प्रबंधक	pɾəbə̃n̪d̪ʱək
प्रबंधकर्ता	pɾəbə̃n̪d̪ʱkəɾt̪äː
प्रबन्ध	pɾəbə̃n̪d̪ʱ
प्रबल	pɾəbəl̪
प्रभात	pɾəbʱäːt̪
प्रभारी	pɾəbʱäːɾiː
प्रभाव	pɾəbʱäːʋ
प्रभावकारी	pɾəbʱäːʋkäːɾiː
प्रभावित	pɾəbʱäːʋɪt̪
प्रभावी	pɾəbʱäːʋiː
प्रभुत्व	pɾəbʱʊt̪wᵊ
प्रमाण	pɾəmä̃ːɳ
प्रमाणभूत	pɾəmä̃ːɳbʱuːt̪
प्रयत्न	pɾəjət̪̚n̪ᵊ
प्रयत्नशील	pɾəjət̪̚n̪əʃiːl̪
प्रयास	pɾəjäːs̪
प्रयोगकर्ता	pɾəjoːɡkəɾt̪äː
प्रयोगशाला	pɾəjoːɡʃäːl̪äː
प्रयोगात्मक	pɾəjoːɡɑt̪mək
प्रयोजन	pɾəjoːd͡ʒə̃n̪
प्रलय	pɾəl̪əj
प्रवक्ता	pɾəʋəkt̪äː
प्रवचन	pɾəʋət͡ʃə̃n̪
प्रवास	pɾəʋäːs̪
प्रवाह	pɾəʋäːɦ
प्रविष्टि	pɾəʋɪʃʈiː
प्रवीण	pɾəʋĩːɳ
प्रवीणता	pɾəʋĩːɳt̪äː
प्रवृत्ति	pɾəʋɾɪt̪̚t̪iː
प्रशंसक	pɾəʃə̃n̪s̪ək
प्रशंसा	pɾəʃə̃n̪s̪äː
प्रशासक	pɾəʃäːs̪ək
प्रशासकीय	pɾəʃäːs̪əkiːjᵊ
प्रशासन	pɾəʃäːs̪ə̃n̪
प्रशासिक	pɾəʃäːs̪ɪk
प्रशिक्षण	pɾəʃɪkʃə̃ɳ
प्रश्न	pɾəʃn̪ə
प्रश्न	pɾəʃn̪ᵊ
प्रश्न	pɾəʃə̃n̪
प्रश्नोत्तर	pɾəʃn̪oːt̪̚t̪əɾ
प्रसंग	pɾəs̪ə̃ŋɡ
प्रसन्नता	pɾəs̪ə̃n̪n̪ᵊt̪äː
प्रसव	pɾəs̪əʋ
प्रसववेदना	pɾəs̪əʋʋeːd̪̚n̪äː
प्रसाद	pɾəs̪äːd̪
प्रसाधन	pɾəs̪äːd̪ʱə̃n̪
प्रसारित	pɾəs̪äːɾɪt̪
प्रसिद्धि	pɾəs̪ɪd̪̚d̪ʱiː
प्रस्ताव	pɾəs̪t̪äːʋ
प्रस्तावक	pɾəs̪t̪äːʋək
प्रस्तुत	pɾəs̪t̪ʊt̪
प्रस्तुति	pɾəs̪t̪ʊt̪iː
प्रस्थान	pɾəs̪t̪ʰä̃ːn̪
प्रहार	pɾəɦäːɾ
प्रांगार	pɾä̃ːŋɡäːɾ
प्रांत	pɾä̃ːn̪t̪
प्राकृत	pɾäːkɾɪt̪
प्राकृतिक	pɾäːkɾɪt̪ɪk
प्राक्कथन	pɾäːk̚kət̪ʰə̃n̪
प्रागितिहास	pɾäːɡɪt̪ɪɦäːs̪
प्रागैतिहासिक	pɾäːɡɛːt̪ɪɦäːs̪ɪk
प्राचल	pɾäːt͡ʃəl̪
प्राची	pɾäːt͡ʃiː
प्राचीन	pɾäːt͡ʃĩːn̪
प्राच्यलवक	pɾäːt͡ʃjəl̪əʋək
प्राण	pɾä̃ːɳ
प्राणवायु	pɾä̃ːɳwäːjuː
प्राणी	pɾäːɳiː
प्रातः	pɾäːt̪əɦ
प्राथमिक	pɾäːt̪ʰmɪk
प्रादेशिक	pɾäːd̪eːʃɪk
प्राधिकार	pɾäːd̪ʱɪkäːɾ
प्राधिकारी	pɾäːd̪ʱɪkäːɾiː
प्राध्यापक	pɾäːd̪ʱjäːpək
प्राप्त	pɾäːpt̪
प्राप्ति	pɾäːpt̪iː
प्राप्तिकर्ता	pɾäːpt̪ɪkəɾt̪äː
प्राप्तिका	pɾäːpt̪ɪkäː
प्राप्य	pɾäːpjᵊ
प्राप्यक	pɾäːpjək
प्रामाणिक	pɾäːmäːɳɪk
प्रायः	pɾäːjəɦ
प्रायद्वीप	pɾäːjd̪wiːp
प्रायापिज़्म	pɾäːjäːpɪd͡ʒm
प्रायापिज़्म	pɾäːjäːpɪzm
प्रायिकता	pɾäːjɪkt̪äː
प्रारंभ	pɾäːɾə̃mbʱ
प्रारंभिक	pɾäːɾə̃mbʱɪk
प्रारम्भ	pɾäːɾə̃mbʱ
प्रारम्भिक	pɾäːɾə̃mbʱɪk
प्रार्थना	pɾäːɾt̪ʰən̪äː
प्रावधान	pɾäːʋd̪ʱä̃ːn̪
प्रावृत्ति	pɾäːʋɾɪt̪̚t̪iː
प्रासंगिक	pɾäːs̪ə̃ŋɡɪk
प्रासंगिकता	pɾäːs̪ə̃ŋɡɪkt̪äː
प्रासाद	pɾäːs̪äːd̪
प्रासुक	pɾäːs̪ʊk
प्रिंस	pɾɪ̃n̪s̪
प्रिटोरिया	pɾɪʈoːɾijäː
प्रिय	pɾijᵊ
प्रिया	pɾijäː
प्रेक्षित	pɾeːkʃɪt̪
प्रेम	pɾẽːm
प्रेमिका	pɾeːmɪkäː
प्रेयसी	pɾeːjs̪iː
प्रेरणा	pɾeːɾɳäː
प्रेस	pɾeːs̪
प्रॉसिक्यूटर	pɾɔs̪ɪkjuːʈəɾ
प्रोग्राम	pɾoːɡɾä̃ːm
प्रोटीन	pɾoːʈĩːn̪
प्रोत्साहन	pɾoːt̪s̪äːɦə̃n̪
प्रोत्साहित	pɾoːt̪s̪äːɦɪt̪
प्रोस्टेट	pɾoːs̪ʈeːʈ
प्लाविका	pl̪äːʋɪkäː
प्लीज़	pl̪iːd͡ʒ
प्लीज़	pl̪iːz
प्लीहा	pl̪iːɦäː
फँसना	pʰə̃s̪n̪äː
फंदा	pʰə̃n̪d̪äː
फक्कड़	pʰək̚kəɽ
फटफटिया	pʰəʈpʰəʈijäː
फट्टू	pʰəʈ̚ʈuː
फड़फड़ाना	pʰəɽpʰəɽäːn̪äː
फफकना	pʰəpʰəkn̪äː
फफूँदी	pʰəpʰũːn̪d̪iː
फफोला	pʰəpʰoːl̪äː
फर्न	pʰəɾn̪
फर्नीचर	pʰəɾn̪iːt͡ʃəɾ
फल	pʰəl̪
फलक	pʰəl̪ək
फलन	pʰəl̪ə̃n̪
फलना	pʰəl̪n̪äː
फलस्वरूप	pʰəl̪əs̪ʋəɾuːp
फलालैन	pʰəl̪äːl̪ɛ̃ːn̪
फली	pʰəl̪iː
फलो	pʰəl̪oː
फलों	pʰəl̪õː
फसल	fəs̪əl̪
फसल	pʰəs̪əl̪
फ़ंतासी	fə̃n̪t̪äːs̪iː
फ़ंतासी	pʰə̃n̪t̪äːs̪iː
फ़ज़ूल	fəzuːl̪
फ़ज़ूल	pʰəd͡ʒuːl̪
फ़तवा	fət̪wäː
फ़तवा	pʰət̪wäː
फ़ना	fən̪äː
फ़ना	pʰən̪äː
फ़रमाइश	fəɾmäːɪʃ
फ़रमाइश	pʰəɾmäːɪʃ
फ़रमान	fəɾmä̃ːn̪
फ़रमान	pʰəɾmä̃ːn̪
फ़रमाना	fəɾmäːn̪äː
फ़रमाना	pʰəɾmäːn̪äː
फ़रात	fəɾäːt̪
फ़रात	pʰəɾäːt̪
फ़रार	fəɾäːɾ
फ़रार	pʰəɾäːɾ
फ़रिश्ता	fəɾɪʃt̪äː
फ़रिश्ता	pʰəɾɪʃt̪äː
फ़रीदाबाद	fəɾiːd̪äːbäːd̪
फ़रीदाबाद	pʰəɾiːd̪äːbäːd̪
फ़र्ज़ंद	fəɾzə̃n̪d̪
फ़र्ज़ंद	pʰəɾd͡ʒə̃n̪d̪
फ़र्ज़न्द	fəɾzə̃n̪d̪
फ़र्ज़न्द	pʰəɾd͡ʒə̃n̪d̪
फ़र्रुख़ाबाद	fəɾɾʊxäːbäːd̪
फ़र्रुख़ाबाद	pʰəɾɾʊkʰäːbäːd̪
फ़लक	fəl̪ək
फ़लक	pʰəl̪ək
फ़लसफ़ा	fəl̪s̪əfäː
फ़लसफ़ा	pʰəl̪s̪əpʰäː
फ़लस्तीनी	fəl̪əs̪t̪iːn̪iː
फ़लस्तीनी	pʰəl̪əs̪t̪iːn̪iː
फ़व्वारा	fəʋʋäːɾäː
फ़व्वारा	pʰəʋʋäːɾäː
फ़सल	fəs̪əl̪
फ़सल	pʰəs̪əl̪
फ़साना	fəs̪äːn̪äː
फ़साना	pʰəs̪äːn̪äː
फ़ाख़्ता	fäːxt̪äː
फ़ाख़्ता	pʰäːkʰt̪äː
फ़ानी	fäːn̪iː
फ़ानी	pʰäːn̪iː
फ़ायदा	fäːjd̪äː
फ़ायदा	pʰäːjd̪äː
फ़ारसी	fäːɾs̪iː
फ़ारसी	pʰäːɾs̪iː
फ़ारिग़	fäːɾɪɣ
फ़ारिग़	pʰäːɾɪɡ
फ़ालतू	fäːl̪t̪uː
फ़ालतू	pʰäːl̪t̪uː
फ़ालसा	fäːl̪s̪äː
फ़ालसा	pʰäːl̪s̪äː
फ़ाश	fäːʃ
फ़ाश	pʰäːʃ
फ़ासला	fäːs̪l̪äː
फ़ासला	pʰäːs̪l̪äː
फ़ासिला	fäːs̪ɪl̪äː
फ़ासिला	pʰäːs̪ɪl̪äː
फ़िदा	fɪd̪äː
फ़िदा	pʰɪd̪äː
फ़िदायीन	fɪd̪äːjĩːn̪
फ़िदायीन	pʰɪd̪äːjĩːn̪
फ़िनलैंड	fɪ̃n̪l̪ɛ̃ːɳɖ
फ़िनलैंड	pʰɪ̃n̪l̪ɛ̃ːɳɖ
फ़िरंग	fɪɾə̃ŋɡ
फ़िरंग	pʰɪɾə̃ŋɡ
फ़िरंगी	fɪɾə̃ŋɡiː
फ़िरंगी	pʰɪɾə̃ŋɡiː
फ़िराक़	fɪɾäːq
फ़िराक़	pʰɪɾäːk
फ़िरिश्ता	fɪɾɪʃt̪äː
फ़िरिश्ता	pʰɪɾɪʃt̪äː
फ़िरौन	fɪɾɔ̃ːn̪
फ़िरौन	pʰɪɾɔ̃ːn̪
फ़िलहाल	fɪl̪ɦäːl̪
फ़िलहाल	pʰɪl̪ɦäːl̪
फ़िलिस्तीनी	fɪl̪ɪs̪t̪iːn̪iː
फ़िलिस्तीनी	pʰɪl̪ɪs̪t̪iːn̪iː
फ़िलीपीन्स	fɪl̪iːpĩːn̪s̪
फ़िलीपीन्स	pʰɪl̪iːpĩːn̪s̪
फ़िल्म	fɪl̪m
फ़िल्म	fɪl̪ə̃m
फ़िल्म	pʰɪl̪m
फ़िल्म	pʰɪl̪ə̃m
फ़ीता	fiːt̪äː
फ़ीता	pʰiːt̪äː
फ़ीलपाँव	fiːl̪pä̃ːʋ
फ़ीलपाँव	pʰiːl̪pä̃ːʋ
फ़ील्मी	fiːl̪miː
फ़ील्मी	pʰiːl̪miː
फ़ीस	fiːs̪
फ़ीस	pʰiːs̪
फ़ीसद	fiːs̪əd̪
फ़ीसद	pʰiːs̪əd̪
फ़ुटबॉल	fʊʈbɔl̪
फ़ुटबॉल	pʰʊʈbɔl̪
फ़ुर्सत	fʊɾs̪ət̪
फ़ुर्सत	pʰʊɾs̪ət̪
फ़ेसबुक	feːs̪bʊk
फ़ेसबुक	pʰeːs̪bʊk
फ़ेहरिस्त	feːɦɾɪs̪t̪
फ़ेहरिस्त	pʰeːɦɾɪs̪t̪
फ़ैज़ाबाद	fɛːzäːbäːd̪
फ़ैज़ाबाद	pʰɛːd͡ʒäːbäːd̪
फ़ैसलाबाद	fɛːs̪l̪äːbäːd̪
फ़ैसलाबाद	pʰɛːs̪l̪äːbäːd̪
फ़ॉर्मूला	fɔɾmuːl̪äː
फ़ॉर्मूला	pʰɔɾmuːl̪äː
फ़ॉलोअर	fɔl̪oːəɾ
फ़ॉलोअर	pʰɔl̪oːəɾ
फ़ोन	fõːn̪
फ़ोन	pʰõːn̪
फ़ौरन	fɔːɾə̃n̪
फ़ौरन	pʰɔːɾə̃n̪
फ़्राँस	fɾä̃ːs̪
फ़्राँस	pʰɾä̃ːs̪
फ़्राँसीसी	fɾä̃ːs̪iːs̪iː
फ़्राँसीसी	pʰɾä̃ːs̪iːs̪iː
फ़्रांसीसी	fɾä̃ːn̪s̪iːs̪iː
फ़्रांसीसी	pʰɾä̃ːn̪s̪iːs̪iː
फ़्रान्सीसी	fɾä̃ːn̪s̪iːs̪iː
फ़्रान्सीसी	pʰɾä̃ːn̪s̪iːs̪iː
फ़्रेन्चाइज़	fɾẽːn̪t͡ʃäːɪz
फ़्रेन्चाइज़	pʰɾẽːn̪t͡ʃäːɪd͡ʒ
फ़्लैट	fl̪ɛːʈ
फ़्लैट	pʰl̪ɛːʈ
फ़्लोरिडा	fl̪oːɾɪɖäː
फ़्लोरिडा	pʰl̪oːɾɪɖäː
फाँसी	pʰä̃ːs̪iː
फाड़ी	pʰäːɽiː
फाफड़ा	pʰäːpʰɽäː
फायदा	fäːjd̪äː
फायदा	pʰäːjd̪äː
फालतू	fäːl̪t̪uː
फालतू	pʰäːl̪t̪uː
फालसा	pʰäːl̪s̪äː
फाल्गुन	pʰäːl̪ɡʊ̃n̪
फावड़ा	pʰäːʋɽäː
फिरना	pʰɪɾn̪äː
फिल्म	fɪl̪m
फिल्म	pʰɪl̪m
फिल्मी	fɪl̪miː
फिल्मी	pʰɪl̪miː
फिसलन	pʰɪs̪l̪ə̃n̪
फिसलना	pʰɪs̪əl̪n̪äː
फीका	pʰiːkäː
फुंसी	pʰʊ̃n̪s̪iː
फुदकना	pʰʊd̪əkn̪äː
फुनगी	pʰʊ̃n̪ɡiː
फुलका	pʰʊl̪käː
फुलझड़ी	pʰʊl̪d͡ʒʱəɽiː
फुसफुसाना	pʰʊs̪pʰʊs̪äːn̪äː
फुहार	pʰʊɦäːɾ
फूफा	pʰuːpʰäː
फूल	pʰuːl̪
फूलदान	pʰuːl̪d̪ä̃ːn̪
फूलना	pʰuːl̪n̪äː
फूलो	pʰuːl̪oː
फूलों	pʰuːl̪õː
फेंक	pʰẽːŋk
फेंकना	pʰẽːŋkn̪äː
फेफड़ा	pʰeːpʰɽäː
फेसबुक	feːs̪bʊk
फेसबुक	pʰeːs̪bʊk
फैलना	pʰɛːl̪n̪äː
फैलाव	pʰɛːl̪äːʋ
फैसला	fɛːs̪l̪äː
फैसला	pʰɛːs̪l̪äː
फोड़ा	pʰoːɽäː
फोन	fõːn̪
फोन	pʰõːn̪
फ्रांस	fɾä̃ːn̪s̪
फ्रांस	pʰɾä̃ːn̪s̪
फ्रांसीसी	fɾä̃ːn̪s̪iːs̪iː
फ्रांसीसी	pʰɾä̃ːn̪s̪iːs̪iː
फ्रेन्चाइज़	fɾẽːn̪t͡ʃäːɪz
फ्रेन्चाइज़	pʰɾẽːn̪t͡ʃäːɪd͡ʒ
बँटवारा	bə̃ɳʈwäːɾäː
बँधुआ	bə̃n̪d̪ʱʊäː
बंगला	bə̃ŋɡl̪äː
बंगाली	bə̃ŋɡäːl̪iː
बंग्ली	bə̃ŋɡl̪iː
बंजर	bə̃n̪d͡ʒəɾ
बंजारा	bə̃n̪d͡ʒäːɾäː
बंटना	bə̃ɳʈn̪äː
बंटाना	bə̃ɳʈäːn̪äː
बंद	bə̃n̪d̪
बंदगी	bə̃n̪d̪əɡiː
बंदर	bə̃n̪d̪əɾ
बंदरगाह	bə̃n̪d̪əɾɡäːɦ
बंदरिया	bə̃n̪d̪əɾijäː
बंदा	bə̃n̪d̪äː
बंदिनी	bə̃n̪d̪ɪn̪iː
बंदिश	bə̃n̪d̪ɪʃ
बंदी	bə̃n̪d̪iː
बंदीघर	bə̃n̪d̪iːɡʱəɾ
बंदूक़	bə̃n̪d̪uːk
बंदूक़	bə̃n̪d̪uːq
बंध	bə̃n̪d̪ʱ
बंधु	bə̃n̪d̪ʱuː
बंधुत्व	bə̃n̪d̪ʱʊt̪wᵊ
बंबई	bə̃mbəiː
बंबा	bə̃mbäː
बंबैया	bə̃mbə̯ijäː
बकरा	bəkɾäː
बकवास	bəkwäːs̪
बक़ाया	bəkäːjäː
बक़ाया	bəqäːjäː
बक्सा	bəks̪äː
बख़रा	bəkʰɾäː
बख़रा	bəxɾäː
बख़ील	bəkʰiːl̪
बख़ील	bəxiːl̪
बख़्शना	bəkʰʃn̪äː
बख़्शना	bəxʃn̪äː
बखान	bəkʰä̃ːn̪
बगला	bəɡl̪äː
बग़दाद	bəɡd̪äːd̪
बग़दाद	bəɣd̪äːd̪
बग़ल	bəɡəl̪
बग़ल	bəɣəl̪
बग़ावत	bəɡäːʋət̪
बग़ावत	bəɣäːʋət̪
बग़ीचा	bəɡiːt͡ʃäː
बग़ीचा	bəɣiːt͡ʃäː
बगावत	bəɡäːʋət̪
बगावत	bəɣäːʋət̪
बगीचा	bəɡiːt͡ʃäː
बगीचा	bəɣiːt͡ʃäː
बघारना	bəɡʱäːɾn̪äː
बचना	bət͡ʃn̪äː
बचपन	bət͡ʃpə̃n̪
बचपना	bət͡ʃpən̪äː
बचाना	bət͡ʃäːn̪äː
बचाव	bət͡ʃäːʋ
बच्चन	bət̚t͡ʃə̃n̪
बच्चा	bət̚t͡ʃäː
बछड़ा	bət͡ʃʰɽäː
बजना	bəd͡ʒn̪äː
बजरंगबली	bəd͡ʒɾə̃ŋɡəbl̪iː
बजाय	bəd͡ʒäːj
बटाटा	bəʈäːʈäː
बटाना	bəʈäːn̪äː
बटालियन	bəʈäːl̪ijə̃n̪
बटोरना	bəʈoːɾn̪äː
बड़बड़ाना	bəɽbəɽäːn̪äː
बड़ा	bəɽäː
बडा	bəɽäː
बढ़ना	bəɽʱn̪äː
बढ़ाना	bəɽʱäːn̪äː
बढ़ावा	bəɽʱäːʋäː
बढ़िया	bəɽʱijäː
बढ़ेला	bəɽʱeːl̪äː
बतलाना	bət̪l̪äːn̪äː
बताना	bət̪äːn̪äː
बतियाना	bət̪ijäːn̪äː
बत्तख	bət̪̚t̪əkʰ
बत्तख	bət̪̚t̪əx
बत्तख़	bət̪̚t̪əkʰ
बत्तख़	bət̪̚t̪əx
बत्ती	bət̪̚t̪iː
बत्तीस	bət̪̚t̪iːs̪
बदतमीज़	bəd̪̚t̪əmiːd͡ʒ
बदतमीज़	bəd̪̚t̪əmiːz
बदतर	bəd̪̚t̪əɾ
बदतरीन	bəd̪̚t̪əɾĩːn̪
बदन	bəd̪ə̃n̪
बदनाम	bəd̪̚n̪ä̃ːm
बदमाश	bəd̪mäːʃ
बदल	bəd̪əl̪
बदलाव	bəd̪l̪äːʋ
बदौलत	bəd̪ɔːl̪ət̪
बद्दुआ	bəd̪̚d̪ʊäː
बद्दू	bəd̪̚d̪uː
बधिरता	bəd̪ʱɪɾt̪äː
बन	bə̃n̪
बनना	bə̃n̪n̪äː
बनमानुस	bə̃n̪mäːn̪ʊs̪
बनवाना	bə̃n̪wäːn̪äː
बनाऊंगी	bən̪äːũːŋɡiː
बनाना	bən̪äːn̪äː
बनाने	bən̪äːn̪eː
बनाम	bən̪ä̃ːm
बनारस	bən̪äːɾəs̪
बनावट	bən̪äːʋəʈ
बनावटी	bən̪äːʋəʈiː
बनिज	bən̪ɪd͡ʒ
बनिया	bən̪ijäː
बनियान	bən̪ijä̃ːn̪
बन्दिनी	bə̃n̪d̪ɪn̪iː
बन्दीघर	bə̃n̪d̪iːɡʱəɾ
बन्दूक	bə̃n̪d̪uːk
बन्दूक	bə̃n̪d̪uːq
बन्दूक़	bə̃n̪d̪uːk
बन्दूक़	bə̃n̪d̪uːq
बपतिस्मा	bəpt̪ɪs̪mäː
बबूल	bəbuːl̪
बब्बर	bəb̚bəɾ
बम	bə̃m
बमबारी	bə̃mbäːɾiː
बमवर्षक	bə̃mwəɾʃək
बम्बई	bə̃mbəiː
बम्बैया	bə̃mbə̯ijäː
बयान	bəjä̃ːn̪
बयानबाज़ी	bəjä̃ːn̪bäːd͡ʒiː
बयानबाज़ी	bəjä̃ːn̪bäːziː
बयालीस	bəjäːl̪iːs̪
बयासी	bəjäːs̪iː
बरक़रार	bəɾkəɾäːɾ
बरक़रार	bəɾqəɾäːɾ
बरज़बान	bəɾəd͡ʒbä̃ːn̪
बरज़बान	bəɾəzbä̃ːn̪
बरतन	bəɾt̪ə̃n̪
बरतना	bəɾət̪̚n̪äː
बरमा	bəɾmäː
बरस	bəɾəs̪
बरसात	bəɾs̪äːt̪
बरसी	bəɾs̪iː
बरात	bəɾäːt̪
बराबर	bəɾäːbəɾ
बरामद	bəɾäːməd̪
बरामदा	bəɾä̃ːmd̪äː
बरिशाल	bəɾɪʃäːl̪
बरेली	bəɾeːl̪iː
बर्ख़ास्त	bəɾkʰäːs̪t̪
बर्ख़ास्त	bəɾxäːs̪t̪
बर्खा	bəɾkʰäː
बर्तन	bəɾt̪ə̃n̪
बर्ताव	bəɾt̪äːʋ
बर्दाश्त	bəɾd̪äːʃt̪
बर्फ़ीला	bəɾfiːl̪äː
बर्फ़ीला	bəɾpʰiːl̪äː
बर्मिंघम	bəɾmɪ̃ŋɡʱə̃m
बर्लिन	bəɾl̪ɪ̃n̪
बल	bəl̪
बलगतिकी	bəl̪ɡət̪ɪkiː
बलग़म	bəl̪ɡə̃m
बलग़म	bəl̪ɣə̃m
बलपूर्वक	bəl̪puːɾʋək
बलमटेर	bəl̪ə̃mʈeːɾ
बला	bəl̪äː
बलिदान	bəl̪ɪd̪ä̃ːn̪
बलूच	bəl̪uːt͡ʃ
बलूचिस्तान	bəl̪uːt͡ʃɪs̪t̪ä̃ːn̪
बलूची	bəl̪uːt͡ʃiː
बल्कि	bəl̪kiː
बल्ला	bəl̪l̪äː
बल्ली	bəl̪l̪iː
बल्लेबाज़	bəl̪l̪eːbäːd͡ʒ
बल्लेबाज़	bəl̪l̪eːbäːz
बवाल	bəʋäːl̪
बवासीर	bəʋäːs̪iːɾ
बस	bəs̪
बसंत	bəs̪ə̃n̪t̪
बसना	bəs̪n̪äː
बसेरा	bəs̪eːɾäː
बस्त	bəs̪t̪
बस्ता	bəs̪t̪äː
बस्ती	bəs̪t̪iː
बहकना	bɛɦɛkn̪äː
बहकाना	bɛɦkäːn̪äː
बहत्तर	bɛɦɛt̪̚t̪əɾ
बहन	bəɦɪ̃n̪
बहन	bɛɦɛ̃n̪
बहनचोद	bɛɦɛ̃n̪t͡ʃoːd̪
बहना	bɛɦn̪äː
बहनापा	bɛɦn̪äːpäː
बहनोई	bɛɦn̪oːiː
बहरा	bɛɦɾäː
बहराइच	bɛɦɾäːɪt͡ʃ
बहरापन	bɛɦɾäːpə̃n̪
बहरी	bɛɦɾiː
बहरीन	bɛɦɾĩːn̪
बहलना	bɛɦɛl̪n̪äː
बहलाना	bɛɦl̪äːn̪äː
बहस	bɛɦɛs̪
बहादुर	bəɦäːd̪ʊɾ
बहादुरी	bəɦäːd̪ʊɾiː
बहाना	bəɦäːn̪äː
बहाल	bəɦäːl̪
बहाव	bəɦäːʋ
बहावलनगर	bəɦäːʋəl̪n̪əɡəɾ
बहावलपुर	bəɦäːʋəl̪pʊɾ
बहिन	bəɦɪ̃n̪
बहिर्वेशन	bəɦɪɾʋeːʃə̃n̪
बहिष्कार	bəɦɪʃkäːɾ
बहुचर्चित	bɔɦɔt͡ʃəɾt͡ʃɪt̪
बहुजन	bɔɦɔd͡ʒə̃n̪
बहुत	bɔɦɔt̪
बहुदलीय	bɔɦɔd̪əl̪iːjᵊ
बहुपद	bɔɦɔpəd̪
बहुपयोगी	bɔɦɔpjoːɡiː
बहुफलक	bɔɦɔpʰəl̪ək
बहुभाषीय	bəɦubʱɑːʂijə
बहुभुज	bɔɦɔbʱʊd͡ʒ
बहुराष्ट्रीय	bɔɦɔɾäːʃʈɾiːjᵊ
बहुरूपिया	bɔɦɔɾuːpijäː
बहुवचन	bɔɦɔʋət͡ʃə̃n̪
बहुविवाह	bɔɦɔʋɪʋäːɦ
बहुव्रीहि	bɔɦɔʋɾiːɦiː
बहुसंख्यक	bɔɦɔs̪ə̃ŋkʰjək
बहुसंख्या	bɔɦɔs̪ə̃ŋkʰjäː
बाँग	bä̃ːŋɡ
बाँचना	bä̃ːt͡ʃn̪äː
बाँझ	bä̃ːn̪d͡ʒʱ
बाँटना	bä̃ːʈn̪äː
बाँध	bä̃ːn̪d̪ʱ
बाँधना	bä̃ːn̪d̪ʱn̪äː
बाँस	bä̃ːs̪
बाँसुरी	bä̃ːs̪ʊɾiː
बाँह	bä̃ːɦ
बांग्लादेश	bä̃ːŋɡl̪äːd̪eːʃ
बांचना	bä̃ːt͡ʃn̪äː
बांझ	bä̃ːn̪d͡ʒʱ
बांटना	bä̃ːʈn̪äː
बांधव	bä̃ːn̪d̪ʱəʋ
बांस	bä̃ːn̪s̪
बांह	bä̃ːɦ
बाई	bäːiː
बाईस	bäːiːs̪
बाएँ	bäːẽː
बाक़ायदा	bäːkäːjd̪äː
बाक़ायदा	bäːqäːjd̪äː
बाक़ी	bäːkiː
बाक़ी	bäːqiː
बाकी	bäːkiː
बाकी	bäːqiː
बाकू	bäːkuː
बाख़ुदा	bäːkʰʊd̪äː
बाख़ुदा	bäːxʊd̪äː
बाग	bäːɡ
बाग	bäːɣ
बाग़	bäːɡ
बाग़	bäːɣ
बाघ	bäːɡʱ
बाछ	bäːt͡ʃʰ
बाजरा	bäːd͡ʒɾäː
बाज़	bäːd͡ʒ
बाज़	bäːz
बाज़ारी	bäːd͡ʒäːɾiː
बाज़ारी	bäːzäːɾiː
बाज़ीचा	bäːd͡ʒiːt͡ʃäː
बाज़ीचा	bäːziːt͡ʃäː
बाज़ू	bäːd͡ʒuː
बाज़ू	bäːzuː
बाजा	bäːd͡ʒäː
बाजी	bäːd͡ʒiː
बाट	bäːʈ
बाटना	bäːʈn̪äː
बाड़ी	bäːɽiː
बाढ़	bäːɽʱ
बाण	bä̃ːɳ
बात	bäːt̪
बातचीत	bäːt̪̚t͡ʃiːt̪
बाती	bäːt̪iː
बातूनी	bäːt̪uːn̪iː
बाथरूम	bäːt̪ʰɾũːm
बाद	bäːd̪
बादल	bäːd̪əl̪
बादशाह	bäːd̪ʃäːɦ
बादशाहत	bäːd̪ʃäːɦət̪
बादाम	bäːd̪ä̃ːm
बाधा	bäːd̪ʱäː
बाध्य	bäːd̪ʱjᵊ
बान	bä̃ːn̪
बानवे	bä̃ːn̪weː
बाप	bäːp
बापू	bäːpuː
बाप्तिस्मा	bäːpt̪ɪs̪mäː
बाबत	bäːbət̪
बाबर	bäːbəɾ
बाबा	bäːbäː
बाबू	bäːbuː
बायाँ	bäːjä̃ː
बार	bäːɾ
बारह	bäːɾəɦ
बारहखड़ी	bäːɾɛɦkʰəɽiː
बारात	bäːɾäːt̪
बारिक	bäːɾɪk
बारिश	bäːɾɪʃ
बारी	bäːɾiː
बारीक	bäːɾiːk
बारूद	bäːɾuːd̪
बारूदख़ाना	bäːɾuːd̪kʰäːn̪äː
बारूदख़ाना	bäːɾuːd̪xäːn̪äː
बारे	bäːɾeː
बाल	bäːl̪
बालक	bäːl̪ək
बालकेलि	bäːl̪keːl̪iː
बालक्रीड़ा	bäːl̪əkɾiːɽäː
बालटी	bäːl̪ʈiː
बालतोड	bäːl̪t̪oːɽ
बालतोड़	bäːl̪t̪oːɽ
बालपन	bäːl̪pə̃n̪
बालिका	bäːl̪ɪkäː
बालिश	bäːl̪ɪʃ
बालू	bäːl̪uː
बाल्टी	bäːl̪ʈiː
बाल्यावस्था	bäːl̪jäːʋəs̪t̪ʰäː
बावजूद	bäːʋd͡ʒuːd̪
बावन	bäːʋə̃n̪
बावरची	bäːʋəɾt͡ʃiː
बावला	bäːʋl̪äː
बाशिंदा	bäːʃɪ̃n̪d̪äː
बासठ	bäːs̪əʈʰ
बासन	bäːs̪ə̃n̪
बासमती	bäːs̪mət̪iː
बाहर	bäːɦəɾ
बाहुबली	bäːɦʊbəl̪iː
बाह्य	bäːɦjᵊ
बिंदास	bɪ̃n̪d̪äːs̪
बिंदी	bɪ̃n̪d̪iː
बिंदु	bɪ̃n̪d̪uː
बिकवाल	bɪkwäːl̪
बिकाऊ	bɪkäːuː
बिगड़ना	bɪɡəɽn̪äː
बिगुल	bɪɡʊl̪
बिचला	bɪt͡ʃl̪äː
बिचौलिया	bɪt͡ʃɔːl̪ijäː
बिच्छू	bɪt̚t͡ʃʰuː
बिछड़ना	bɪt͡ʃʰəɽn̪äː
बिछना	bɪt͡ʃʰn̪äː
बिछवाना	bɪt͡ʃʰʋäːn̪äː
बिछाना	bɪt͡ʃʰäːn̪äː
बिछौना	bɪt͡ʃʰɔːn̪äː
बिजली	bɪd͡ʒl̪iː
बिजलीकरण	bɪd͡ʒl̪iːkəɾə̃ɳ
बिजलीघर	bɪd͡ʒl̪iːɡʱəɾ
बिटकॉइन	bɪʈkɔɪ̃n̪
बिटिया	bɪʈijäː
बिताना	bɪt̪äːn̪äː
बित्ता	bɪt̪̚t̪äː
बिन	bɪ̃n̪
बिनती	bɪ̃n̪t̪iː
बिना	bɪn̪äː
बिबाद	bɪbäːd̪
बिमारी	bɪmäːɾiː
बियाबान	bijäːbä̃ːn̪
बिरयानी	bɪɾjäːn̪iː
बिरादर	bɪɾäːd̪əɾ
बिल	bɪl̪
बिलखना	bɪl̪əkʰn̪äː
बिलोना	bɪl̪oːn̪äː
बिलौटा	bɪl̪ɔːʈäː
बिल्कुल	bɪl̪kʊl̪
बिल्ला	bɪl̪l̪äː
बिल्ली	bɪl̪l̪iː
बिश्नोई	bɪʃn̪oːiː
बिसरना	bɪs̪əɾn̪äː
बिस्कुट	bɪs̪kʊʈ
बिस्तर	bɪs̪t̪əɾ
बिस्मिल्ला	bɪs̪mɪl̪l̪äː
बिहार	bɪɦäːɾ
बिहारी	bɪɦäːɾiː
बीकानेर	biːkäːn̪eːɾ
बीघा	biːɡʱäː
बीजांड	biːd͡ʒä̃ːɳɖ
बीजांडासन	biːd͡ʒä̃ːɳɖäːs̪ə̃n̪
बीड़ा	biːɽäː
बीतना	biːt̪̚n̪äː
बीमा	biːmäː
बीमार	biːmäːɾ
बीमारी	biːmäːɾiː
बीरगंज	biːɾɡə̃n̪d͡ʒ
बीवी	biːviː
बीस	biːs̪
बुंदेलखंड	bʊ̃n̪d̪eːl̪kʰə̃ɳɖ
बुंदेली	bʊ̃n̪d̪eːl̪iː
बुआ	bʊäː
बुआई	bʊäːiː
बुज़दिल	bʊd͡ʒd̪ɪl̪
बुज़दिल	bʊzd̪ɪl̪
बुझाना	bʊd͡ʒʱäːn̪äː
बुटवल	bʊʈwəl̪
बुड्ढा	bʊɖ̚ɖʱäː
बुड्ढी	bʊɖ̚ɖʱiː
बुढ़ाना	bʊɽʱäːn̪äː
बुढ़ापा	bʊɽʱäːpäː
बुद्धि	bʊd̪̚d̪ʱiː
बुद्धिजीवी	bʊd̪̚d̪ʱɪd͡ʒiːʋiː
बुद्धिमान	bʊd̪̚d̪ʱɪmä̃ːn̪
बुधवार	bʊd̪ʱʋäːɾ
बुनना	bʊ̃n̪n̪äː
बुनियाद	bʊn̪ijäːd̪
बुभुक्षा	bʊbʱʊkʃäː
बुभुक्षित	bʊbʱʊkʃɪt̪
बुरक़ा	bʊɾkäː
बुरक़ा	bʊɾqäː
बुर्जुआ	bʊɾd͡ʒʊäː
बुलंद	bʊl̪ə̃n̪d̪
बुलंदशहर	bʊl̪ə̃n̪d̪ʃɛɦɛɾ
बुलबुल	bʊl̪bʊl̪
बुलबुला	bʊl̪bʊl̪äː
बुलाकर	bʊl̪äːkəɾ
बुलाना	bʊl̪äːn̪äː
बुलावा	bʊl̪äːʋäː
बुलेटिन	bʊl̪eːʈɪ̃n̪
बुल्गारिया	bʊl̪ɡäːɾijäː
बुल्ला	bʊl̪l̪äː
बुसान	bʊs̪ä̃ːn̪
बूँद	bũːn̪d̪
बूंद	bũːn̪d̪
बूझना	buːd͡ʒʱn̪äː
बूढ़ा	buːɽʱäː
बृहस्पति	bɾɪɦəs̪pət̪iː
बेंच	bẽːn̪t͡ʃ
बेअक़्ल	beːəkl̪ᵊ
बेअक़्ल	beːəql̪ᵊ
बेइज़्ज़ती	beːɪd̚d͡ʒət̪iː
बेक़रार	beːkəɾäːɾ
बेक़रार	beːqəɾäːɾ
बेक़ाबू	beːkäːbuː
बेक़ाबू	beːqäːbuː
बेकार	beːkäːɾ
बेगम	beːɡə̃m
बेगाना	beːɡäːn̪äː
बेगार	beːɡäːɾ
बेगुनाह	beːɡʊn̪äːɦ
बेचैन	beːt͡ʃɛ̃ːn̪
बेज़बान	beːd͡ʒbä̃ːn̪
बेज़बान	beːzbä̃ːn̪
बेजान	beːd͡ʒä̃ːn̪
बेटा	beːʈäː
बेड़ा	beːɽäː
बेतवा	beːt̪wäː
बेतहाशा	beːt̪əɦäːʃäː
बेताब	beːt̪äːb
बेतुका	beːt̪ʊkäː
बेदख़ल	beːd̪əkʰl̪ᵊ
बेदख़ल	beːd̪əxl̪ᵊ
बेदख़ली	beːd̪əkʰl̪iː
बेदख़ली	beːd̪əxl̪iː
बेनतीजा	beːn̪ət̪iːd͡ʒäː
बेबस	beːbəs̪
बेबाक़	beːbäːk
बेबाक़	beːbäːq
बेबुनियाद	beːbʊn̪ijäːd̪
बेमेल	beːmeːl̪
बेरौनक़	beːɾɔːn̪ək
बेरौनक़	beːɾɔːn̪əq
बेलचा	beːl̪t͡ʃäː
बेलन	beːl̪ə̃n̪
बेलना	beːl̪n̪äː
बेलनाकार	beːl̪ə̃n̪äːkäːɾ
बेलफ़ास्ट	beːl̪fäːs̪ʈ
बेलफ़ास्ट	beːl̪pʰäːs̪ʈ
बेलारूस	beːl̪äːɾuːs̪
बेल्जियम	beːl̪d͡ʒijə̃m
बेवफ़ा	beːʋəfäː
बेवफ़ा	beːʋəpʰäː
बेवा	beːʋäː
बेशक़ीमती	beːʃkĩːmt̪iː
बेशक़ीमती	beːʃqĩːmt̪iː
बेशुमार	beːʃʊmäːɾ
बेसन	beːs̪ə̃n̪
बेसबॉल	beːs̪bɔl̪
बेस्वाद	beːs̪ʋäːd̪
बेहतर	bɛɦt̪əɾ
बेहतरीन	beːɦt̪əɾĩːn̪
बैंक	bɛ̃ːŋk
बैंगन	bɛ̃ːŋɡə̃n̪
बैंगनी	bɛ̃ːŋɡn̪iː
बैठकबाज़	bɛːʈʰəkbäːd͡ʒ
बैठकबाज़	bɛːʈʰəkbäːz
बैठना	bɛːʈʰn̪äː
बैतनिय्याह	bɛːt̪ən̪ɪjjäːɦ
बैतलहम	bɛːt̪l̪ɛɦɛ̃m
बैरा	bɛːɾäː
बैल	bɛːl̪
बैलगाड़ी	bɛːl̪ɡäːɽiː
बैसाखी	bɛːs̪äːkʰiː
बॉलीवुड	bɔl̪iːʋʊɖ
बोझिल	boːd͡ʒʱɪl̪
बोतल	boːt̪əl̪
बोतलबंद	boːt̪əl̪bə̃n̪d̪
बोतली	boːt̪l̪iː
बोत्सवाना	boːt̪s̪ʋäːn̪äː
बोना	boːn̪äː
बोरियत	boːɾijət̪
बोल	boːl̪
बोलना	boːl̪n̪äː
बोलने	boːl̪n̪eː
बोलिए	boːl̪ɪeː
बोलिविया	boːl̪ɪʋijäː
बोली	boːl̪iː
बोलो	boːl̪oː
बोहरान	boːɦɾä̃ːn̪
बौछाड़	bɔːt͡ʃʰäːɽ
बौछार	bɔːt͡ʃʰäːɾ
बौड़म	bɔːɽə̃m
बौना	bɔːn̪äː
ब्याज	bjäːd͡ʒ
ब्यान	bjä̃ːn̪
ब्याह	bjäːɦ
ब्याहना	bjäːɦn̪äː
ब्योंत	bjõːn̪t̪
ब्यौरा	bjɔːɾäː
ब्रह्म	bɾɛɦmᵊ
ब्रह्मदेश	bɾɛɦməd̪eːʃ
ब्रह्मा	bɾɛɦmäː
ब्रह्मांड	bɾɛɦmä̃ːɳɖ
ब्रह्माण्ड	bɾɛɦmä̃ːɳɖ
ब्राज़िल	bɾäːd͡ʒɪl̪
ब्राज़िल	bɾäːzɪl̪
ब्राह्मण	bɾäːɦmə̃ɳ
ब्राह्मणेतर	bɾäːɦməɳeːt̪əɾ
ब्राह्मी	bɾäːɦmiː
ब्रिटेन	bɾɪʈẽːn̪
ब्रिस्बेन	bɾɪs̪bẽːn̪
ब्रुनेई	bɾʊn̪eːiː
ब्रूनेई	bɾuːn̪eːiː
ब्रैंपटन	bɾɛ̃ːmpʈə̃n̪
भँवरा	bʱə̃ʋɾäː
भंकस	bʱə̃ŋkəs̪
भंग	bʱə̃ŋɡ
भंजक	bʱə̃n̪d͡ʒək
भंडा	bʱə̃ɳɖäː
भंडाफोड़	bʱə̃ɳɖäːpʰoːɽ
भंडार	bʱə̃ɳɖäːɾ
भगनासा	bʱəɡn̪äːs̪äː
भगफल	bʱəɡpʰəl̪
भगवा	bʱəɡʋäː
भगवाकरण	bʱəɡʋäːkəɾə̃ɳ
भगवान	bʱəɡʋä̃ːn̪
भगवान्	bʱəɡʋä̃ːn̪
भजन	bʱəd͡ʒə̃n̪
भजमन	bʱəd͡ʒmə̃n̪
भटकना	bʱəʈəkn̪äː
भटनागर	bʱəʈn̪äːɡəɾ
भटूरा	bʱəʈuːɾäː
भड़कना	bʱəɽəkn̪äː
भड़काऊ	bʱəɽkäːuː
भड़काना	bʱəɽkäːn̪äː
भड़कीला	bʱəɽkiːl̪äː
भतीजा	bʱət̪iːd͡ʒäː
भत्ता	bʱət̪̚t̪äː
भद्दा	bʱəd̪̚d̪äː
भयाक्रांत	bʱəjäːkɾä̃ːn̪t̪
भयावह	bʱəjäːʋəɦ
भरण	bʱəɾə̃ɳ
भरना	bʱəɾn̪äː
भरनी	bʱəɾn̪iː
भरोसा	bʱəɾoːs̪äː
भरोसेमंद	bʱəɾoːs̪eːmə̃n̪d̪
भर्त्सना	bʱəɾt̪s̪ən̪äː
भला	bʱəl̪äː
भली	bʱəl̪iː
भले	bʱəl̪eː
भवन	bʱəʋə̃n̪
भविष्य	bʱəʋɪʃjə
भविष्यवाणी	bʱəʋɪʃjəʋäːɳiː
भाँग	bʱä̃ːŋɡ
भाँजना	bʱä̃ːn̪d͡ʒn̪äː
भाँड़	bʱä̃ːɽ
भाँति	bʱä̃ːn̪t̪iː
भांग	bʱä̃ːŋɡ
भांजा	bʱä̃ːn̪d͡ʒäː
भांजी	bʱä̃ːn̪d͡ʒiː
भाई	bʱäːiː
भाईचारा	bʱäːiːt͡ʃäːɾäː
भाखा	bʱäːkʰäː
भाग	bʱäːɡ
भागना	bʱäːɡn̪äː
भागवत	bʱäːɡʋət̪
भागा	bʱäːɡäː
भागी	bʱäːɡiː
भागीदार	bʱäːɡiːd̪äːɾ
भागे	bʱäːɡeː
भाग्यवान	bʱäːɡjəʋä̃ːn̪
भाग्यशाली	bʱäːɡjəʃäːl̪iː
भाजन	bʱäːd͡ʒə̃n̪
भाजपा	bʱäːd͡ʒpäː
भाटक	bʱäːʈək
भाड़	bʱäːɽ
भाड़ा	bʱäːɽäː
भात	bʱäːt̪
भाद्र	bʱäːd̪ɾᵊ
भाना	bʱäːn̪äː
भाप	bʱäːp
भाभी	bʱäːbʱiː
भार	bʱäːɾ
भारत	bʱäːɾət̪
भारतीय	bʱäːɾt̪iːjᵊ
भारा	bʱäːɾäː
भारी	bʱäːɾiː
भारोत्तोलक	bʱäːɾoːt̪̚t̪oːl̪ək
भारोत्तोलन	bʱäːɾoːt̪̚t̪oːl̪ə̃n̪
भारोपीय	bʱäːɾoːpiːjᵊ
भालू	bʱäːl̪uː
भाव	bʱäːʋ
भावनगर	bʱäːʋn̪əɡəɾ
भावना	bʱäːʋn̪äː
भावनात्मक	bʱäːʋn̪äːt̪mək
भावमय	bʱäːʋməj
भावुक	bʱäːʋʊk
भावुकता	bʱäːʋʊkt̪äː
भाषण	bʱäːʃə̃ɳ
भाषा	bʱäːʃäː
भाषाबोध	bʱäːʃäːboːd̪ʱ
भाषाविज्ञान	bʱäːʃäːʋɪɡjä̃ːn̪
भाषाविद्	bʱäːʃäːʋɪd̪
भाषिक	bʱäːʃɪk
भास्कर	bʱäːs̪kəɾ
भिंडी	bʱɪ̃ɳɖiː
भिक्षा	bʱɪkʃäː
भिखारी	bʱɪkʰäːɾiː
भिड़ना	bʱɪɽn̪äː
भिन्न	bʱɪ̃n̪n̪ᵊ
भिन्नता	bʱɪ̃n̪n̪t̪äː
भिया	bʱijäː
भिषग्माता	bʱɪʃəɡmäːt̪äː
भिषग्वर	bʱɪʃəɡʋəɾ
भीगा	bʱiːɡäː
भीड़भाड़	bʱiːɽbʱäːɽ
भीमसरट	bʱĩːms̪əɾəʈ
भीषण	bʱiːʃə̃ɳ
भुगतना	bʱʊɡət̪̚n̪äː
भुगतान	bʱʊɡt̪ä̃ːn̪
भुगताना	bʱʊɡt̪äːn̪äː
भुजंग	bʱʊd͡ʒə̃ŋɡ
भुजा	bʱʊd͡ʒäː
भुट्टा	bʱʊʈ̚ʈäː
भुवन	bʱʊʋə̃n̪
भूकंप	bʱuːkə̃mp
भूकम्प	bʱuːkə̃mp
भूखा	bʱuːkʰäː
भूगोल	bʱuːɡoːl̪
भूचाल	bʱuːt͡ʃäːl̪
भूजल	bʱuːd͡ʒəl̪
भूटान	bʱuːʈä̃ːn̪
भूतकाल	bʱuːt̪käːl̪
भूतनी	bʱuːt̪̚n̪iː
भूनना	bʱũːn̪n̪äː
भूभाग	bʱuːbʱäːɡ
भूमंडल	bʱuːmə̃ɳɖəl̪
भूमंडलीकरण	bʱuːmə̃ɳɖəl̪iːkəɾə̃ɳ
भूमंडलीय	bʱuːmə̃ɳɖəl̪iːjᵊ
भूमिका	bʱuːmɪkäː
भूयाति	bʱuːjäːt̪iː
भूरा	bʱuːɾäː
भूराजनीति	bʱuːɾäːd͡ʒn̪iːt̪iː
भूल	bʱuːl̪
भूलभुलैया	bʱuːl̪bʱʊl̪ə̯ijäː
भूविज्ञान	bʱuːʋɪɡjä̃ːn̪
भूसा	bʱuːs̪äː
भूस्खलन	bʱuːs̪kʰəl̪ə̃n̪
भेंट	bʱẽːɳʈ
भेजना	bʱeːd͡ʒn̪äː
भेजा	bʱeːd͡ʒäː
भेदना	bʱeːd̪̚n̪äː
भेदभाव	bʱeːd̪bʱäːʋ
भेलपूरी	bʱeːl̪puːɾiː
भेषज	bʱeːʃəd͡ʒ
भैंस	bʱɛ̃ːs̪
भैंसा	bʱɛːs̪äː
भैया	bʱə̯ijäː
भोंकना	bʱõːŋkn̪äː
भोगना	bʱoːɡn̪äː
भोजन	bʱoːd͡ʒə̃n̪
भोजनालय	bʱoːd͡ʒn̪äːl̪əj
भोपाल	bʱoːpäːl̪
भोला	bʱoːl̪äː
भोलानाथ	bʱoːl̪äːn̪äːt̪ʰ
भोलेपन	bʱoːl̪eːpə̃n̪
भोसड़ी	bʱoːs̪ɽiː
भौंरा	bʱɔ̃ːɾäː
भौकाल	bʱɔːkäːl̪
भौगोलिक	bʱɔːɡoːl̪ɪk
भौतिकवाद	bʱɔːt̪ɪkwäːd̪
भ्रम	bʱɾə̃m
भ्रमण	bʱɾəmə̃ɳ
भ्रष्टाचार	bʱɾəʃʈäːt͡ʃäːɾ
भ्राजातु	bʱɾäːd͡ʒäːt̪uː
भ्राता	bʱɾäːt̪äː
भ्रामकता	bʱɾäːməkt̪äː
भ्रूण	bʱɾũːɳ
भ्रूणता	bʱɾũːɳt̪äː
मँगनी	mə̃ŋɡn̪iː
मँगवाना	mə̃ŋɡʋäːn̪äː
मँगेतर	mə̃ŋɡeːt̪əɾ
मंगल	mə̃ŋɡəl̪
मंगलवार	mə̃ŋɡəl̪ʋäːɾ
मंगवाना	mə̃ŋɡʋäːn̪äː
मंगोलिया	mə̃ŋɡoːl̪ijäː
मंच	mə̃n̪t͡ʃ
मंचूरिया	mə̃n̪t͡ʃuːɾijäː
मंजन	mə̃n̪d͡ʒə̃n̪
मंज़िल	mə̃d͡ʒɪl̪
मंज़िल	mə̃zɪl̪
मंडप	mə̃ɳɖəp
मंडराना	mə̃ɳɖɾäːn̪äː
मंडलवक	mə̃ɳɖəl̪əʋək
मंडलिका	mə̃ɳɖəl̪ɪkäː
मंत्र	mə̃n̪t̪ɾᵊ
मंत्रालय	mə̃n̪t̪ɾäːl̪əj
मंत्रिमंडल	mə̃n̪t̪ɾɪmə̃ɳɖəl̪
मंत्री	mə̃n̪t̪ɾiː
मंदी	mə̃n̪d̪iː
मंशा	mə̃n̪ʃäː
मंसब	mə̃n̪s̪əb
मअनी	mäːn̪iː
मअनी	məən̪iː
मकड़ा	məkɽäː
मकदूनिया	məkd̪uːn̪ijäː
मकदूनिया	məqd̪uːn̪ijäː
मक़दूनिया	məkd̪uːn̪ijäː
मक़दूनिया	məqd̪uːn̪ijäː
मक़बरा	məkbəɾäː
मक़बरा	məqbəɾäː
मक़बूल	məkbuːl̪
मक़बूल	məqbuːl̪
मक़सद	məks̪əd̪
मक़सद	məqs̪əd̪
मकान	məkä̃ːn̪
मक्का	mək̚käː
मक्कार	mək̚käːɾ
मक्खन	mək̚kʰə̃n̪
मक्खनफल	mək̚kʰə̃n̪pʰəl̪
मख़मल	məkʰməl̪
मख़मल	məxməl̪
मखानी	məkʰäːn̪iː
मखीजा	məkʰiːd͡ʒäː
मगरमच्छ	məɡəɾmət̚t͡ʃʰ
मग्न	məɡn̪ᵊ
मचलना	mət͡ʃəl̪n̪äː
मचाना	mət͡ʃäːn̪äː
मच्छ	mət̚t͡ʃʰ
मच्छर	mət̚t͡ʃʰəɾ
मच्छी	mət̚t͡ʃʰiː
मछली	mət͡ʃʰl̪iː
मछलीपालन	mət͡ʃʰl̪iːpäːl̪ə̃n̪
मछुआ	mət͡ʃʰʊäː
मछुआरा	mət͡ʃʰʊäːɾäː
मजनू	məd͡ʒn̪uː
मजनूँ	məd͡ʒn̪ũː
मजमा	məd͡ʒmäː
मजमून	məd͡ʒmũːn̪
मजमून	məzmũːn̪
मजलिस	məd͡ʒl̪ɪs̪
मज़लूम	məd͡ʒl̪ũːm
मज़लूम	məzl̪ũːm
मज़ा	məd͡ʒäː
मज़ा	məzäː
मज़ाक़	məd͡ʒäːk
मज़ाक़	məzäːq
मज़ाक़िया	məd͡ʒäːkijäː
मज़ाक़िया	məzäːqijäː
मज़ार	məd͡ʒäːɾ
मज़ार	məzäːɾ
मजाल	məd͡ʒäːl̪
मझधार	məd͡ʒʱd̪ʱäːɾ
मटकना	məʈəkn̪äː
मटका	məʈkäː
मटकाना	məʈkäːn̪äː
मटमैला	məʈmɛːl̪äː
मट्टी	məʈ̚ʈiː
मड़ुआ	məɽʊäː
मण्डलिका	mə̃ɳɖəl̪ɪkäː
मतगणना	mət̪ɡə̃ɳn̪äː
मतदाता	mət̪̚d̪äːt̪äː
मतदान	mət̪̚d̪ä̃ːn̪
मतलब	mət̪l̪əb
मतलबी	mət̪l̪əbiː
मथुरा	mət̪ʰʊɾäː
मददगार	məd̪əd̪ɡäːɾ
मदमाता	məd̪mäːt̪äː
मदार	məd̪äːɾ
मदिरा	məd̪ɪɾäː
मद्देनज़र	məd̪̚d̪eːn̪əd͡ʒəɾ
मद्देनज़र	məd̪̚d̪eːn̪əzəɾ
मद्धम	məd̪̚d̪ʱə̃m
मद्यपान	məd̪jəpä̃ːn̪
मद्यसार	məd̪jəs̪äːɾ
मद्रासी	məd̪ɾäːs̪iː
मधुमक्खी	məd̪ʱʊmək̚kʰiː
मधुशाला	məd̪ʱʊʃäːl̪äː
मध्यांतर	məd̪ʱjä̃ːn̪t̪əɾ
मध्यावकाश	məd̪ʱjäːʋkäːʃ
मध्यावधि	məd̪ʱjäːʋəd̪ʱiː
मन	mə̃n̪
मनमाना	mə̃n̪mäːn̪äː
मनश्चिकित्सक	mən̪əʃt͡ʃɪkɪt̪s̪ək
मनसूब	mə̃n̪s̪uːb
मनस्विता	mən̪əs̪ʋɪt̪äː
मनस्वी	mən̪əs̪ʋiː
मना	mən̪äː
मनाना	mən̪äːn̪äː
मनीऑर्डर	mən̪iːɔɾɖəɾ
मनु	mən̪uː
मनुज	mən̪ʊd͡ʒ
मनुष्य	mən̪ʊʃjə
मनोनित	mən̪oːn̪ɪt̪
मनोनीत	mən̪oːn̪iːt̪
मनोबल	mən̪oːbəl̪
मनोरंजन	mən̪oːɾə̃n̪d͡ʒə̃n̪
मनोरोग	mən̪oːɾoːɡ
मनोविदलता	mən̪oːʋɪd̪əl̪t̪äː
मनोवैज्ञानिक	mən̪oːʋɛːɡjäːn̪ɪk
मन्नत	mə̃n̪n̪ət̪
ममता	mə̃mt̪äː
ममनून	mə̃mn̪ũːn̪
ममेरा	məmeːɾäː
मम्मी	mə̃mmiː
मयस्सर	məjəs̪s̪əɾ
मरना	məɾn̪äː
मरम्मत	məɾə̃mmət̪
मरवाना	məɾʋäːn̪äː
मरहबा	məɾɦəbäː
मरहम	məɾɦə̃m
मराठा	məɾäːʈʰäː
मराठी	məɾäːʈʰiː
मराना	məɾäːn̪äː
मरियम	məɾijə̃m
मरियल	məɾijəl̪
मरुस्थल	məɾʊs̪t̪ʰəl̪
मर्तबा	məɾt̪əbäː
मर्तबान	məɾt̪əbä̃ːn̪
मर्दानगी	məɾd̪ä̃ːn̪ɡiː
मर्दाना	məɾd̪äːn̪äː
मर्दुम	məɾd̪ʊ̃m
मर्दुमशुमारी	məɾd̪ʊ̃mʃʊmäːɾiː
मर्मघातक	məɾməɡʱäːt̪ək
मर्यादा	məɾjäːd̪äː
मल	məl̪
मलना	məl̪n̪äː
मलयालम	məl̪əjäːl̪ə̃m
मलहम	məl̪ɦə̃m
मलाई	məl̪äːiː
मलाल	məl̪äːl̪
मलिका	məl̪ɪkäː
मलिन	məl̪ɪ̃n̪
मलेशिया	məl̪eːʃijäː
मल्लाह	məl̪l̪äːɦ
मल्होत्रा	məl̪ɦoːt̪ɾäː
मशरूम	məʃɾũːm
मशाल	məʃäːl̪
मशीन	məʃĩːn̪
मशीनरी	məʃĩːn̪ɾiː
मशीनी	məʃiːn̪iː
मशीनीकरण	məʃiːn̪iːkəɾə̃ɳ
मस	məs̪
मसका	məs̪käː
मसख़री	məs̪kʰəɾiː
मसख़री	məs̪xəɾiː
मसनद	məs̪n̪əd̪
मसनवी	məs̪n̪əʋiː
मसरूफ़	məs̪ɾuːf
मसरूफ़	məs̪ɾuːpʰ
मसल	məs̪əl̪
मसला	məs̪l̪äː
मसान	məs̪ä̃ːn̪
मसि	məs̪iː
मसिपात्र	məs̪ɪpäːt̪ɾᵊ
मसीह	məs̪iːɦ
मसीहा	məs̪iːɦäː
मसीही	məs̪iːɦiː
मसूड़ा	məs̪uːɽäː
मसूर	məs̪uːɾ
मस्जिद	məs̪d͡ʒɪd̪
मस्त	məs̪t̪
मस्तक	məs̪t̪ək
मस्ताना	məs̪t̪äːn̪äː
मस्तानी	məs̪t̪äːn̪iː
मस्तिष्क	məs̪t̪ɪʃk
मस्ती	məs̪t̪iː
मस्तूल	məs̪t̪uːl̪
महँगाई	mɛɦɛ̃ŋɡäːiː
महंगा	mɛɦɛ̃ŋɡäː
महकना	mɛɦɛkn̪äː
महकमा	mɛɦɛkmäː
महज़	mɛɦɛd͡ʒ
महज़	mɛɦɛz
महताब	mɛɦt̪äːb
महत्त्व	mɛɦɛt̪̚t̪wᵊ
महत्त्वपूर्ण	mɛɦɛt̪̚t̪wəpuːɾɳ
महत्व	mɛɦɛt̪wᵊ
महत्वपूर्ण	mɛɦɛt̪wəpuːɾɳ
महत्वाकांक्षा	mɛɦɛt̪wäːkä̃ːkʃäː
महफ़िल	mɛɦfɪl̪
महफ़िल	mɛɦpʰɪl̪
महफ़ूज़	mɛɦfuːz
महफ़ूज़	mɛɦpʰuːd͡ʒ
महफिल	mɛɦfɪl̪
महफिल	mɛɦpʰɪl̪
महबूब	mɛɦbuːb
महबूबा	mɛɦbuːbäː
महमूद	mɛɦmuːd̪
महरूम	mɛɦɾũːm
महल	mɛɦɛl̪
महसूस	mɛɦs̪uːs̪
महा	məɦäː
महागठबंधन	məɦäːɡəʈʰbə̃n̪d̪ʱə̃n̪
महागुरु	məɦäːɡʊɾuː
महात्मा	məɦäːt̪mäː
महादेव	məɦäːd̪eːʋ
महाधिवक्ता	məɦäːd̪ʱɪʋəkt̪äː
महान	məɦä̃ːn̪
महानगर	məɦäːn̪əɡəɾ
महापंडित	məɦäːpə̃ɳɖɪt̪
महापण्डित	məɦäːpə̃ɳɖɪt̪
महापौर	məɦäːpɔːɾ
महाप्रभु	məɦäːpɾəbʱuː
महाभियोग	məɦäːbʱijoːɡ
महामारी	məɦäːmäːɾiː
महायुद्ध	məɦäːjʊd̪d̪ʱ
महारत	məɦäːɾət̪
महाराज	məɦäːɾäːd͡ʒ
महाराजा	məɦäːɾäːd͡ʒäː
महाराष्ट्र	məɦäːɾäːʃʈɾᵊ
महावत	məɦäːʋət̪
महाविद्यालय	məɦäːʋɪd̪jäːl̪əj
महावीर	məɦäːʋiːɾ
महाशय	məɦäːʃəj
महासचिव	məɦäːs̪ət͡ʃɪʋ
महासागर	məɦäːs̪äːɡəɾ
महिमा	məɦɪmäː
महीन	məɦĩːn̪
महोदया	məɦoːd̪əjäː
मह्ल	mɛɦl̪ᵊ
माँ	mä̃ː
माँग	mä̃ːŋɡ
माँगना	mä̃ːŋɡn̪äː
माँजा	mä̃ːn̪d͡ʒäː
माँझी	mä̃ːn̪d͡ʒʱiː
माँदा	mä̃ːn̪d̪äː
माँस	mä̃ːs̪
माँसाहारी	mä̃ːs̪äːɦäːɾiː
मां	mä̃ː
मांग	mä̃ːŋɡ
मांगना	mä̃ːŋɡn̪äː
मांगलिक	mä̃ːŋɡəl̪ɪk
मांजा	mä̃ːn̪d͡ʒäː
मांडलिक	mä̃ːɳɖəl̪ɪk
मांस	mä̃ːn̪s̪
मांसपेशी	mä̃ːn̪s̪peːʃiː
मांसल	mä̃ːn̪s̪əl̪
माइक	mäːɪk
माइक्रोप्रोसेसर	mäːɪkɾoːpɾoːs̪eːs̪əɾ
माओवाद	mäːoːʋäːd̪
माओवादी	mäːoːʋäːd̪iː
माखन	mäːkʰə̃n̪
माघ	mäːɡʱ
माचिस	mäːt͡ʃɪs̪
माजरा	mäːd͡ʒɾäː
माजूफल	mäːd͡ʒuːpʰəl̪
माटी	mäːʈiː
माण्डलिक	mä̃ːɳɖəl̪ɪk
मातम	mäːt̪ə̃m
माता	mäːt̪äː
मातृभाषा	mäːt̪ɾɪbʱäːʃäː
मातृसत्ता	mäːt̪ɾɪs̪ət̪̚t̪äː
मात्रक	mäːt̪ɾək
मात्रा	mäːt̪ɾäː
माथा	mäːt̪ʰäː
मादरचोद	mäːd̪əɾt͡ʃoːd̪
मादा	mäːd̪äː
माधव	mäːd̪ʱəʋ
मानक	mäːn̪ək
मानचित्र	mä̃ːn̪t͡ʃɪt̪ɾᵊ
मानदेय	mä̃ːn̪d̪eːj
मानना	mä̃ːn̪n̪äː
माननीय	mä̃ːn̪n̪iːjᵊ
मानव	mäːn̪əʋ
मानववाद	mäːn̪əʋʋäːd̪
मानवविज्ञान	mäːn̪əʋʋɪɡjä̃ːn̪
मानवशास्त्र	mäːn̪əʋʃäːs̪t̪ɾᵊ
मानवाधिकार	mäːn̪əʋäːd̪ʱɪkäːɾ
मानविकी	mä̃ːn̪wɪkiː
मानवीय	mäːn̪əʋiːjᵊ
मानस	mäːn̪əs̪
मानसिक	mä̃ːn̪s̪ɪk
मानसिकता	mä̃ːn̪s̪ɪkt̪äː
मानसून	mä̃ːn̪s̪ũːn̪
मानसूनी	mä̃ːn̪s̪uːn̪iː
मानुस	mäːn̪ʊs̪
माने	mäːn̪eː
मान्यता	mä̃ːn̪jət̪äː
मान्यताप्राप्त	mä̃ːn̪jət̪äːpɾäːpt̪
माप	mäːp
माफ़	mäːf
माफ़	mäːpʰ
माफ़िया	mäːfijäː
माफ़िया	mäːpʰijäː
माफ़ी	mäːfiː
माफ़ी	mäːpʰiː
मामला	mä̃ːml̪äː
मामा	mäːmäː
मामी	mäːmiː
मामू	mäːmuː
मामूली	mäːmuːl̪iː
मायका	mäːjkäː
मायने	mäːjn̪eː
माया	mäːjäː
मायूस	mäːjuːs̪
मायूसी	mäːjuːs̪iː
मारख़ोर	mäːɾkʰoːɾ
मारख़ोर	mäːɾxoːɾ
मारतौल	mäːɾt̪ɔːl̪
मारना	mäːɾn̪äː
मारपीट	mäːɾpiːʈ
मारवाड़	mäːɾʋäːɽ
मारवाड़ी	mäːɾʋäːɽiː
मार्केट	mäːɾkeːʈ
मार्क्सवाद	mäːɾks̪ʋäːd̪
मार्ग	mäːɾɡ
मार्गदर्शन	mäːɾɡd̪əɾʃə̃n̪
मार्गशीर्ष	mäːɾɡʃiːɾʃ
मार्गाभिगमन	mäːɾɡäːbʱɪɡəmə̃n̪
मार्च	mäːɾt͡ʃ
मार्फ़िया	mäːɾfijäː
मार्फ़िया	mäːɾpʰijäː
माल	mäːl̪
मालगुज़ारी	mäːl̪ɡʊd͡ʒäːɾiː
मालगुज़ारी	mäːl̪ɡʊzäːɾiː
मालदार	mäːl̪d̪äːɾ
मालदीव	mäːl̪d̪iːʋ
मालागासी	mäːl̪äːɡäːs̪iː
मालिक	mäːl̪ɪk
मालिकाना	mäːl̪ɪkäːn̪äː
मालिन	mäːl̪ɪ̃n̪
मालिश	mäːl̪ɪʃ
माली	mäːl̪iː
मालीद	mäːl̪iːd̪
मालूम	mäːl̪ũːm
माले	mäːl̪eː
माल्टा	mäːl̪ʈäː
मावा	mäːʋäː
माशा	mäːʃäː
माशूक़	mäːʃuːk
माशूक़	mäːʃuːq
मास	mäːs̪
मासिक	mäːs̪ɪk
मास्क	mäːs̪k
मास्को	mäːs̪koː
माह	mäːɦ
माहिर	mäːɦɪɾ
माहौल	mäːɦɔːl̪
मिक्सर	mɪks̪əɾ
मिज़ाज	mɪd͡ʒäːd͡ʒ
मिज़ाज	mɪzäːd͡ʒ
मिज़ोरम	mɪd͡ʒoːɾə̃m
मिज़ोरम	mɪzoːɾə̃m
मिटना	mɪʈn̪äː
मिट्टी	mɪʈ̚ʈiː
मिठाई	mɪʈʰäːiː
मिठास	mɪʈʰäːs̪
मित्राई	mɪt̪ɾäːiː
मिथ्या	mɪt̪ʰjäː
मिनट	mɪn̪əʈ
मिन्नत	mɪ̃n̪n̪ət̪
मिमियाना	mɪmijäːn̪äː
मियाँ	mijä̃ː
मिल	mɪl̪
मिलन	mɪl̪ə̃n̪
मिलनसार	mɪl̪ə̃n̪s̪äːɾ
मिलनी	mɪl̪n̪iː
मिलाप	mɪl̪äːp
मिलीभगत	mɪl̪iːbʱəɡət̪
मिल्कियत	mɪl̪kijət̪
मिश्रण	mɪʃɾə̃ɳ
मिश्रधातु	mɪʃɾəd̪ʱäːt̪uː
मिस	mɪs̪
मिसरी	mɪs̪ɾiː
मिसाइल	mɪs̪äːɪl̪
मिसाल	mɪs̪äːl̪
मिसिसॉगा	mɪs̪ɪs̪ɔɡäː
मिसेज़	mɪs̪eːd͡ʒ
मिसेज़	mɪs̪eːz
मिसो	mɪs̪oː
मिस्टर	mɪs̪ʈəɾ
मिस्त्री	mɪs̪t̪ɾiː
मिस्र	mɪs̪ɾ
मीचना	miːt͡ʃn̪äː
मीज़ान	miːd͡ʒä̃ːn̪
मीज़ान	miːzä̃ːn̪
मीठा	miːʈʰäː
मीडिया	miːɖijäː
मीन	mĩːn̪
मीम	mĩːm
मीरा	miːɾäː
मील	miːl̪
मुँडेर	mʊ̃ɳɖeːɾ
मुँहमाँगा	mʊ̃ɦmä̃ːŋɡäː
मुँहासा	mʊ̃ɦäːs̪äː
मुंडन	mʊ̃ɳɖə̃n̪
मुंतज़िम	mʊ̃n̪t̪əd͡ʒɪ̃m
मुंतज़िम	mʊ̃n̪t̪əzɪ̃m
मुंतज़िर	mʊ̃n̪t̪əd͡ʒɪɾ
मुंतज़िर	mʊ̃n̪t̪əzɪɾ
मुंशी	mʊ̃n̪ʃiː
मुंसिफ़ाना	mʊ̃n̪s̪ɪfäːn̪äː
मुंसिफ़ाना	mʊ̃n̪s̪ɪpʰäːn̪äː
मुअज़्ज़िन	mʊəd̚d͡ʒɪ̃n̪
मुअज़्ज़िन	mʊəzzɪ̃n̪
मुअल्लम	mʊəl̪l̪ə̃m
मुअल्लिम	mʊəl̪l̪ɪ̃m
मुआ	mʊäː
मुआयना	mʊäːjn̪äː
मुआवज़ा	mʊäːʋd͡ʒäː
मुआवज़ा	mʊäːʋzäː
मुआहिदा	mʊäːɦɪd̪äː
मुकम्मल	mʊkə̃mməl̪
मुक़दमा	mʊkəd̪mäː
मुक़दमा	mʊqəd̪mäː
मुक़द्दर	mʊkəd̪̚d̪əɾ
मुक़द्दर	mʊqəd̪̚d̪əɾ
मुक़ाबला	mʊkäːbl̪äː
मुक़ाबला	mʊqäːbl̪äː
मुक़ाम	mʊkä̃ːm
मुक़ाम	mʊqä̃ːm
मुकुट	mʊkʊʈ
मुक्का	mʊk̚käː
मुक्केबाज़	mʊk̚keːbäːd͡ʒ
मुक्केबाज़	mʊk̚keːbäːz
मुक्तिवादी	mʊkt̪ɪʋäːd̪iː
मुखड़ा	mʊkʰɽäː
मुखमैथुन	mʊkʰmɛːt̪ʰʊ̃n̪
मुख़ालिफ़त	mʊkʰäːl̪ɪpʰət̪
मुख़ालिफ़त	mʊxäːl̪ɪfət̪
मुख़्तसर	mʊkʰt̪əs̪əɾ
मुख़्तसर	mʊxt̪əs̪əɾ
मुखाभिगम	mʊkʰäːbʱɪɡə̃m
मुखिया	mʊkʰijäː
मुख्यधारा	mʊkʰjəd̪ʱäːɾäː
मुख्यालय	mʊkʰjäːl̪əj
मुग़ल	mʊɡəl̪
मुग़ल	mʊɣəl̪
मुग़लई	mʊɡl̪əiː
मुग़लई	mʊɣl̪əiː
मुग़लिया	mʊɡl̪ijäː
मुग़लिया	mʊɣl̪ijäː
मुग़ालता	mʊɡäːl̪t̪äː
मुग़ालता	mʊɣäːl̪t̪äː
मुजरिम	mʊd͡ʒɾɪ̃m
मुजस्समा	mʊd͡ʒəs̪s̪əmäː
मुज़फ़्फ़राबाद	mʊd͡ʒəpʰpʰəɾäːbäːd̪
मुज़फ़्फ़राबाद	mʊzəffəɾäːbäːd̪
मुजाहिदीन	mʊd͡ʒäːɦɪd̪ĩːn̪
मुझसे	mʊd͡ʒʱs̪eː
मुतअल्लिक़	mʊt̪əəl̪l̪ɪk
मुतअल्लिक़	mʊt̪əəl̪l̪ɪq
मुताबिक	mʊt̪äːbɪk
मुताबिक	mʊt̪äːbɪq
मुदाख़लत	mʊd̪äːkʰəl̪ət̪
मुद्दई	mʊd̪̚d̪əiː
मुद्दा	mʊd̪̚d̪äː
मुद्रणालय	mʊd̪ɾəɳäːl̪əj
मुद्रा	mʊd̪ɾäː
मुनाफ़ा	mʊn̪äːfäː
मुनाफ़ा	mʊn̪äːpʰäː
मुनासिब	mʊn̪äːs̪ɪb
मुनीम	mʊn̪ĩːm
मुन्ना	mʊ̃n̪n̪äː
मुबारकबाद	mʊbäːɾəkbäːd̪
मुम्बई	mʊ̃mbəiː
मुरझाना	mʊɾd͡ʒʱäːn̪äː
मुरदा	mʊɾd̪äː
मुरदाबाद	mʊɾd̪äːbäːd̪
मुराद	mʊɾäːd̪
मुरादाबाद	mʊɾäːd̪äːbäːd̪
मुर्ग़ा	mʊɾɡäː
मुर्ग़ा	mʊɾɣäː
मुर्ग़ाबी	mʊɾɡäːbiː
मुर्ग़ाबी	mʊɾɣäːbiː
मुर्दन	mʊɾd̪ə̃n̪
मुर्दा	mʊɾd̪äː
मुलाक़ात	mʊl̪äːkäːt̪
मुलाक़ात	mʊl̪äːqäːt̪
मुलाज़िम	mʊl̪äːd͡ʒɪ̃m
मुलाज़िम	mʊl̪äːzɪ̃m
मुलायम	mʊl̪äːjə̃m
मुल्तान	mʊl̪t̪ä̃ːn̪
मुल्तानी	mʊl̪t̪äːn̪iː
मुल्ला	mʊl̪l̪äː
मुशायरा	mʊʃäːjɾäː
मुश्ताक़	mʊʃt̪äːk
मुश्ताक़	mʊʃt̪äːq
मुष्टि	mʊʃʈiː
मुसलमान	mʊs̪əl̪mä̃ːn̪
मुसल्ला	mʊs̪əl̪l̪äː
मुसाफ़िर	mʊs̪äːfɪɾ
मुसाफ़िर	mʊs̪äːpʰɪɾ
मुसीबत	mʊs̪iːbət̪
मुस्कुराना	mʊs̪kʊɾäːn̪äː
मुस्टंडा	mʊs̪ʈə̃ɳɖäː
मुस्तक़बिल	mʊs̪t̪əkbɪl̪
मुस्तक़बिल	mʊs̪t̪əqbɪl̪
मुस्लिम	mʊs̪l̪ɪ̃m
मुहतरम	mɔɦɔt̪ɾə̃m
मुहब्बत	mɔɦɔb̚bət̪
मुहम्मद	mɔɦɔ̃mməd̪
मुहर	mɔɦɔɾ
मुहर्रम	mɔɦɔɾɾə̃m
मुहाजिर	mʊɦäːd͡ʒɪɾ
मुहाफ़ज़ाह	mʊɦäːfzäːɦ
मुहाफ़ज़ाह	mʊɦäːpʰd͡ʒäːɦ
मुहावरा	mʊɦäːʋɾäː
मुहिम	mʊɦɪ̃m
मुहैया	mɔɦɔ̯ijäː
मूँग	mũːŋɡ
मूँगफली	mũːŋɡpʰəl̪iː
मूंग	mũːŋɡ
मूतना	muːt̪̚n̪äː
मूत्रमार्ग	muːt̪ɾəmäːɾɡ
मूत्राशय	muːt̪ɾäːʃəj
मूर्खता	muːɾkʰət̪äː
मूर्खतापूर्ण	muːɾkʰt̪äːpuːɾɳ
मूर्छन	muːɾt͡ʃʰə̃n̪
मूर्छा	muːɾt͡ʃʰäː
मूर्तिपूजा	muːɾt̪ɪpuːd͡ʒäː
मूर्तिमान	muːɾt̪iːmä̃ːn̪
मूर्धन्य	muːɾd̪ʱə̃n̪jᵊ
मूलतः	muːl̪t̪əɦ
मूलाक्षर	muːl̪äːkʃəɾ
मूलाधार	muːl̪äːd̪ʱäːɾ
मूली	muːl̪iː
मूल्य	muːl̪jᵊ
मूल्यवान	muːl̪jəʋä̃ːn̪
मूल्यांकन	muːl̪jä̃ːkə̃n̪
मूस	muːs̪
मूसल	muːs̪əl̪
मूसलधार	muːs̪əl̪d̪ʱäːɾ
मूसा	muːs̪äː
मृगतृष्णा	mɾɪɡt̪ɾɪʃɳäː
मृतप्राय	mɾɪt̪pɾäːj
मृत्युदंड	mɾɪt̪jʊd̪ə̃ɳɖ
मृदुता	mɾɪd̪ʊt̪äː
मेंडक	mẽːɳɖək
मेंढक	mẽːɳɖʱək
मेंढ्र	mẽːɳɖʱɾᵊ
मेक्सिको	meːks̪ɪkoː
मेघालय	meːɡʱäːl̪əj
मेज़बान	meːd͡ʒbä̃ːn̪
मेज़बान	meːzbä̃ːn̪
मेमना	mẽːmn̪äː
मेरा	meːɾäː
मेरुदंड	meːɾʊd̪ə̃ɳɖ
मेल	meːl̪
मेलबॉर्न	meːl̪bɔɾn̪
मेला	meːl̪äː
मेवा	meːʋäː
मेवाड़	meːʋäːɽ
मेष	meːʃ
मेहंदी	meːɦn̪d̪iː
मेहनत	meːɦn̪ət̪
मेहनत	mɛɦn̪ət̪
मेहनती	meːɦə̃n̪t̪iː
मेहमान	meːɦmä̃ːn̪
मेहमानदारी	meːɦmä̃ːn̪d̪äːɾiː
मेहमाननवाज़ी	meːɦmä̃ːn̪n̪əʋäːd͡ʒiː
मेहमाननवाज़ी	meːɦmä̃ːn̪n̪əʋäːziː
मेहरबानी	meːɦɾbäːn̪iː
मैं	məɪ̯
मैंने	mɛ̃ːn̪eː
मैथुन	mɛːt̪ʰʊ̃n̪
मैदा	mɛːd̪äː
मैदान	mɛːd̪ä̃ːn̪
मैनचेस्टर	mɛ̃ːn̪t͡ʃeːs̪ʈəɾ
मैना	mɛːn̪äː
मैनेजर	mɛːn̪eːd͡ʒəɾ
मैलवेयर	mɛːl̪ʋeːjəɾ
मैला	mɛːl̪äː
मैसिडोनिया	mɛːs̪ɪɖoːn̪ijäː
मैसूर	mɛːs̪uːɾ
मॉड्यूल	mɔɖjuːl̪
मॉरीतानिया	mɔɾiːt̪äːn̪ijäː
मॉल	mɔl̪
मोंटेनीगरो	mõːɳʈeːn̪iːɡɾoː
मोज़ा	moːd͡ʒäː
मोज़ा	moːzäː
मोज़ांबीक	moːd͡ʒä̃ːmbiːk
मोज़ांबीक	moːzä̃ːmbiːk
मोड़ना	moːɽn̪äː
मोनाको	moːn̪äːkoː
मोबाइल	moːbäːɪl̪
मोबिलिटी	moːbɪl̪ɪʈiː
मोम	mõːm
मोमबत्ती	mõːmbət̪̚t̪iː
मोरक्को	moːɾək̚koː
मोरनी	moːɾn̪iː
मोर्चा	moːɾt͡ʃäː
मोल	moːl̪
मोहताज	moːɦt̪äːd͡ʒ
मोहना	moːɦn̪äː
मोहरा	moːɦɾäː
मोहलत	mɔɦl̪ət̪
मौक़ा	mɔːkäː
मौक़ा	mɔːqäː
मौजूदा	mɔːd͡ʒuːd̪äː
मौन	mɔ̃ːn̪
मौलवी	mɔːl̪ʋiː
मौला	mɔːl̪äː
मौलाना	mɔːl̪äːn̪äː
मौलिक	mɔːl̪ɪk
मौसंबी	mɔːs̪ə̃mbiː
मौसम	mɔːs̪ə̃m
मौसमी	mɔːs̪miː
मौसमीपन	mɔːs̪miːpə̃n̪
मौसा	mɔːs̪äː
मौसी	mɔːs̪iː
मौसीक़ी	mɔːs̪iːkiː
मौसीक़ी	mɔːs̪iːqiː
म्यान	mjä̃ːn̪
म्यानमार	mjä̃ːn̪mäːɾ
म्यान्मा	mjä̃ːn̪mäː
म्लेच्छ	ml̪eːt̚t͡ʃʰ
यंत्र	jə̃n̪t̪ɾə
यंत्रीकृत	jə̃n̪t̪ɾiːkɾɪt̪
यक़ीनन	jəkiːn̪ə̃n̪
यक़ीनन	jəqiːn̪ə̃n̪
यज्ञकर्ता	jəɡjəkəɾt̪äː
यतीम	jət̪ĩːm
यतीमख़ाना	jət̪ĩːmkʰäːn̪äː
यतीमख़ाना	jət̪ĩːmxäːn̪äː
यत्न	jət̪̚n̪ᵊ
यथा	jət̪ʰäː
यथाक्रम	jət̪ʰäːkɾə̃m
यथारूप	jət̪ʰäːɾuːp
यथार्थ	jət̪ʰäːɾt̪ʰ
यथार्थता	jət̪ʰäːɾt̪ʰət̪äː
यम	jə̃m
यमन	jəmə̃n̪
यमराज	jə̃mɾäːd͡ʒ
यमुना	jəmʊn̪äː
यरुशलम	jəɾʊʃəl̪ə̃m
यवनिका	jəʋn̪ɪkäː
यवशर्करा	jəʋʃəɾkəɾäː
यशायाह	jəʃäːjäːɦ
यहाँ	jəɦä̃ː
यहेज़क़ेल	jəɦeːd͡ʒkeːl̪
यहेज़क़ेल	jəɦeːzqeːl̪
या	jäː
यांत्रिक	jä̃ːn̪t̪ɾɪk
यांत्रिकी	jä̃ːn̪t̪ɾɪkiː
याचिका	jäːt͡ʃɪkäː
याजक	jäːd͡ʒək
यातायात	jäːt̪äːjäːt̪
यातु	jäːt̪uː
यात्रा	jäːt̪ɾäː
यात्री	jäːt̪ɾiː
याद	jäːd̪
यादगार	jäːd̪ɡäːɾ
याददाश्त	jäːd̪̚d̪äːʃt̪
यादाश्त	jäːd̪äːʃt̪
यादृच्छिक	jäːd̪ɾɪt̚t͡ʃʰɪk
यान	jä̃ːn̪
यानाति	jäːn̪äːt̪iː
यानी	jäːn̪iː
यार	jäːɾ
यिर्मियाह	jɪɾmijäːɦ
युगल	jʊɡəl̪
युग्मनज	jʊɡmən̪əd͡ʒ
युद्धक	jʊd̪̚d̪ʱək
युद्धकाल	jʊd̪̚d̪ʱkäːl̪
युद्धक्षेत्र	jʊd̪d̪ʱkʃeːt̪ɾᵊ
युद्धनीति	jʊd̪̚d̪ʱn̪iːt̪iː
युद्धप्रिय	jʊd̪̚d̪ʱpɾijᵊ
युद्धबंदी	jʊd̪d̪ʱbə̃n̪d̪iː
युद्धस्थल	jʊd̪d̪ʱs̪t̪ʰəl̪
युवा	jʊʋäː
युवावस्था	jʊʋäːʋəs̪t̪ʰäː
यूक्रेन	juːkɾẽːn̪
यूनान	juːn̪ä̃ːn̪
यूनानी	juːn̪äːn̪iː
यूनिकोड	juːn̪ɪkoːɖ
यूनिवर्सिटी	juːn̪ɪʋəɾs̪ɪʈiː
यूरेनियम	juːɾeːn̪ijə̃m
यूहन्ना	juːɦə̃n̪n̪äː
येड़ा	jeːɽäː
योकोहामा	joːkoːɦäːmäː
योग	joːɡäː
योगदान	joːɡd̪ä̃ːn̪
योगिनी	joːɡɪn̪iː
योग्यकार्ता	joːɡjəkäːɾt̪äː
योजना	joːd͡ʒn̪äː
योज्यता	joːd͡ʒjət̪äː
योद्धा	joːd̪̚d̪ʱäː
योनि	joːn̪iː
यौन	jɔ̃ːn̪
यौनाकर्षण	jɔːn̪äːkəɾʃə̃ɳ
यौम	jɔ̃ːm
यौवन	jə̯uʋə̃n̪
यौवनकाल	jə̯uʋə̃n̪käːl̪
रंग	ɾə̃ŋɡ
रंगकर्म	ɾə̃ŋɡkəɾm
रंगकर्मी	ɾə̃ŋɡkəɾmiː
रंगमंच	ɾə̃ŋɡmə̃n̪t͡ʃ
रंगरूट	ɾə̃ŋɡɾuːʈ
रंगीन	ɾə̃ŋɡĩːn̪
रंगीला	ɾə̃ŋɡiːl̪äː
रंगोली	ɾə̃ŋɡoːl̪iː
रंजन	ɾə̃n̪d͡ʒə̃n̪
रंजित	ɾə̃n̪d͡ʒɪt̪
रंजिश	ɾə̃n̪d͡ʒɪʃ
रंडी	ɾə̃ɳɖiː
रंभा	ɾə̃mbʱäː
रईस	ɾəiːs̪
रक़बा	ɾəkbäː
रक़बा	ɾəqbäː
रक़म	ɾəkə̃m
रक़म	ɾəqə̃m
रक़्क़ासा	ɾək̚käːs̪äː
रक़्क़ासा	ɾəqqäːs̪äː
रक़्स	ɾəks̪
रक़्स	ɾəqs̪
रकाबी	ɾəkäːbiː
रक्खना	ɾək̚kʰn̪äː
रक्तचाप	ɾəkt̪̚t͡ʃäːp
रक्तपात	ɾəkt̪päːt̪
रक्तसंचार	ɾəkt̪s̪ə̃n̪t͡ʃäːɾ
रक्षण	ɾəkʃə̃ɳ
रक्षा	ɾəkʃäː
रक्षाबंधन	ɾəkʃäːbə̃n̪d̪ʱə̃n̪
रक्षित	ɾəkʃɪt̪
रखना	ɾəkʰn̪äː
रखवाल	ɾəkʰʋäːl̪
रखवाला	ɾəkʰʋäːl̪äː
रखा	ɾəkʰäː
रगड़न	ɾəɡɽə̃n̪
रगड़ना	ɾəɡəɽn̪äː
रचना	ɾət͡ʃn̪äː
रचनावली	ɾət͡ʃn̪äːʋəl̪iː
रज़ाकार	ɾəd͡ʒäːkäːɾ
रज़ाकार	ɾəzäːkäːɾ
रज़ामंद	ɾəd͡ʒäːmə̃n̪d̪
रज़ामंद	ɾəzäːmə̃n̪d̪
रज़ामंदी	ɾəd͡ʒäːmə̃n̪d̪iː
रज़ामंदी	ɾəzäːmə̃n̪d̪iː
रजिस्टर	ɾəd͡ʒɪs̪ʈəɾ
रजिस्ट्रीकृत	ɾəd͡ʒɪs̪ʈɾiːkɾɪt̪
रजोदर्शन	ɾəd͡ʒoːd̪əɾʃə̃n̪
रटना	ɾəʈn̪äː
रणछोड़	ɾə̃ɳt͡ʃʰoːɽ
रणनीतिक	ɾə̃ɳn̪iːt̪ɪk
रतन	ɾət̪ə̃n̪
रतालू	ɾət̪äːl̪uː
रत्ती	ɾət̪̚t̪iː
रत्न	ɾət̪ə̃n̪
रत्न	ɾət̪̚n̪ᵊ
रन	ɾə̃n̪
रनवास	ɾə̃n̪wäːs̪
रमणीय	ɾə̃mɳiːjᵊ
रमना	ɾə̃mn̪äː
रवा	ɾəʋäː
रवांडा	ɾəʋä̃ːɳɖäː
रवाना	ɾəʋäːn̪äː
रवानी	ɾəʋäːn̪iː
रविवार	ɾəʋɪʋäːɾ
रवैया	ɾəʋə̯ijäː
रशिया	ɾəʃijäː
रस	ɾəs̪
रसगुल्ला	ɾəs̪ɡʊl̪l̪äː
रसद	ɾəs̪əd̪
रसना	ɾəs̪n̪äː
रसभरी	ɾəs̪bʱəɾiː
रसायन	ɾəs̪äːjə̃n̪
रसायनज्ञ	ɾəs̪äːjən̪əɡj
रसीद	ɾəs̪iːd̪
रसूल	ɾəs̪uːl̪
रसूलुल्लाह	ɾəs̪uːl̪ʊl̪l̪äːɦ
रसोइया	ɾəs̪oːijäː
रसोई	ɾəs̪oːiː
रसोईघर	ɾəs̪oːiːɡʱəɾ
रसोईया	ɾəs̪oːiːjäː
रस्म	ɾəs̪m
रस्म	ɾəs̪ə̃m
रस्सा	ɾəs̪s̪äː
रस्सी	ɾəs̪s̪iː
रहना	ɾɛɦn̪äː
रहनुमा	ɾɛɦn̪ʊmäː
रहमान	ɾɛɦmä̃ːn̪
रहस्य	ɾɛɦɛs̪jᵊ
रहस्यमय	ɾɛɦɛs̪jəməj
रहा	ɾəɦäː
रहीम	ɾəɦĩːm
राँची	ɾä̃ːt͡ʃiː
राँझा	ɾä̃ːn̪d͡ʒʱäː
रांची	ɾä̃ːt͡ʃiː
राइफ़ल	ɾäːɪfəl̪
राइफ़ल	ɾäːɪpʰəl̪
राकेट	ɾäːkeːʈ
राख	ɾäːkʰ
राखी	ɾäːkʰiː
राग	ɾäːɡ
रागमाला	ɾäːɡmäːl̪äː
रागी	ɾäːɡiː
राज	ɾäːd͡ʒ
राजकुमार	ɾäːd͡ʒkʊmäːɾ
राजकुमारी	ɾäːd͡ʒkʊmäːɾiː
राजकोट	ɾäːd͡ʒkoːʈ
राजग	ɾäːd͡ʒəɡ
राजत्व	ɾäːd͡ʒət̪wᵊ
राजद	ɾäːd͡ʒəd̪
राजदूत	ɾäːd͡ʒd̪uːt̪
राजधानी	ɾäːd͡ʒd̪ʱäːn̪iː
राजनय	ɾäːd͡ʒn̪əj
राजनयिक	ɾäːd͡ʒn̪əjɪk
राजनीति	ɾäːd͡ʒn̪iːt̪iː
राजनीतिक	ɾäːd͡ʒn̪iːt̪ɪk
राजनीतिज्ञ	ɾäːd͡ʒn̪iːt̪ɪɡj
राजनैतिक	ɾäːd͡ʒn̪ɛːt̪ɪk
राजमा	ɾäːd͡ʒmäː
राजमार्ग	ɾäːd͡ʒmäːɾɡ
राजवंश	ɾäːd͡ʒʋə̃n̪ʃ
राजस्थान	ɾäːd͡ʒəs̪t̪ʰä̃ːn̪
राजस्थानी	ɾäːd͡ʒəs̪t̪ʰäːn̪iː
राजस्व	ɾäːd͡ʒəs̪ʋᵊ
राजहंस	ɾäːd͡ʒʱə̃n̪s̪
राज़	ɾäːd͡ʒ
राज़	ɾäːz
राज़ी	ɾäːd͡ʒiː
राज़ी	ɾäːziː
राजा	ɾäːd͡ʒäː
राजेश	ɾäːd͡ʒeːʃ
राज्य	ɾäːd͡ʒjᵊ
राज्यपाल	ɾäːd͡ʒjəpäːl̪
राज्यवार	ɾäːd͡ʒjəʋäːɾ
राज्यानुसार	ɾäːd͡ʒjäːn̪ʊs̪äːɾ
रात	ɾäːt̪
रात्रि	ɾäːt̪ɾiː
रान	ɾä̃ːn̪
रानी	ɾäːn̪iː
राब्ता	ɾäːbt̪äː
राम	ɾä̃ːm
रामचंद्र	ɾä̃ːmt͡ʃə̃n̪d̪ɾᵊ
रामबाण	ɾä̃ːmbä̃ːɳ
रामरज	ɾä̃ːmɾəd͡ʒ
रामलीला	ɾä̃ːml̪iːl̪äː
रामल्लाह	ɾäːməl̪l̪äːɦ
रामायण	ɾäːmäːjə̃ɳ
रामायणी	ɾäːmäːjəɳiː
राय	ɾäːj
रायता	ɾäːjt̪äː
रार	ɾäːɾ
रावत	ɾäːʋət̪
रावलपिंडी	ɾäːʋəl̪pɪ̃ɳɖiː
राशन	ɾäːʃə̃n̪
राशि	ɾäːʃiː
राशिफल	ɾäːʃɪpʰəl̪
राष्ट्र	ɾäːʃʈɾᵊ
राष्ट्रगान	ɾäːʃʈɾəɡä̃ːn̪
राष्ट्रपति	ɾäːʃʈɾəpt̪iː
राष्ट्रपिता	ɾäːʃʈɾəpɪt̪äː
राष्ट्रवाद	ɾäːʃʈɾəʋäːd̪
राष्ट्रीय	ɾäːʃʈɾiːjᵊ
रासो	ɾäːs̪oː
रास्ता	ɾäːs̪t̪äː
राह	ɾäːɦ
राहत	ɾäːɦət̪
राही	ɾäːɦiː
रिंच	ɾɪ̃n̪t͡ʃ
रिक्तिका	ɾɪkt̪ɪkäː
रिक्शा	ɾɪkʃäː
रिक्शावाला	ɾɪkʃäːʋäːl̪äː
रिज़ल्ट	ɾɪd͡ʒəl̪ʈ
रिज़ल्ट	ɾɪzəl̪ʈ
रिमझिम	ɾɪ̃md͡ʒʱɪ̃m
रियाज़	ɾijäːd͡ʒ
रियाज़	ɾijäːz
रियाद	ɾijäːd̪
रियायत	ɾijäːjət̪
रियासत	ɾijäːs̪ət̪
रिवाज	ɾɪʋäːd͡ʒ
रिवाज़	ɾɪʋäːd͡ʒ
रिवाज़	ɾɪʋäːz
रिश्ता	ɾɪʃt̪äː
रिश्तेदार	ɾɪʃt̪eːd̪äːɾ
रिसाला	ɾɪs̪äːl̪äː
रिहा	ɾɪɦäː
रिहाई	ɾɪɦäːiː
रीट्वीट	ɾiːʈwiːʈ
रीता	ɾiːt̪äː
रुकना	ɾʊkn̪äː
रुकावट	ɾʊkäːʋəʈ
रुग्णालय	ɾʊɡɳäːl̪əj
रुचिरा	ɾʊt͡ʃɪɾäː
रुझान	ɾʊd͡ʒʱä̃ːn̪
रुद्रवीणा	ɾʊd̪ɾəʋiːɳäː
रुद्राक्ष	ɾʊd̪ɾäːkʃ
रुपया	ɾʊpjäː
रुपया	ɾʊpəjäː
रुलाना	ɾʊl̪äːn̪äː
रूठना	ɾuːʈʰn̪äː
रूठा	ɾuːʈʰäː
रूढ़िवाद	ɾuːɽʱɪʋäːd̪
रूपरेखा	ɾuːpɾeːkʰäː
रूबल	ɾuːbəl̪
रूमाल	ɾuːmäːl̪
रूस	ɾuːs̪
रूसी	ɾuːs̪iː
रूहानियत	ɾuːɦäːn̪ijət̪
रेंगना	ɾẽːŋɡn̪äː
रेख़ता	ɾeːkʰt̪äː
रेख़ता	ɾeːxt̪äː
रेख़्ता	ɾeːkʰt̪äː
रेख़्ता	ɾeːxt̪äː
रेखा	ɾeːkʰäː
रेखाखंड	ɾeːkʰäːkʰə̃ɳɖ
रेज़गारी	ɾeːd͡ʒɡäːɾiː
रेज़गारी	ɾeːzɡäːɾiː
रेडियो	ɾeːɖijoː
रेडॉन	ɾeːɖɔ̃n̪
रेतना	ɾeːt̪̚n̪äː
रेल	ɾeːl̪
रेलगाड़ी	ɾeːl̪ɡäːɽiː
रेलवे	ɾeːl̪ʋeː
रेस्तराँ	ɾeːs̪t̪əɾä̃ː
रेस्तराँ	ɾeːs̪t̪ɾä̃ː
रैन	ɾɛ̃ːn̪
रैनबसेरा	ɾɛ̃ːn̪bəs̪eːɾäː
रोंगटा	ɾõːŋɡʈäː
रोकड़िया	ɾoːkɽijäː
रोकथाम	ɾoːkt̪ʰä̃ːm
रोकना	ɾoːkn̪äː
रोका	ɾoːkäː
रोज़गार	ɾoːd͡ʒɡäːɾ
रोज़गार	ɾoːzɡäːɾ
रोज़मर्रा	ɾoːd͡ʒməɾɾäː
रोज़मर्रा	ɾoːzməɾɾäː
रोज़ा	ɾoːd͡ʒäː
रोज़ा	ɾoːzäː
रोज़ाना	ɾoːd͡ʒäːn̪äː
रोज़ाना	ɾoːzäːn̪äː
रोड़ा	ɾoːɽäː
रोपना	ɾoːpn̪äː
रोपाई	ɾoːpäːiː
रोमांच	ɾoːmä̃ːt͡ʃ
रोमांचक	ɾoːmä̃ːt͡ʃək
रोमानिया	ɾoːmäːn̪ijäː
रोशनी	ɾoːʃn̪iː
रोहिंग्या	ɾoːɦɪ̃ŋɡjäː
रौंदना	ɾɔ̃ːn̪d̪n̪äː
रौज़न	ɾɔːd͡ʒə̃n̪
रौज़न	ɾɔːzə̃n̪
रौनक़	ɾɔːn̪ək
रौनक़	ɾɔːn̪əq
रौशन	ɾɔːʃə̃n̪
रौशनी	ɾɔːʃn̪iː
ल	l̪ə
लँगड़ाना	l̪ə̃ŋɡɽäːn̪äː
लंकिलाट	l̪ə̃ŋkɪl̪äːʈ
लंगड़ा	l̪ə̃ŋɡɽäː
लंगराई	l̪ə̃ŋɡɾäːiː
लंगूर	l̪ə̃ŋɡuːɾ
लंगोटी	l̪ə̃ŋɡoːʈiː
लंड	l̪ə̃ɳɖ
लंदन	l̪ə̃n̪d̪ə̃n̪
लंबाई	l̪ə̃mbäːiː
लंबू	l̪ə̃mbuː
लंभा	l̪ə̃mbʱäː
लकीर	l̪əkiːɾ
लक्षण	l̪əkʃə̃ɳ
लक्ष्मी	l̪əkʃmiː
लखन	l̪əkʰə̃n̪
लखनऊ	l̪əkʰn̪əuː
लगता	l̪əɡt̪äː
लगन	l̪əɡə̃n̪
लगना	l̪əɡn̪äː
लगभग	l̪əɡbʱəɡ
लगान	l̪əɡä̃ːn̪
लगाना	l̪əɡäːn̪äː
लगावट	l̪əɡäːʋəʈ
लगी	l̪əɡiː
लगूहा	l̪əɡuːɦäː
लगे	l̪əɡeː
लग्न	l̪əɡn̪ᵊ
लघु	l̪əɡʱuː
लघुगणक	l̪əɡʱʊɡəɳək
लघ्वातु	l̪əɡʱʋäːt̪uː
लचकना	l̪ət͡ʃəkn̪äː
लज़ीज़	l̪əd͡ʒiːd͡ʒ
लज़ीज़	l̪əziːz
लजाना	l̪əd͡ʒäːn̪äː
लज्जा	l̪əd̚d͡ʒäː
लज्जित	l̪əd̚d͡ʒɪt̪
लट	l̪əʈ
लटकना	l̪əʈəkn̪äː
लटकाना	l̪əʈkäːn̪äː
लट्टू	l̪əʈ̚ʈuː
लडका	l̪əɽkäː
लडकी	l̪əɽkiː
लड़कपन	l̪əɽəkpə̃n̪
लड़का	l̪əɽkäː
लड़की	l̪əɽkiː
लड़खड़ाना	l̪əɽkʰəɽäːn̪äː
लड़ना	l̪əɽn̪äː
लड़ाई	l̪əɽäːiː
लड़ाका	l̪əɽäːkäː
लड़ाकू	l̪əɽäːkuː
लड्डू	l̪əɖ̚ɖuː
लण्ड	l̪ə̃ɳɖ
लताड़ना	l̪ət̪äːɽn̪äː
लतीफ़ा	l̪ət̪iːfäː
लतीफ़ा	l̪ət̪iːpʰäː
लथपथ	l̪ət̪ʰpət̪ʰ
लद्दाख़	l̪əd̪̚d̪äːkʰ
लद्दाख़	l̪əd̪̚d̪äːx
लपकना	l̪əpəkn̪äː
लपेटना	l̪əpeːʈn̪äː
लफड़ा	l̪əpʰɽäː
लफ़ंगा	l̪əfə̃ŋɡäː
लफ़ंगा	l̪əpʰə̃ŋɡäː
लफ़्ज़	l̪əfz
लफ़्ज़	l̪əpʰd͡ʒ
लब	l̪əb
लब्धि	l̪əbd̪ʱiː
लमहा	l̪ə̃mɦäː
लय	l̪əj
ललकार	l̪əl̪käːɾ
ललकारना	l̪əl̪käːɾn̪äː
ललचाना	l̪əl̪t͡ʃäːn̪äː
ललाट	l̪əl̪äːʈ
लवड़ा	l̪əʋɽäː
लवण	l̪əʋə̃ɳ
लश्कर	l̪əʃkəɾ
लश्करी	l̪əʃkəɾiː
लसन	l̪əs̪ə̃n̪
लहंगा	l̪ɛːɦŋɡäː
लहंगा	l̪ɛːɦɛ̃ːŋɡäː
लहज़ा	l̪ɛɦd͡ʒäː
लहज़ा	l̪ɛɦzäː
लहजा	l̪ɛɦd͡ʒäː
लहर	l̪ɛɦɛɾ
लहरा	l̪ɛɦɾäː
लहसुन	l̪ɛɦs̪ʊ̃n̪
लाँघना	l̪ä̃ːŋɡʱn̪äː
लांछन	l̪ä̃ːn̪t͡ʃʰə̃n̪
लांछित	l̪ä̃ːn̪t͡ʃʰɪt̪
लाइन	l̪äːɪ̃n̪
लाइम	l̪äːɪ̃m
लाइसेंस	l̪äːɪs̪ẽːn̪s̪
लाई	l̪äːiː
लाओस	l̪äːoːs̪
लाख	l̪äːkʰ
लागत	l̪äːɡət̪
लागू	l̪äːɡuː
लाचार	l̪äːt͡ʃäːɾ
लाजवर्द	l̪äːd͡ʒʋəɾd̪
लाजवाब	l̪äːd͡ʒəʋäːb
लाज़िम	l̪äːd͡ʒɪ̃m
लाज़िम	l̪äːzɪ̃m
लाट	l̪äːʈ
लाठ	l̪äːʈʰ
लाड़	l̪äːɽ
लाड़काना	l̪äːɽkäːn̪äː
लात	l̪äːt̪
लातविया	l̪äːt̪wijäː
लातीनी	l̪äːt̪iːn̪iː
लादना	l̪äːd̪̚n̪äː
लानत	l̪äːn̪ət̪
लाना	l̪äːn̪äː
लापता	l̪äːpət̪äː
लापरवाह	l̪äːpəɾʋäːɦ
लापरवाही	l̪äːpəɾʋäːɦiː
लापसी	l̪äːps̪iː
लाफा	l̪äːpʰäː
लाबु	l̪äːbuː
लाभ	l̪äːbʱ
लाभकारक	l̪äːbʱkäːɾək
लाभदायक	l̪äːbʱd̪äːjək
लायक	l̪äːjək
लायक	l̪äːjəq
लायक़	l̪äːjək
लायक़	l̪äːjəq
लार	l̪äːɾ
लाल	l̪äːl̪
लालच	l̪äːl̪ət͡ʃ
लालची	l̪äːl̪t͡ʃiː
लालटेन	l̪äːl̪ʈẽːn̪
लालफ़ीता	l̪äːl̪fiːt̪äː
लालफ़ीता	l̪äːl̪pʰiːt̪äː
लालफ़ीताशाही	l̪äːl̪fiːt̪äːʃäːɦiː
लालफ़ीताशाही	l̪äːl̪pʰiːt̪äːʃäːɦiː
लालसा	l̪äːl̪s̪äː
लालायित	l̪äːl̪äːjɪt̪
लालित्य	l̪äːl̪ɪt̪jᵊ
लिंग	l̪ɪ̃ŋɡ
लिंगानुपात	l̪ɪ̃ŋɡäːn̪ʊpäːt̪
लिंगायत	l̪ɪ̃ŋɡäːjət̪
लिए	l̪ɪeː
लिख	l̪ɪkʰ
लिखता	l̪ɪkʰt̪äː
लिखती	l̪ɪkʰt̪iː
लिखते	l̪ɪkʰt̪eː
लिखना	l̪ɪkʰn̪äː
लिखने	l̪ɪkʰn̪eː
लिखनेवाला	l̪ɪkʰn̪eːʋäːl̪äː
लिखनेवाली	l̪ɪkʰn̪eːʋäːl̪iː
लिखा	l̪ɪkʰäː
लिखाई	l̪ɪkʰäːiː
लिखावट	l̪ɪkʰäːʋəʈ
लिखिए	l̪ɪkʰɪeː
लिखित	l̪ɪkʰɪt̪
लिखी	l̪ɪkʰiː
लिखे	l̪ɪkʰeː
लिखो	l̪ɪkʰoː
लिख्टेंश्टाइन	l̪ɪkʰʈẽːn̪ʃʈäːɪ̃n̪
लिथुआनिया	l̪ɪt̪ʰʊäːn̪ijäː
लिपटना	l̪ɪpəʈn̪äː
लिपि	l̪ɪpiː
लिप्यंतरण	l̪ɪpjə̃n̪t̪əɾə̃ɳ
लिफ़ाफ़ा	l̪ɪfäːfäː
लिफ़ाफ़ा	l̪ɪpʰäːpʰäː
लिबास	l̪ɪbäːs̪
लिमिटेड	l̪ɪmɪʈeːɖ
लिवरपूल	l̪ɪʋəɾpuːl̪
लिसान	l̪ɪs̪ä̃ːn̪
लिस्ट	l̪ɪs̪ʈ
लिहाज़ा	l̪ɪɦäːd͡ʒäː
लिहाज़ा	l̪ɪɦäːzäː
लीची	l̪iːt͡ʃiː
लीडरी	l̪iːɖəɾiː
लीड्स	l̪iːɖs̪
लीद	l̪iːd̪
लीबिया	l̪iːbijäː
लीलना	l̪iːl̪n̪äː
लीला	l̪iːl̪äː
लुंगी	l̪ʊ̃ŋɡiː
लुंबिनी	l̪ʊ̃mbɪn̪iː
लुग़त	l̪ʊɡət̪
लुग़त	l̪ʊɣət̪
लुग़ात	l̪ʊɡäːt̪
लुग़ात	l̪ʊɣäːt̪
लुगाई	l̪ʊɡäːiː
लुचपन	l̪ʊt͡ʃpə̃n̪
लुच्चा	l̪ʊt̚t͡ʃäː
लुटेरा	l̪ʊʈeːɾäː
लुत्फ़	l̪ʊt̪f
लुत्फ़	l̪ʊt̪pʰ
लुधियाना	l̪ʊd̪ʱijäːn̪äː
लुप्त	l̪ʊpt̪
लुभाना	l̪ʊbʱäːn̪äː
लूक़ा	l̪uːkäː
लूक़ा	l̪uːqäː
लेकर	l̪eːkəɾ
लेकिन	l̪eːkɪ̃n̪
लेख	l̪eːkʰ
लेखक	l̪eːkʰək
लेखन	l̪eːkʰə̃n̪
लेखनी	l̪eːkʰən̪iː
लेखा	l̪eːkʰäː
लेखाकार	l̪eːkʰäːkäːɾ
लेखाचित्र	l̪eːkʰäːt͡ʃɪt̪ɾᵊ
लेखिका	l̪eːkʰɪkäː
लेटना	l̪eːʈn̪äː
लेना	l̪eːn̪äː
लेनिनवाद	l̪eːn̪ɪ̃n̪wäːd̪
लेबनान	l̪eːbn̪ä̃ːn̪
लेबनॉन	l̪eːbn̪ɔ̃n̪
लेस्टर	l̪eːs̪ʈəɾ
लैंगिक	l̪ɛ̃ːŋɡɪk
लैंडर	l̪ɛ̃ːɳɖəɾ
लैब	l̪ɛːb
लॉकडाउन	l̪ɔkɖäːʊ̃n̪
लोक	l̪oːk
लोकगीत	l̪oːkɡiːt̪
लोकतांत्रिक	l̪oːkt̪ä̃ːn̪t̪ɾɪk
लोकनायक	l̪oːkn̪äːjək
लोकनृत्य	l̪oːkn̪ɾɪt̪jᵊ
लोकप्रिय	l̪oːkəpɾɪj
लोकप्रियता	l̪oːkəpɾɪjt̪äː
लोकसभा	l̪oːkəs̪bʱäː
लोकसाहित्य	l̪oːks̪äːɦɪt̪jᵊ
लोकाचार	l̪oːkäːt͡ʃäːɾ
लोकाट	l̪oːkäːʈ
लोकोक्ति	l̪oːkoːkt̪iː
लोग	l̪oːɡ
लोगो	l̪oːɡoː
लोगों	l̪oːɡõː
लोचा	l̪oːt͡ʃäː
लोजबान	l̪oːd͡ʒbä̃ːn̪
लोटपोट	l̪oːʈpoːʈ
लोटा	l̪oːʈäː
लोथ	l̪oːt̪ʰ
लोन	l̪õːn̪
लोबिया	l̪oːbijäː
लोभ	l̪oːbʱ
लोमड़ी	l̪õːmɽiː
लोल	l̪oːl̪
लोहड़ी	l̪oːɦɽiː
लोहिया	l̪oːɦijäː
लोहू	l̪oːɦuː
लौ	l̪ɔː
लौंग	l̪ɔ̃ːŋɡ
लौंडा	l̪ɔ̃ːɳɖäː
लौआ	l̪ɔːäː
लौकी	l̪ɔːkiː
लौड़ा	l̪ɔːɽäː
लौहपथगामिनी	l̪ɔːɦpət̪ʰɡäːmɪn̪iː
लौहपथगामिनीसूचकदर्शकहरितताम्रलौहपट्टिका	l̪ɔːɦpət̪ʰɡäːmɪn̪iːs̪uːt͡ʃəkd̪əɾʃəkʰəɾɪt̪̚t̪ä̃ːmɾəl̪ɔːɦpəʈ̚ʈɪkäː
ल्हासा	l̪ɦäːs̪äː
वंगन	ʋə̃ŋɡə̃n̪
वंचित	ʋə̃n̪t͡ʃɪt̪
वंटन	ʋə̃ɳʈə̃n̪
वंदना	ʋə̃n̪d̪ən̪äː
वंश	ʋə̃n̪ʃ
वंशज	ʋə̃n̪ʃəd͡ʒ
वंशवाद	ʋə̃n̪ʃʋäːd̪
वंशावली	ʋə̃n̪ʃäːʋəl̪iː
वक़्फ़ा	ʋəkpʰäː
वक़्फ़ा	ʋəqfäː
वकालत	ʋəkäːl̪ət̪
वक्ता	ʋəkt̪äː
वक्ष	ʋəkʃ
वचन	ʋət͡ʃə̃n̪
वज़न	ʋəd͡ʒə̃n̪
वज़न	ʋəzə̃n̪
वड़ा	ʋəɽäː
वड़ोदरा	ʋəɽoːd̪ɾäː
वतन	ʋət̪ə̃n̪
वतनपरस्त	ʋət̪ə̃n̪pəɾəs̪t̪
वन	ʋə̃n̪
वनों	ʋən̪õː
वन्य	ʋə̃n̪jᵊ
वफ़ा	ʋəfäː
वफ़ा	ʋəpʰäː
वफ़ादार	ʋəfäːd̪äːɾ
वफ़ादार	ʋəpʰäːd̪äːɾ
वयस्क	ʋəjəs̪k
वरण	ʋəɾə̃ɳ
वरियाली	ʋəɾijäːl̪iː
वरीयता	ʋəɾiːjt̪äː
वरुण	ʋəɾʊ̃ɳ
वर्गहीन	ʋəɾɡɦĩːn̪
वर्गीकरण	ʋəɾɡiːkəɾə̃ɳ
वर्चुअल	ʋəɾt͡ʃʊəl̪
वर्णमाला	ʋəɾɳmäːl̪äː
वर्णविपर्यास	ʋəɾɳəʋɪpəɾjäːs̪
वर्णहीन	ʋəɾɳɦĩːn̪
वर्तमान	ʋəɾt̪əmä̃ːn̪
वर्तुल	ʋəɾt̪ʊl̪
वर्दीधारी	ʋəɾd̪iːd̪ʱäːɾiː
वर्मसरट	ʋəɾms̪əɾəʈ
वर्मा	ʋəɾmäː
वर्ष	ʋəɾʃ
वर्षा	ʋəɾʃäː
वली	ʋəl̪iː
वलीअहद	ʋəl̪iːɛɦɛd̪
वसंत	ʋəs̪ə̃n̪t̪
वसन्त	ʋəs̪ə̃n̪t̪
वसीयत	ʋəs̪iːjət̪
वसूल	ʋəs̪uːl̪
वस्तु	ʋəs̪t̪uː
वस्त्र	ʋəs̪t̪ɾᵊ
वहम	ʋɛɦɛ̃m
वहमी	ʋɛɦmiː
वहशत	ʋɛɦʃət̪
वहशी	ʋɛɦʃiː
वा	ʋäː
वाइटफ़ील्ड	ʋäːɪʈfiːl̪ɖ
वाइटफ़ील्ड	ʋäːɪʈpʰiːl̪ɖ
वाइन	ʋäːɪ̃n̪
वाक़ई	ʋäːkəiː
वाक़ई	ʋäːqəiː
वाकिफ	ʋäːkɪpʰ
वाकिफ	ʋäːqɪf
वाक्य	ʋäːkjᵊ
वाचिक	ʋäːt͡ʃɪk
वाजिब	ʋäːd͡ʒɪb
वाटर	ʋäːʈəɾ
वाटिका	ʋäːʈɪkäː
वाणिज्य	ʋäːɳɪd͡ʒjᵊ
वाणी	ʋäːɳiː
वाताद	ʋäːt̪äːd̪
वातानुकूलक	ʋäːt̪äːn̪ʊkuːl̪ək
वातानुकूलन	ʋäːt̪äːn̪ʊkuːl̪ə̃n̪
वातानुकूलित	ʋäːt̪äːn̪ʊkuːl̪ɪt̪
वातावरण	ʋäːt̪äːʋəɾə̃ɳ
वादसभा	ʋäːd̪s̪əbʱäː
वादा	ʋäːd̪äː
वाद्य	ʋäːd̪jᵊ
वाद्ययंत्र	ʋäːd̪jəjə̃n̪t̪ɾᵊ
वानर	ʋäːn̪əɾ
वापस	ʋäːpəs̪
वापसी	ʋäːps̪iː
वापिस	ʋäːpɪs̪
वामन	ʋäːmə̃n̪
वामपंथी	ʋä̃ːmpə̃n̪t̪ʰiː
वायदा	ʋäːjd̪äː
वायु	ʋäːjuː
वायुजनित	ʋäːjʊd͡ʒən̪ɪt̪
वायुमंडलीय	ʋäːjʊmə̃ɳɖl̪iːjᵊ
वायुसेना	ʋäːjuːs̪eːn̪äː
वार	ʋäːɾ
वारक	ʋäːɾək
वारदात	ʋäːɾd̪äːt̪
वारिस	ʋäːɾɪs̪
वार्ता	ʋäːɾt̪äː
वार्तालाप	ʋäːɾt̪äːl̪äːp
वार्षिक	ʋäːɾʃɪk
वालिदैन	ʋäːl̪ɪd̪ɛ̃ːn̪
वाली	ʋäːl̪iː
वाष्प	ʋäːʃp
वाष्पचालित	ʋäːʃpt͡ʃäːl̪ɪt̪
वाष्पन	ʋäːʃpə̃n̪
वाष्पीकरण	ʋäːʃpiːkəɾə̃ɳ
वाष्पोत्सर्जन	ʋäːʃpoːt̪s̪əɾd͡ʒə̃n̪
वासना	ʋäːs̪n̪äː
वासी	ʋäːs̪iː
वासुदेव	ʋäːs̪ʊd̪eːʋ
वास्कट	ʋäːs̪kəʈ
वास्तव	ʋäːs̪t̪əʋ
वास्तविक	ʋäːs̪t̪əʋɪk
वास्तविकता	ʋäːs̪t̪əʋɪkt̪äː
वास्तु	ʋäːs̪t̪uː
वास्तुकला	ʋäːs̪t̪ʊkəl̪äː
वाहक	ʋäːɦək
वाहन	ʋäːɦə̃n̪
वाहिका	ʋäːɦɪkäː
विंडसर	ʋɪ̃ɳɖs̪əɾ
विंदालू	ʋɪ̃n̪d̪äːl̪uː
विकसित	ʋɪks̪ɪt̪
विकार	ʋɪkäːɾ
विकास	ʋɪkäːs̪
विकासशील	ʋɪkäːs̪ʃiːl̪
विकिपीडिया	ʋɪkɪpiːɖijäː
विकिमीडिया	ʋɪkɪmiːɖijäː
विकिरण	ʋɪkɪɾə̃ɳ
विकिरणशील	ʋɪkɪɾə̃ɳʃiːl̪
विकिरणशीलता	ʋɪkɪɾə̃ɳʃiːl̪t̪äː
विक्रम	ʋɪkɾə̃m
विक्रेता	ʋɪkɾeːt̪äː
विक्षनरी	ʋɪkʃn̪əɾiː
विक्षनरी	ʋɪkʃə̃n̪ɾiː
विखंडन	ʋɪkʰə̃ɳɖə̃n̪
विख्यात	ʋɪkʰjäːt̪
विघ्न	ʋɪɡʱn̪ᵊ
विचार	ʋɪt͡ʃäːɾ
विचारधारा	ʋɪt͡ʃäːɾd̪ʱäːɾäː
विचारपूर्वक	ʋɪt͡ʃäːɾpuːɾʋək
विजयनगरम	ʋɪd͡ʒjən̪əɡɾə̃m
विजयादशमी	ʋɪd͡ʒjäːd̪əʃmiː
विज़ारत	ʋɪd͡ʒäːɾət̪
विज़ारत	ʋɪzäːɾət̪
विजेता	ʋɪd͡ʒeːt̪äː
विज्ञान	ʋɪɡjä̃ːn̪
विज्ञापन	ʋɪɡjäːpə̃n̪
विज्ञापित	ʋɪɡjäːpɪt̪
वितरण	ʋɪt̪ɾə̃ɳ
वित्तीय	ʋɪt̪̚t̪iːjᵊ
विदा	ʋɪd̪äː
विद्या	ʋɪd̪jäː
विद्यार्थिनी	ʋɪd̪jäːɾt̪ʰɪn̪iː
विद्यार्थी	ʋɪd̪jäːɾt̪ʰiː
विद्यालय	ʋɪd̪jäːl̪əj
विद्यालयी	ʋɪd̪jäːl̪əjiː
विद्युतदर्शी	ʋɪd̪jʊt̪̚d̪əɾʃiː
विद्युन्मय	ʋɪd̪jʊ̃n̪məj
विद्वान	ʋɪd̪wä̃ːn̪
विद्वान्	ʋɪd̪wä̃ːn̪
विधवा	ʋɪd̪ʱʋäː
विधा	ʋɪd̪ʱäː
विधानसभा	ʋɪd̪ʱä̃ːn̪s̪əbʱäː
विधायक	ʋɪd̪ʱäːjək
विध्वंस	ʋɪd̪ʱʋə̃n̪s̪
विनती	ʋɪ̃n̪t̪iː
विनम्रता	ʋɪn̪ə̃mɾət̪äː
विनय	ʋɪn̪əj
विना	ʋɪn̪äː
विनाशक	ʋɪn̪äːʃək
विनाशकारी	ʋɪn̪äːʃkäːɾiː
विनिधान	ʋɪn̪ɪd̪ʱä̃ːn̪
विनिपेग	ʋɪn̪ɪpeːɡ
विनिमय	ʋɪn̪ɪməj
विनियम	ʋɪn̪ijə̃m
विनिर्माण	ʋɪn̪ɪɾmä̃ːɳ
विनिवेश	ʋɪn̪ɪʋeːʃ
विनीत	ʋɪn̪iːt̪
विनोद	ʋɪn̪oːd̪
विपक्षी	ʋɪpəkʃiː
विपन्नता	ʋɪpə̃n̪n̪t̪äː
विपुल	ʋɪpʊl̪
विफलता	ʋɪpʰəl̪t̪äː
विभाजन	ʋɪbʱäːd͡ʒə̃n̪
विभाजित	ʋɪbʱäːd͡ʒɪt̪
विभिन्न	ʋɪbʱɪ̃n̪n̪ᵊ
विभीषिका	ʋɪbʱiːʃɪkäː
विमा	ʋɪmäː
विमान	ʋɪmä̃ːn̪
विमानतल	ʋɪmä̃ːn̪t̪əl̪
विमाननगर	ʋɪmä̃ːn̪n̪əɡəɾ
वियतनाम	ʋijət̪̚n̪ä̃ːm
विराजमान	ʋɪɾäːd͡ʒmä̃ːn̪
विराटनगर	ʋɪɾäːʈn̪əɡəɾ
विरोधाभास	ʋɪɾoːd̪ʱäːbʱäːs̪
विलंब	ʋɪl̪ə̃mb
विलक्षण	ʋɪl̪əkʃə̃ɳ
विलायती	ʋɪl̪äːjət̪iː
विलास	ʋɪl̪äːs̪
विलासिता	ʋɪl̪äːs̪ɪt̪äː
विलीन	ʋɪl̪ĩːn̪
विवाद	ʋɪʋäːd̪
विवादित	ʋɪʋäːd̪ɪt̪
विवाह	ʋɪʋäːɦ
विविधता	ʋɪʋɪd̪ʱt̪äː
विवेचन	ʋɪʋeːt͡ʃə̃n̪
विशाखपट्नम	ʋɪʃäːkʰpəʈn̪ə̃m
विशेषकर	ʋɪʃeːʃkəɾ
विशेषज्ञ	ʋɪʃeːʃəɡj
विशेषण	ʋɪʃeːʃə̃ɳ
विशेषता	ʋɪʃeːʃt̪äː
विश्रामालय	ʋɪʃɾäːmäːl̪əj
विश्लेषक	ʋɪʃl̪eːʃək
विश्लेषण	ʋɪʃl̪eːʃə̃ɳ
विश्वकर्मा	ʋɪʃʋəkəɾmäː
विश्वप्रसिद्ध	ʋɪʃʋəpɾəs̪ɪd̪d̪ʱ
विश्वभाषा	ʋɪʃʋəbʱäːʃäː
विश्वमारी	ʋɪʃʋəmäːɾiː
विश्वविख्यात	ʋɪʃʋəʋɪkʰjäːt̪
विश्वविद्यालय	ʋɪʃʋəʋɪd̪jäːl̪əj
विश्वास	ʋɪʃʋäːs̪
विश्वासघात	ʋɪʃʋäːs̪ɡʱäːt̪
विश्वासनीय	ʋɪʃʋäːs̪n̪iːjᵊ
विश्वासपात्र	ʋɪʃʋäːs̪päːt̪ɾᵊ
विष	ʋɪʃ
विषकन्या	ʋɪʃkə̃n̪jäː
विषम	ʋɪʃə̃m
विषय	ʋɪʃəj
विषयवस्तु	ʋɪʃəjʋəs̪t̪uː
विषयासक्त	ʋɪʃəjäːs̪əkt̪
विषाणु	ʋɪʃäːɳuː
विषुव	ʋɪʃʊʋ
विष्णु	ʋɪʃɳuː
विसर्जन	ʋɪs̪əɾd͡ʒə̃n̪
विसर्जित	ʋɪs̪əɾd͡ʒɪt̪
विस्तार	ʋɪs̪t̪äːɾ
विस्थापन	ʋɪs̪t̪ʰäːpə̃n̪
विस्फोट	ʋɪs̪pʰoːʈ
विस्फोटक	ʋɪs̪pʰoːʈək
विस्मय	ʋɪs̪məj
विहीन	ʋɪɦĩːn̪
वीज़ा	ʋiːd͡ʒäː
वीज़ा	ʋiːzäː
वीडियो	ʋiːɖijoː
वीरता	ʋiːɾt̪äː
वीरान	ʋiːɾä̃ːn̪
वृक्ष	ʋɾɪkʃ
वृत्तांत	ʋɾɪt̪̚t̪ä̃ːn̪t̪
वृत्तान्त	ʋɾɪt̪̚t̪ä̃ːn̪t̪
वृद्धावस्था	ʋɾɪd̪̚d̪ʱäːʋəs̪t̪ʰäː
वृद्धाश्रम	ʋɾɪd̪̚d̪ʱäːʃɾə̃m
वृद्धि	ʋɾɪd̪̚d̪ʱiː
वेंटिलेटर	ʋẽːɳʈɪl̪eːʈəɾ
वेटिकन	ʋeːʈɪkə̃n̪
वेदना	ʋeːd̪̚n̪äː
वेदांत	ʋeːd̪ä̃ːn̪t̪
वेनेज़ुएला	ʋeːn̪eːd͡ʒʊeːl̪äː
वेनेज़ुएला	ʋeːn̪eːzʊeːl̪äː
वेबकॅम	ʋeːbkæ̃m
वेबसाइट	ʋeːbs̪äːɪʈ
वेलिंग्टन	ʋeːl̪ɪ̃ŋɡʈə̃n̪
वेल्ला	ʋeːl̪l̪äː
वेश्या	ʋeːʃjäː
वेश्यावृत्ति	ʋeːʃjäːʋɾɪt̪̚t̪iː
वैंकूवर	ʋɛ̃ːŋkuːʋəɾ
वैकुंठ	ʋɛːkʊ̃ɳʈʰ
वैकुण्ठ	ʋɛːkʊ̃ɳʈʰ
वैगन	ʋɛːɡə̃n̪
वैचारिक	ʋɛːt͡ʃäːɾɪk
वैज्ञानिक	ʋɛːɡjäːn̪ɪk
वैतनिक	ʋɛːt̪ən̪ɪk
वैराग्य	ʋɛːɾäːɡjᵊ
वैवाहिक	ʋɛːʋäːɦɪk
वैशाख	ʋɛːʃäːkʰ
वॉशिंगटन	ʋɔʃɪ̃ŋɡʈə̃n̪
वोल्गा	ʋoːl̪ɡäː
व्यंग	ʋjə̃ŋɡ
व्यंग्य	ʋjə̃ŋɡjᵊ
व्यंजक	ʋjə̃n̪d͡ʒək
व्यंजन	ʋjə̃n̪d͡ʒə̃n̪
व्यंजनाक्षर	ʋjə̃n̪d͡ʒən̪äːkʃəɾ
व्यक्तित्व	ʋjəkt̪ɪt̪wᵊ
व्यजन	ʋjəd͡ʒə̃n̪
व्यतिक्रम	ʋjət̪ɪkɾə̃m
व्यथा	ʋjət̪ʰäː
व्यभिचार	ʋjəbʱɪt͡ʃäːɾ
व्यवकलन	ʋjəʋkəl̪ə̃n̪
व्यवसाय	ʋjəʋs̪äːj
व्यवस्था	ʋjəʋəs̪t̪ʰäː
व्यवहार	ʋjəʋɦäːɾ
व्यष्टि	ʋjəʃʈiː
व्यसन	ʋjəs̪ə̃n̪
व्यस्त	ʋjəs̪t̪
व्याकरण	ʋjäːkəɾə̃ɳ
व्याकुल	ʋjäːkʊl̪
व्याख्या	ʋjäːkʰjäː
व्याख्याता	ʋjäːkʰjäːt̪äː
व्याख्यान	ʋjäːkʰjä̃ːn̪
व्याख्यानदाता	ʋjäːkʰjä̃ːn̪d̪äːt̪äː
व्याख्यायित	ʋjäːkʰjäːjɪt̪
व्याधि	ʋjäːd̪ʱiː
व्यापक	ʋjäːpək
व्यापार	ʋjäːpäːɾ
व्यायाम	ʋjäːjä̃ːm
व्यावहारिक	ʋjäːʋɦäːɾɪk
व्यास	ʋjäːs̪
व्युत्क्रम	ʋjʊt̪kɾə̃m
व्युत्पत्ति	ʋjʊt̪pət̪̚t̪iː
व्युत्पन्न	ʋjʊt̪pə̃n̪n̪ᵊ
व्यूहरचना	ʋjuːɦɾət͡ʃn̪äː
व्लादिमीर	ʋl̪äːd̪ɪmiːɾ
व्लादिवोस्तोक	ʋl̪äːd̪ɪʋoːs̪t̪oːk
व्हेल	ʋɦeːl̪
शंघाई	ʃə̃ŋɡʱäːiː
शंतनु	ʃə̃n̪t̪ən̪uː
शकरकंद	ʃəkəɾkə̃n̪d̪
शक्की	ʃək̚kiː
शक्तिशाली	ʃəkt̪ɪʃäːl̪iː
शक्तिहीन	ʃəkt̪ɪɦĩːn̪
शक्ल	ʃəkl̪ᵊ
शख़्स	ʃəkʰs̪
शख़्स	ʃəxs̪
शख़्सियत	ʃəkʰs̪ijət̪
शख़्सियत	ʃəxs̪ijət̪
शख्स	ʃəkʰs̪
शख्स	ʃəxs̪
शख्सियत	ʃəkʰs̪ijət̪
शख्सियत	ʃəxs̪ijət̪
शगुन	ʃəɡʊ̃n̪
शगूफ़ा	ʃəɡuːfäː
शगूफ़ा	ʃəɡuːpʰäː
शजरा	ʃəd͡ʒɾäː
शतकवीर	ʃət̪əkwiːɾ
शतपाद	ʃət̪päːd̪
शतरंज	ʃət̪ɾə̃n̪d͡ʒ
शताब्दी	ʃət̪äːbd̪iː
शतावर	ʃət̪äːʋəɾ
शनि	ʃən̪iː
शनिवार	ʃən̪ɪʋäːɾ
शफ़ा	ʃəfäː
शफ़ा	ʃəpʰäː
शब्दसूची	ʃəbd̪s̪uːt͡ʃiː
शब्दांश	ʃəbd̪ä̃ːn̪ʃ
शब्दाडंबर	ʃəbd̪äːɖə̃mbəɾ
शब्दार्थ	ʃəbd̪äːɾt̪ʰ
शब्दालंकार	ʃəbd̪äːl̪ə̃ŋkäːɾ
शब्दावली	ʃəbd̪äːʋl̪iː
शमशीर	ʃə̃mʃiːɾ
शमशेर	ʃə̃mʃeːɾ
शमा	ʃəmäː
शयन	ʃəjə̃n̪
शयनकक्ष	ʃəjə̃n̪kəkʃ
शयनागार	ʃəjn̪äːɡäːɾ
शरण	ʃəɾə̃ɳ
शरणागत	ʃəɾɳäːɡət̪
शरणार्थी	ʃəɾɳäːɾt̪ʰiː
शरमाना	ʃəɾmäːn̪äː
शरमिंदा	ʃəɾmɪ̃n̪d̪äː
शराफत	ʃəɾäːfət̪
शराफत	ʃəɾäːpʰət̪
शराब	ʃəɾäːb
शरारत	ʃəɾäːɾət̪
शरियत	ʃəɾijət̪
शरीफ़ा	ʃəɾiːfäː
शरीफ़ा	ʃəɾiːpʰäː
शर्करा	ʃəɾkəɾäː
शर्म	ʃəɾə̃m
शर्मनाक	ʃəɾmn̪äːk
शर्मा	ʃəɾmäː
शर्माना	ʃəɾmäːn̪äː
शर्मिंदगी	ʃəɾmɪ̃n̪d̪ɡiː
शर्मीला	ʃəɾmiːl̪äː
शलगम	ʃəl̪ɡə̃m
शलभ	ʃəl̪əbʱ
शल्यक्रियागार	ʃəl̪jəkɾijäːɡäːɾ
शवयात्रा	ʃəʋjäːt̪ɾäː
शस्त्र	ʃəs̪t̪ɾᵊ
शहंशाह	ʃɛɦɛ̃n̪ʃäːɦ
शहज़ादा	ʃɛɦd͡ʒäːd̪äː
शहज़ादा	ʃɛɦzäːd̪äː
शहज़ादी	ʃɛɦd͡ʒäːd̪iː
शहज़ादी	ʃɛɦzäːd̪iː
शहद	ʃɛɦɛd̪
शहमात	ʃɛɦmäːt̪
शहर	ʃɛɦɛɾ
शहरवासी	ʃɛɦɛɾʋäːs̪iː
शहरी	ʃɛɦɾiː
शहला	ʃɛɦl̪äː
शहादत	ʃəɦäːd̪ət̪
शांति	ʃä̃ːn̪t̪iː
शांतिपूर्ण	ʃä̃ːn̪t̪ɪpuːɾɳ
शाइस्ता	ʃäːɪs̪t̪äː
शाक	ʃäːk
शाकाहारी	ʃäːkäːɦäːɾiː
शाखा	ʃäːkʰäː
शागिर्द	ʃäːɡɪɾd̪
शाणा	ʃäːɳäː
शादी	ʃäːd̪iː
शादीशुदा	ʃäːd̪iːʃʊd̪äː
शान	ʃä̃ːn̪
शानदार	ʃä̃ːn̪d̪äːɾ
शान्ति	ʃä̃ːn̪t̪iː
शाप	ʃäːp
शाबाश	ʃäːbäːʃ
शाबाशी	ʃäːbäːʃiː
शाब्दिक	ʃäːbd̪ɪk
शाम	ʃä̃ːm
शामियाना	ʃäːmijäːn̪äː
शामिल	ʃäːmɪl̪
शायरा	ʃäːjɾäː
शायराना	ʃäːjəɾäːn̪äː
शायराना	ʃäːjɾäːn̪äː
शारजाह	ʃäːɾd͡ʒäːɦ
शारीरिक	ʃäːɾiːɾɪk
शार्क	ʃäːɾk
शाल	ʃäːl̪
शालीन	ʃäːl̪ĩːn̪
शालीनता	ʃäːl̪ĩːn̪t̪äː
शालीनतापूर्वक	ʃäːl̪ĩːn̪t̪äːpuːɾʋək
शावक	ʃäːʋək
शाश्वत	ʃäːʃʋət̪
शासक	ʃäːs̪ək
शासन	ʃäːs̪ə̃n̪
शासनहीनता	ʃäːs̪ə̃n̪ɦiːn̪ət̪äː
शास्त्र	ʃäːs̪t̪ɾᵊ
शास्त्रीय	ʃäːs̪t̪ɾiːjᵊ
शाह	ʃäːɦ
शाहमुखी	ʃäːɦmʊkʰiː
शाहाना	ʃäːɦäːn̪äː
शाही	ʃäːɦiː
शाहीन	ʃäːɦĩːn̪
शिंदे	ʃɪ̃n̪d̪eː
शिकंजा	ʃɪkə̃n̪d͡ʒäː
शिकंजी	ʃɪkə̃n̪d͡ʒiː
शिकम	ʃɪkə̃m
शिकस्त	ʃɪkəs̪t̪
शिकायत	ʃɪkäːjət̪
शिकार	ʃɪkäːɾ
शिकारा	ʃɪkäːɾäː
शिकारी	ʃɪkäːɾiː
शिकोहाबाद	ʃɪkoːɦäːbäːd̪
शिक्षक	ʃɪkʃək
शिक्षण	ʃɪkʃə̃ɳ
शिक्षा	ʃɪkʃäː
शिक्षाकर्मी	ʃɪkʃäːkəɾmiː
शिक्षामित्र	ʃɪkʃäːmɪt̪ɾᵊ
शिक्षार्थी	ʃɪkʃäːɾt̪ʰiː
शिक्षाविद्	ʃɪkʃäːʋɪd̪
शिक्षाशास्त्र	ʃɪkʃäːʃäːs̪t̪ɾᵊ
शिक्षाशास्त्री	ʃɪkʃäːʃäːs̪t̪ɾiː
शिक्षिका	ʃɪkʃɪkäː
शिगात्से	ʃɪɡäːt̪s̪eː
शिथिराति	ʃɪt̪ʰɪɾäːt̪iː
शिद्दत	ʃɪd̪̚d̪ət̪
शिनकानसेन	ʃɪ̃n̪kä̃ːn̪s̪ẽːn̪
शिनजियांग	ʃɪ̃n̪d͡ʒijä̃ːŋɡ
शिनाख़्त	ʃɪn̪äːkʰt̪
शिनाख़्त	ʃɪn̪äːxt̪
शिफ़ा	ʃɪfäː
शिफ़ा	ʃɪpʰäː
शिमला	ʃɪ̃ml̪äː
शिरोरेखा	ʃɪɾoːɾeːkʰäː
शिलांग	ʃɪl̪ä̃ːŋɡ
शिलातैल	ʃɪl̪äːt̪ɛːl̪
शिल्प	ʃɪl̪p
शिल्पकार	ʃɪl̪pkäːɾ
शिल्पशाला	ʃɪl̪pʃäːl̪äː
शिव	ʃɪʋäː
शिवलिंग	ʃɪʋl̪ɪ̃ŋɡ
शिवांबु	ʃɪʋä̃ːmbuː
शिवालय	ʃɪʋäːl̪əj
शिशुशाला	ʃɪʃʊʃäːl̪äː
शिश्न	ʃɪʃn̪ᵊ
शिश्नमुंड	ʃɪʃn̪əmʊ̃ɳɖ
शिश्नो	ʃɪʃn̪oː
शिश्नों	ʃɪʃn̪õː
शिष्य	ʃɪʃjᵊ
शिष्या	ʃɪʃjäː
शीघ्रता	ʃiːɡʱɾət̪äː
शीर्ष	ʃiːɾʃ
शीर्षक	ʃiːɾʃək
शीर्षासन	ʃiːɾʃäːs̪ə̃n̪
शीशा	ʃiːʃäː
शुक्रगुज़ार	ʃʊkɾəɡʊd͡ʒäːɾ
शुक्रगुज़ार	ʃʊkɾəɡʊzäːɾ
शुक्रवार	ʃʊkɾəʋäːɾ
शुक्राणु	ʃʊkɾäːɳuː
शुक्रिया	ʃʊkɾijäː
शुद्धगतिकी	ʃʊd̪̚d̪ʱəɡt̪ɪkiː
शुभकामना	ʃʊbʱkä̃ːmn̪äː
शुभेच्छु	ʃʊbʱeːt̚t͡ʃʰuː
शुरुआत	ʃʊɾʊäːt̪
शुरुआत	ʃʊɾʋäːt̪
शुरुआती	ʃʊɾʊäːt̪iː
शुल्क	ʃʊl̪k
शुष्क	ʃʊʃk
शुष्कफल	ʃʊʃkəpʰəl̪
शूटिंग	ʃuːʈɪ̃ŋɡ
शून्य	ʃũːn̪jə
शूरसेन	ʃuːɾs̪ẽːn̪
शृंखला	ʃɾɪ̃ŋkʰl̪äː
शृंग	ʃɾɪ̃ŋɡ
शेख़ूपुरा	ʃeːkʰuːpʊɾäː
शेख़ूपुरा	ʃeːxuːpʊɾäː
शेयरधारक	ʃeːjəɾd̪ʱäːɾək
शेरनी	ʃeːɾn̪iː
शेष	ʃeːʃ
शैंपू	ʃɛ̃ːmpuː
शैक्षणिक	ʃɛːkʃəɳɪk
शैतान	ʃɛːt̪ä̃ːn̪
शैतानी	ʃɛːt̪äːn̪iː
शैली	ʃɛːl̪iː
शैवाल	ʃɛːʋäːl̪
शोधना	ʃoːd̪ʱn̪äː
शोला	ʃoːl̪äː
शोषण	ʃoːʃə̃ɳ
शोषित	ʃoːʃɪt̪
शौक़ीन	ʃɔːkĩːn̪
शौक़ीन	ʃɔːqĩːn̪
शौचालय	ʃɔːt͡ʃäːl̪əj
शौरसेनी	ʃɔːɾs̪eːn̪iː
श्मशान	ʃməʃä̃ːn̪
श्यान	ʃjä̃ːn̪
श्यानता	ʃjä̃ːn̪t̪äː
श्याम	ʃjä̃ːm
श्यामदेश	ʃjä̃ːmd̪eːʃ
श्येन	ʃjẽːn̪
श्रद्धा	ʃɾəd̪̚d̪ʱäː
श्रद्धालु	ʃɾəd̪̚d̪ʱäːl̪uː
श्रद्धेय	ʃɾəd̪̚d̪ʱeːj
श्रमण	ʃɾəmə̃ɳ
श्रामणेर	ʃɾä̃ːmɳeːɾ
श्रावण	ʃɾäːʋə̃ɳ
श्रीकाकुलम	ʃɾiːkäːkʊl̪ə̃m
श्रीनगर	ʃɾiːn̪əɡəɾ
श्रीफल	ʃɾiːpʰəl̪
श्रीमती	ʃɾĩːmt̪iː
श्रीलंका	ʃɾiːl̪ə̃ŋkäː
श्रोता	ʃɾoːt̪äː
श्लोक	ʃl̪oːk
श्वसन	ʃʋəs̪ə̃n̪
श्वान	ʃʋä̃ːn̪
श्वेता	ʃʋeːt̪äː
ष	ʃə
षट्कोण	ʃəʈkõːɳ
षड्यंत्र	ʃəɖjə̃n̪t̪ɾᵊ
षड्यंत्र	ʃəɽjə̃n̪t̪ɾᵊ
षष्ठी	ʃəʃʈʰiː
षाण्मासिक	ʃä̃ːɳmäːs̪ɪk
स	s̪ə
संकट	s̪ə̃ŋkəʈ
संकलक	s̪ə̃ŋkəl̪ək
संकलन	s̪ə̃ŋkəl̪ə̃n̪
संकल्प	s̪ə̃ŋkəl̪p
संकल्पना	s̪ə̃ŋkəl̪pən̪äː
संकेत	s̪ə̃ŋkeːt̪
संकोच	s̪ə̃ŋkoːt͡ʃ
संक्रमण	s̪ə̃ŋkɾəmə̃ɳ
संक्रमित	s̪ə̃ŋkɾəmɪt̪
संक्रांति	s̪ə̃ŋkɾä̃ːn̪t̪iː
संक्रामक	s̪ə̃ŋkɾäːmək
संक्षय	səŋkʃəj
संक्षिप्त	s̪ə̃ŋkʃɪpt̪
संक्षिप्तीकरण	s̪ə̃ŋkʃɪpt̪iːkəɾə̃ɳ
संख्या	s̪ə̃ŋkʰjäː
संग	s̪ə̃ŋɡ
संगठन	s̪ə̃ŋɡəʈʰə̃n̪
संगठनात्मक	s̪ə̃ŋɡəʈʰən̪äːt̪mək
संगणक	s̪ə̃ŋɡəɳək
संगम	s̪ə̃ŋɡə̃m
संगमरमर	s̪ə̃ŋɡməɾməɾ
संगीत	s̪ə̃ŋɡiːt̪
संगीन	s̪ə̃ŋɡĩːn̪
संगोष्ठी	s̪ə̃ŋɡoːʃʈʰiː
संग्रंथन	s̪ə̃ŋɡɾə̃n̪t̪ʰə̃n̪
संग्रथन	s̪ə̃ŋɡɾət̪ʰə̃n̪
संग्रन्थन	s̪ə̃ŋɡɾə̃n̪t̪ʰə̃n̪
संग्रह	s̪ə̃ŋɡɾəɦ
संग्रहालय	s̪ə̃ŋɡɾəɦäːl̪əj
संग्राम	s̪ə̃ŋɡɾä̃ːm
संघ	s̪ə̃ŋɡʱ
संघीय	s̪ə̃ŋɡʱiːjᵊ
संचयन	s̪ə̃t͡ʃəjə̃n̪
संचार	s̪ə̃n̪t͡ʃäːɾ
संजय	s̪ə̃n̪d͡ʒəj
संजाल	s̪ə̃n̪d͡ʒäːl̪
संज्ञा	s̪ə̃ŋɡjäː
संडास	s̪ə̃ɳɖäːs̪
संत	s̪ə̃n̪t̪
संतरा	s̪ə̃n̪t̪ɾäː
संतान	s̪ə̃n̪t̪ä̃ːn̪
संतुलन	s̪ə̃n̪t̪ʊl̪ə̃n̪
संतुलित	s̪ə̃n̪t̪ʊl̪ɪt̪
संतोष	s̪ə̃n̪t̪oːʃ
संतोषी	s̪ə̃n̪t̪oːʃiː
संदर्भ	s̪ə̃n̪d̪əɾbʱ
संदल	s̪ə̃n̪d̪əl̪
संदिग्ध	s̪ə̃n̪d̪ɪɡd̪ʱ
संदूक़	s̪ə̃n̪d̪uːk
संदूक़	s̪ə̃n̪d̪uːq
संदूक़चा	s̪ə̃n̪d̪uːkt͡ʃäː
संदूक़चा	s̪ə̃n̪d̪uːqt͡ʃäː
संदूषण	s̪ə̃n̪d̪uːʃə̃ɳ
संदेय	s̪ə̃n̪d̪eːj
संदेश	s̪ə̃n̪d̪eːʃ
संदेह	s̪ə̃n̪d̪eːɦ
संध्या	s̪ə̃n̪d̪ʱjäː
संन्यास	s̪ə̃n̪n̪jäːs̪
संन्यासिनी	s̪ə̃n̪n̪jäːs̪ɪn̪iː
संन्यासी	s̪ə̃n̪n̪jäːs̪iː
संपत्ति	s̪ə̃mpət̪̚t̪iː
संपदा	s̪ə̃mpəd̪äː
संपर्क	s̪ə̃mpəɾk
संपादक	s̪ə̃mpäːd̪ək
संपादकीय	s̪ə̃mpäːd̪əkiːjᵊ
संपादन	s̪ə̃mpäːd̪ə̃n̪
संपूर्ण	s̪ə̃mpuːɾɳ
संपूर्णता	s̪ə̃mpuːɾɳt̪äː
संप्रति	s̪ə̃mpɾət̪iː
संप्रदाय	s̪ə̃mpɾəd̪äːj
संप्रभु	s̪ə̃mpɾəbʱuː
संप्रभुता	s̪ə̃mpɾəbʱʊt̪äː
संबंध	s̪ə̃mbə̃n̪d̪ʱ
संबंधी	s̪ə̃mbə̃n̪d̪ʱiː
संबोधित	s̪ə̃mboːd̪ʱɪt̪
संभव	s̪ə̃mbʱəʋ
संभालना	s̪ə̃mbʱäːl̪n̪äː
संभावना	s̪ə̃mbʱäːʋn̪äː
संभोग	s̪ə̃mbʱoːɡ
संयंत्र	s̪ə̃jə̃n̪t̪ɾᵊ
संयम	s̪ə̃jə̃m
संयमिनी	s̪ə̃n̪jəmɪn̪iː
संयमी	s̪ə̃n̪jəmiː
संयुक्त	s̪ə̃jʊkt̪
संयुक्ताक्षर	s̪ə̃jʊkt̪äːkʃəɾ
संयोग	s̪ə̃joːɡ
संयोगवश	s̪ə̃joːɡʋəʃ
संयोजक	s̪ə̃joːd͡ʒək
संयोजकता	s̪ə̃joːd͡ʒəkt̪äː
संरक्षण	s̪ə̃ɾəkʃə̃ɳ
संरक्षणवाद	s̪ə̃ɾəkʃə̃ɳwäːd̪
संरक्षित	s̪ə̃ɾəkʃɪt̪
संरचना	s̪ə̃ɾət͡ʃn̪äː
संरचनात्मक	s̪ə̃ɾət͡ʃn̪äːt̪mək
संलक्षण	s̪ə̃l̪əkʃə̃ɳ
संलग्न	s̪ə̃l̪əɡn̪ᵊ
संलयन	s̪ə̃l̪əjə̃n̪
संलिप्त	s̪ə̃l̪ɪpt̪
संवत्सर	s̪ə̃mwət̪s̪əɾ
संवत्सरी	s̪ə̃mwət̪s̪əɾiː
संवर्धन	s̪ə̃mwəɾd̪ʱə̃n̪
संवहन	s̪ə̃mwɛɦɛ̃n̪
संवाद	s̪ə̃mwäːd̪
संवाददाता	s̪ə̃mwäːd̪̚d̪äːt̪äː
संवाहिका	s̪ə̃mwäːɦɪkäː
संवेग	s̪ə̃mweːɡ
संवेदनशील	s̪ə̃mweːd̪ə̃n̪ʃiːl̪
संवेदना	s̪ə̃mweːd̪̚n̪äː
संवैधानिक	s̪ə̃mwɛːd̪ʱäːn̪ɪk
संशोधन	s̪ə̃n̪ʃoːd̪ʱə̃n̪
संशोधित	s̪ə̃n̪ʃoːd̪ʱɪt̪
संश्लिष्ट	s̪ə̃n̪ʃl̪ɪʂʈ
संसद	s̪ə̃n̪s̪əd̪
संसदीय	s̪ə̃n̪s̪əd̪iːj
संसाधन	s̪ə̃n̪s̪äːd̪ʱə̃n̪
संसार	s̪ə̃n̪s̪äːɾ
संसिद्धि	s̪ə̃n̪s̪ɪd̪̚d̪ʱiː
संस्कारी	s̪ə̃n̪s̪käːɾiː
संस्कृत	s̪ə̃n̪s̪kɾɪt̪
संस्कृति	s̪ə̃n̪s̪kɾɪt̪iː
संस्था	s̪ə̃n̪s̪t̪ʰäː
संस्थान	s̪ə̃n̪s̪t̪ʰä̃ːn̪
संस्थापक	s̪ə̃n̪s̪t̪ʰäːpək
संहार	s̪ə̃ŋɦäːɾ
संहार	s̪ə̃ɦäːɾ
संहिता	s̪ə̃ɦɪt̪äː
सकत	s̪əkət̪
सकता	s̪əkt̪äː
सकना	s̪əkn̪äː
सकर्मक	s̪əkəɾmək
सकल	s̪əkəl̪
सकार	s̪əkäːɾ
सक्त	s̪əkt̪
सक्रिय	s̪əkɾɪj
सक्षम	s̪əkʃə̃m
सक्सेना	s̪əks̪eːn̪äː
सख़्ती	s̪əkʰt̪iː
सख़्ती	s̪əxt̪iː
सखा	s̪əkʰäː
सख्खर	s̪əkʰkʰəɾ
सगाई	s̪əɡäːiː
सघन	s̪əɡʱə̃n̪
सघोष	s̪əɡʱoːʃ
सच	s̪ət͡ʃ
सचमुच	s̪ət͡ʃmʊt͡ʃ
सचित्र	s̪ət͡ʃɪt̪ɾᵊ
सचिव	s̪ət͡ʃɪʋ
सच्चरित्र	s̪ət̚t͡ʃəɾɪt̪ɾᵊ
सच्चा	s̪ət̚t͡ʃäː
सजल	s̪əd͡ʒəl̪
सज़ा	s̪əd͡ʒäː
सज़ा	s̪əzäː
सजाना	s̪əd͡ʒäːn̪äː
सजावट	s̪əd͡ʒäːʋəʈ
सजावटी	s̪əd͡ʒäːʋʈiː
सजीवता	s̪əd͡ʒiːʋt̪äː
सज्जन	s̪əd̚d͡ʒə̃n̪
सज्जा	s̪əd̚d͡ʒäː
सज्जित	s̪əd̚d͡ʒɪt̪
सटकना	s̪əʈəkn̪äː
सटीक	s̪əʈiːk
सट्टा	s̪əʈ̚ʈäː
सट्टेबाज़	s̪əʈ̚ʈeːbäːd͡ʒ
सट्टेबाज़	s̪əʈ̚ʈeːbäːz
सट्टेबाज़ी	s̪əʈ̚ʈeːbäːd͡ʒiː
सट्टेबाज़ी	s̪əʈ̚ʈeːbäːziː
सड़क	s̪əɽək
सड़कछाप	s̪əɽəkt͡ʃʰäːp
सड़ना	s̪əɽn̪äː
सड़सठ	s̪əɽs̪əʈʰ
सड़ियल	s̪əɽijəl̪
सतलुज	s̪ət̪l̪ʊd͡ʒ
सतह	s̪ət̪əɦ
सतहत्तर	s̪ət̪ʰət̪̚t̪əɾ
सताना	s̪ət̪äːn̪äː
सत्तर	s̪ət̪̚t̪əɾ
सत्ता	s̪ət̪̚t̪äː
सत्ताईस	s̪ət̪̚t̪äːiːs̪
सत्तानवे	s̪ət̪̚t̪ä̃ːn̪weː
सत्तारूढ़	s̪ət̪̚t̪äːɾuːɽʱ
सत्तावन	s̪ət̪̚t̪äːʋə̃n̪
सत्तावाद	s̪ət̪̚t̪äːʋäːd̪
सत्तासी	s̪ət̪̚t̪äːs̪iː
सत्य	s̪ət̪jᵊ
सत्याग्रह	s̪ət̪jäːɡɾəɦ
सत्यापन	s̪ət̪jäːpə̃n̪
सत्यापनों	s̪ət̪jäːpn̪õː
सत्रह	s̪ət̪ɾəɦ
सत्वर	s̪ət̪wəɾ
सदन	s̪əd̪ə̃n̪
सदमा	s̪əd̪mäː
सदर	s̪əd̪əɾ
सदर	s̪əd̪ɾ
सदरी	s̪əd̪ɾiː
सदस्य	s̪əd̪əs̪jᵊ
सदा	s̪əd̪äː
सदाबहार	s̪əd̪äːbəɦäːɾ
सदिश	s̪əd̪ɪʃ
सदैव	s̪əd̪ɛːʋ
सद्भावना	s̪əd̪bʱäːʋn̪äː
सधुक्कड़ी	s̪əd̪ʱʊk̚kəɽiː
सन	s̪ə̃n̪
सनक	s̪ən̪ək
सनकना	s̪ən̪əkn̪äː
सनसनी	s̪ə̃n̪s̪ən̪iː
सनसनीख़ेज़	s̪ə̃n̪s̪ən̪iːkʰeːd͡ʒ
सनसनीख़ेज़	s̪ə̃n̪s̪ən̪iːxeːz
सनातन	s̪ən̪äːt̪ə̃n̪
सन्	s̪ə̃n̪
सन्दूक़चा	s̪ə̃n̪d̪uːkt͡ʃäː
सन्दूक़चा	s̪ə̃n̪d̪uːqt͡ʃäː
सन्देह	s̪ə̃n̪d̪eːɦ
सन्नाटा	s̪ə̃n̪n̪äːʈäː
सन्निकट	s̪ə̃n̪n̪ɪkəʈ
सन्निकटन	s̪ə̃n̪n̪ɪkəʈə̃n̪
सपूत	s̪əpuːt̪
सप्तक	s̪əpt̪ək
सप्ताह	s̪əpt̪äːɦ
सप्ताहांत	s̪əpt̪äːɦä̃ːn̪t̪
सफल	s̪əpʰəl̪
सफ़र	s̪əfəɾ
सफ़र	s̪əpʰəɾ
सफ़रनामा	s̪əfəɾn̪äːmäː
सफ़रनामा	s̪əpʰəɾn̪äːmäː
सफ़ाई	s̪əfäːiː
सफ़ाई	s̪əpʰäːiː
सफ़ेद	s̪əfeːd̪
सफ़ेद	s̪əpʰeːd̪
सफेद	s̪əfeːd̪
सफेद	s̪əpʰeːd̪
सब	s̪əb
सबक	s̪əbək
सबक	s̪əbəq
सबब	s̪əbəb
सबील	s̪əbiːl̪
सबूत	s̪əbuːt̪
सब्ज़ी	s̪əbd͡ʒiː
सब्ज़ी	s̪əbziː
सब्ज़ीमंडी	s̪əbd͡ʒiːmə̃ɳɖiː
सब्ज़ीमंडी	s̪əbziːmə̃ɳɖiː
सब्र	s̪əbəɾ
सब्र	s̪əbɾ
सभा	s̪əbʱäː
सभ्य	s̪əbʱjᵊ
सभ्यता	s̪əbʱjət̪äː
सम	s̪ə̃m
समंदर	s̪əmə̃n̪d̪əɾ
समकालीन	s̪ə̃mkäːl̪ĩːn̪
समकोण	s̪ə̃mkõːɳ
समक्ष	s̪əməkʃ
समझदार	s̪əməd͡ʒʱd̪äːɾ
समझना	s̪əməd͡ʒʱn̪äː
समझाना	s̪ə̃md͡ʒʱäːn̪äː
समझौता	s̪ə̃md͡ʒʱɔːt̪äː
समतल	s̪ə̃mt̪əl̪
समधी	s̪ə̃md̪ʱiː
समनुषंगी	s̪ə̃mn̪ʊʃə̃ŋɡiː
समन्वय	s̪əmə̃n̪wəj
समबाहु	s̪ə̃mbäːɦuː
सममिति	s̪ə̃mmɪt̪iː
समय	s̪əməj
समयसारणी	s̪əməjs̪äːɾɳiː
समयसारिणी	s̪əməjs̪äːɾɪɳiː
समयादेश	s̪əməjäːd̪eːʃ
समयानुसार	s̪ə̃mjäːn̪ʊs̪äːɾ
समरूप	s̪ə̃mɾuːp
समर्थ	s̪əməɾt̪ʰ
समर्थक	s̪əməɾt̪ʰək
समर्थन	s̪əməɾt̪ʰə̃n̪
समर्पण	s̪əməɾpə̃ɳ
समष्टि	s̪əməʃʈiː
समसामयिक	s̪ə̃ms̪ä̃ːmjɪk
समस्या	s̪əməs̪jäː
समाकलन	s̪əmäːkl̪ə̃n̪
समाचार	s̪əmäːt͡ʃäːɾ
समाचारपत्र	s̪əmäːt͡ʃäːɾpət̪ɾᵊ
समाज	s̪əmäːd͡ʒ
समाजवाद	s̪əmäːd͡ʒʋäːd̪
समाजवादी	s̪əmäːd͡ʒʋäːd̪iː
समाजसेवा	s̪əmäːd͡ʒs̪eːʋäː
समाधान	s̪əmäːd̪ʱä̃ːn̪
समाधि	s̪əmäːd̪ʱiː
समान	s̪əmä̃ːn̪
समाना	s̪əmäːn̪äː
समापन	s̪əmäːpə̃n̪
समामेलक	s̪əmäːmeːl̪ək
समामेलन	s̪əmäːmeːl̪ə̃n̪
समामेलित	s̪əmäːmeːl̪ɪt̪
समायोजन	s̪əmäːjoːd͡ʒə̃n̪
समायोजित	s̪əmäːjoːd͡ʒɪt̪
समारोह	s̪əmäːɾoːɦ
समालोचना	s̪əmäːl̪oːt͡ʃn̪äː
समावेश	s̪əmäːʋeːʃ
समास	s̪əmäːs̪
समिट	s̪əmɪʈ
समिति	s̪əmɪt̪iː
समीकरण	s̪əmiːkəɾə̃ɳ
समीक्षा	s̪əmiːkʃäː
समीप	s̪əmiːp
समीर	s̪əmiːɾ
समुच्चय	s̪əmʊt̚t͡ʃəj
समुच्चयबोधक	s̪əmʊt̚t͡ʃəjboːd̪ʱək
समुत्थान	s̪əmʊt̪̚t̪ʰä̃ːn̪
समुदाय	s̪əmʊd̪äːj
समुद्र	s̪əmʊd̪ɾᵊ
समूह	s̪əmuːɦ
समूहन	s̪əmuːɦə̃n̪
समृद्धिकरण	s̪ə̃mɾɪd̪̚d̪ʱɪkəɾə̃ɳ
समेकन	s̪əmeːkə̃n̪
समेटना	s̪əmeːʈn̪äː
समेत	s̪əmeːt̪
समोसा	s̪əmoːs̪äː
सम्पत्ति	s̪ə̃mpət̪̚t̪iː
सम्पादक	s̪ə̃mpäːd̪ək
सम्पादन	s̪ə̃mpäːd̪ə̃n̪
सम्पूर्ण	s̪ə̃mpuːɾɳ
सम्बन्धी	s̪ə̃mbə̃n̪d̪ʱiː
सम्मति	s̪ə̃mmət̪iː
सम्मान	s̪ə̃mmä̃ːn̪
सम्मानजनक	s̪ə̃mmä̃ːn̪d͡ʒən̪ək
सम्मिलन	s̪ə̃mmɪl̪ə̃n̪
सम्मिलित	s̪ə̃mmɪl̪ɪt̪
सम्मिश्रण	s̪ə̃mmɪʃɾə̃ɳ
सम्मुख	s̪ə̃mmʊkʰ
सम्मेलन	s̪ə̃mmeːl̪ə̃n̪
सम्यक्	s̪ə̃mjək
सम्राज्ञी	s̪ə̃mɾäːɡjiː
सम्राट	s̪ə̃mɾäːʈ
सयाना	s̪əjäːn̪äː
सय्याद	s̪əjjäːd̪
सर	s̪əɾ
सरंजाम	s̪əɾə̃n̪d͡ʒä̃ːm
सरकंडा	s̪əɾkə̃ɳɖäː
सरकाना	s̪əɾkäːn̪äː
सरकार	s̪əɾkäːɾ
सरगोधा	s̪əɾɡoːd̪ʱäː
सरद	s̪əɾəd̪
सरदार	s̪əɾd̪äːɾ
सरदी	s̪əɾd̪iː
सरपंच	s̪əɾpə̃n̪t͡ʃ
सरफ़रोश	s̪əɾfəɾoːʃ
सरफ़रोश	s̪əɾpʰəɾoːʃ
सरफिरा	s̪əɾpʰɪɾäː
सरल	s̪əɾəl̪
सरलीकृत	s̪əɾl̪iːkɾɪt̪
सरसठ	s̪əɾs̪əʈʰ
सरसों	s̪əɾs̪õː
सरस्वती	s̪əɾəs̪ʋət̪iː
सरहद	s̪əɾɦəd̪
सरहदी	s̪əɾɦəd̪iː
सराइकी	s̪əɾäːɪkiː
सराफ़ा	s̪əɾäːfäː
सराफ़ा	s̪əɾäːpʰäː
सराबोर	s̪əɾäːboːɾ
सराय	s̪əɾäːj
सराहना	s̪əɾäːɦn̪äː
सरी	s̪əɾiː
सरीखा	s̪əɾiːkʰäː
सरीसृप	s̪əɾiːs̪ɾɪp
सरूर	s̪əɾuːɾ
सरेआम	s̪əɾeːä̃ːm
सरोज	s̪əɾoːd͡ʒ
सरोद	s̪əɾoːd̪
सरोरुह	s̪əɾoːɾʊɦ
सर्किल	s̪əɾkɪl̪
सर्जन	s̪əɾd͡ʒə̃n̪
सर्द	s̪əɾd̪
सर्दी	s̪əɾd̪iː
सर्प	s̪əɾp
सर्पिल	s̪əɾpɪl̪
सर्ब	s̪əɾb
सर्बिया	s̪əɾbijäː
सर्वत्र	s̪əɾʋət̪ɾᵊ
सर्वथा	s̪əɾʋt̪ʰäː
सर्वथा	s̪əɾʋət̪ʰäː
सर्वदलीय	s̪əɾʋd̪əl̪iːjᵊ
सर्वनाम	s̪əɾʋn̪ä̃ːm
सर्वनाम	s̪əɾʋən̪ä̃ːm
सर्वप्रथम	s̪əɾʋpɾət̪ʰə̃m
सर्वश्रेष्ठ	s̪əɾʋəʃɾeːʂʈʰ
सर्वसम्मति	s̪əɾʋs̪ə̃mmət̪iː
सर्वसाधारण	s̪əɾʋs̪äːd̪ʱäːɾə̃ɳ
सर्वहारा	s̪əɾʋɦäːɾäː
सर्वांगसम	s̪əɾʋä̃ːŋɡs̪ə̃m
सर्वाधिक	s̪əɾʋäːd̪ʱɪk
सर्विस	s̪əɾʋɪs̪
सर्वेक्षण	s̪əɾʋeːkʃə̃ɳ
सर्वोच्च	s̪əɾʋoːt̚t͡ʃ
सर्वोदय	s̪əɾʋoːd̪əj
सर्वोपरि	s̪əɾʋoːpəɾiː
सर्षप	s̪əɾʃəp
सलवार	s̪əl̪ʋäːɾ
सलहज	s̪əl̪ɛɦɛd͡ʒ
सलाउद्दीन	s̪əl̪äːʊd̪̚d̪ĩːn̪
सलाख	s̪əl̪äːkʰ
सलाम	s̪əl̪ä̃ːm
सलामत	s̪əl̪äːmət̪
सलामी	s̪əl̪äːmiː
सलाह	s̪əl̪äːɦ
सलाहकार	s̪əl̪äːɦkäːɾ
सलीक़ा	s̪əl̪iːkäː
सलीक़ा	s̪əl̪iːqäː
सलीब	s̪əl̪iːb
सलीम	s̪əl̪ĩːm
सलूक	s̪əl̪uːk
सलोतरी	s̪əl̪oːt̪ɾiː
सलोना	s̪əl̪oːn̪äː
सल्तनत	s̪əl̪t̪ən̪ət̪
सवर्ण	s̪əʋəɾɳ
सवा	s̪əʋäː
सवाना	s̪əʋäːn̪äː
सवार	s̪əʋäːɾ
सवाल	s̪əʋäːl̪
सवेरा	s̪əʋeːɾäː
सवेरे	s̪əʋeːɾeː
सशंक	s̪əʃə̃ŋk
सशक्तिकरण	s̪əʃəkt̪ɪkəɾə̃ɳ
सशस्त्र	s̪əʃəs̪t̪ɾᵊ
सशुल्क	s̪əʃʊl̪k
ससुर	s̪əs̪ʊɾ
ससुराल	s̪əs̪ʊɾäːl̪
सस्ता	s̪əs̪t̪äː
सस्ताई	s̪əs̪t̪äːiː
सस्तापन	s̪əs̪t̪äːpə̃n̪
सस्यविज्ञान	s̪əs̪jəʋɪɡjä̃ːn̪
सहकर्मी	s̪ɛɦkəɾmiː
सहकारी	s̪ɛɦkäːɾiː
सहचर	s̪ɛɦt͡ʃəɾ
सहज	s̪ɛɦɛd͡ʒ
सहजात	s̪ɛɦd͡ʒäːt̪
सहन	s̪əɦn̪
सहन	s̪ɛɦɛ̃n̪
सहना	s̪ɛɦn̪äː
सहपाठी	s̪ɛɦpäːʈʰiː
सहबद्ध	s̪ɛɦbəd̪d̪ʱ
सहभागी	s̪ɛɦbʱäːɡiː
सहमत	s̪ɛɦmət̪
सहमति	s̪ɛɦmət̪iː
सहयोग	s̪ɛɦjoːɡ
सहयोगी	s̪ɛɦjoːɡiː
सहर	s̪ɛɦɛɾ
सहरा	s̪ɛɦɾäː
सहरी	s̪ɛɦɾiː
सहलाना	s̪ɛɦl̪äːn̪äː
सहवास	s̪ɛɦʋäːs̪
सहसंयोजक	s̪ɛɦs̪ə̃joːd͡ʒək
सहसा	s̪ɛɦs̪äː
सहस्र	s̪ɛɦɛs̪t̪ɾᵊ
सहस्र	s̪ɛɦɛs̪ɾᵊ
सहस्रपाद	s̪ɛɦɛs̪ɾəpäːd̪
सहस्रमान	s̪ɛɦɛs̪ɾəmä̃ːn̪
सहस्रिमान	s̪ɛɦɛs̪ɾɪmä̃ːn̪
सहायक	s̪əɦäːjək
सहायता	s̪əɦäːjt̪äː
सहारा	s̪əɦäːɾäː
सहित	s̪əɦɪt̪
सही	s̪əɦiː
सहेजना	s̪əɦeːd͡ʒn̪äː
सहेली	s̪əɦeːl̪iː
सहोदर	s̪əɦoːd̪əɾ
स़िफ़र	s̪ɪfəɾ
स़िफ़र	s̪ɪpʰəɾ
साँई	s̪ä̃ːiː
साँझ	s̪ä̃ːn̪d͡ʒʱ
साँड़	s̪ä̃ːɽ
साँप	s̪ä̃ːp
साँवला	s̪ä̃ːʋl̪äː
साँस	s̪ä̃ːs̪
सांख्यिकी	s̪ä̃ːkʰjɪkiː
सांझ	s̪ä̃ːn̪d͡ʒʱ
सांड	s̪ä̃ːɳɖ
सांडा	s̪ä̃ːɳɖäː
सांद्रता	s̪ä̃ːn̪d̪ɾət̪äː
सांप	s̪ä̃ːp
सांप्रदायिकता	s̪ä̃ːpɾəd̪äːjɪkt̪äː
सांबर	s̪ä̃ːmbəɾ
सांस	s̪ä̃ːn̪s̪
सांसद	s̪ä̃ːn̪s̪əd̪
सांस्कृतिक	s̪ä̃ːn̪s̪kɾɪt̪ɪk
साइकल	s̪äːɪkəl̪
साइकिल	s̪äːɪkɪl̪
साइप्रस	s̪äːɪpɾəs̪
साउथहैंपटन	s̪äːʊt̪ʰɦɛ̃ːmpʈə̃n̪
साउथॉल	s̪äːʊt̪ʰɔl̪
साक्षर	s̪äːkʃəɾ
साक्षात्कार	s̪äːkʃäːt̪käːɾ
साक्षी	s̪äːkʃiː
साक्ष्य	s̪äːkʃjᵊ
साख	s̪äːkʰ
साग	s̪äːɡ
सागर	s̪äːɡəɾ
सागौन	s̪äːɡɔ̃ːn̪
साजन	s̪äːd͡ʒə̃n̪
साज़	s̪äːd͡ʒ
साज़	s̪äːz
साज़िश	s̪äːd͡ʒɪʃ
साज़िश	s̪äːzɪʃ
साझा	s̪äːd͡ʒʱäː
साझेदार	s̪äːd͡ʒʱeːd̪äːɾ
साझेदारी	s̪äːd͡ʒʱeːd̪äːɾiː
साठ	s̪äːʈʰ
साड़ी	s̪äːɽiː
साढ़े	s̪äːɽʱeː
सात	s̪äːt̪
सातवाहन	s̪äːt̪wäːɦə̃n̪
साथ	s̪äːt̪ʰ
साथसाथ	s̪äːt̪ʰs̪äːt̪ʰ
साथी	s̪äːt̪ʰiː
साद	s̪äːd̪
सादगी	s̪äːd̪əɡiː
सादा	s̪äːd̪äː
सादिक़ाबाद	s̪äːd̪ɪkäːbäːd̪
सादिक़ाबाद	s̪äːd̪ɪqäːbäːd̪
साधन	s̪äːd̪ʱə̃n̪
साधना	s̪äːd̪ʱn̪äː
साधारण	s̪äːd̪ʱäːɾə̃ɳ
साधारणतः	s̪äːd̪ʱäːɾə̃ɳt̪əɦ
साध्वी	s̪äːd̪ʱʋiː
सानी	s̪äːn̪iː
साप्ताहिक	s̪äːpt̪äːɦɪk
साफ	s̪äːf
साफ	s̪äːpʰ
साफ़	s̪äːf
साफ़	s̪äːpʰ
साबिक	s̪äːbɪk
साबिक	s̪äːbɪq
साबिक़	s̪äːbɪk
साबिक़	s̪äːbɪq
साबित	s̪äːbɪt̪
साबू	s̪äːbuː
साबूदाना	s̪äːbuːd̪äːn̪äː
साम	s̪ä̃ːm
सामग्री	s̪äːməɡɾiː
सामन	s̪äːmə̃n̪
सामना	s̪ä̃ːmn̪äː
सामने	s̪ä̃ːmn̪eː
सामरिक	s̪ä̃ːmɾɪk
सामर्थ्य	s̪äːməɾt̪ʰjə
सामवेद	s̪ä̃ːmweːd̪
सामान	s̪äːmä̃ːn̪
सामान्यतः	s̪äːmä̃ːn̪jət̪əɦ
सामान्यीकृत	s̪äːmä̃ːn̪jiːkɾɪt̪
सामी	s̪äːmiː
सामुदायिक	s̪äːmʊd̪äːjɪk
सामूहिक	s̪äːmuːɦɪk
साम्य	s̪ä̃ːmjᵊ
साम्यवाद	s̪ä̃ːmjəʋäːd̪
साम्यावस्था	s̪ä̃ːmjäːʋəs̪t̪ʰäː
साम्राज्य	s̪ä̃ːmɾäːd͡ʒjᵊ
साम्राज्यवाद	s̪ä̃ːmɾäːd͡ʒjəʋäːd̪
सायबान	s̪äːjbä̃ːn̪
साया	s̪äːjäː
सारंगी	s̪äːɾə̃ŋɡiː
सारणी	s̪äːɾɳiː
सारथी	s̪äːɾət̪ʰiː
सारस	s̪äːɾəs̪
सारा	s̪äːɾäː
सारांश	s̪äːɾä̃ːn̪ʃ
सार्थ	s̪äːɾt̪ʰ
सार्थक	s̪äːɾt̪ʰək
सार्वजनिक	s̪äːɾʋd͡ʒən̪ɪk
सार्वत्रिक	s̪äːɾʋət̪ɾɪk
सार्वभौमिक	s̪äːɾʋəbʱɔːmɪk
साल	s̪äːl̪
सालगिरह	s̪äːl̪ɡɪɾəɦ
सालन	s̪äːl̪ə̃n̪
सालभर	s̪äːl̪bʱəɾ
सालाना	s̪äːl̪äːn̪äː
सावधानी	s̪äːʋd̪ʱäːn̪iː
सास	s̪äːs̪
साहसी	s̪äːɦs̪iː
साहित्य	s̪äːɦɪt̪jᵊ
साहित्यिक	s̪äːɦɪt̪jɪk
साहिब	s̪äːb
साहिब	s̪äːɦb
साहिब	s̪äːɦəb
साहिब	s̪äːɦɪb
साहिल	s̪äːɦɪl̪
साही	s̪äːɦiː
साहूकार	s̪äːɦuːkäːɾ
सिंगापुर	s̪ɪ̃ŋɡäːpʊɾ
सिंघ	s̪ɪ̃ŋɡʱ
सिंचाई	s̪ɪ̃n̪t͡ʃäːiː
सिंचित	s̪ɪ̃n̪t͡ʃɪt̪
सिंदूर	s̪ɪ̃n̪d̪uːɾ
सिंह	s̪ɪ̃ŋɡʱ
सिंहला	s̪ɪ̃ŋɡʱl̪äː
सिंहला	s̪ɪ̃ŋɡʱəl̪äː
सिंहाली	s̪ɪ̃ɦäːl̪iː
सिंहासन	s̪ɪ̃ŋɡʱäːs̪ə̃n̪
सिकंदर	s̪ɪkə̃n̪d̪əɾ
सिकंदराबाद	s̪ɪkə̃n̪d̪əɾäːbäːd̪
सिकोड़ना	s̪ɪkoːɽn̪äː
सिक्का	s̪ɪk̚käː
सिक्किम	s̪ɪk̚kɪ̃m
सिगरेट	s̪ɪɡəɾeːʈ
सिगार	s̪ɪɡäːɾ
सिचुआन	s̪ɪt͡ʃʊä̃ːn̪
सिडनी	s̪ɪɖn̪iː
सितंबर	s̪ɪt̪ə̃mbəɾ
सितम	s̪ɪt̪ə̃m
सितारा	s̪ɪt̪äːɾäː
सिद्ध	s̪ɪd̪d̪ʱ
सिद्धांत	s̪ɪd̪̚d̪ʱä̃ːn̪t̪
सिनेमा	s̪ɪn̪eːmäː
सिनेमाघर	s̪ɪn̪eːmäːɡʱəɾ
सिपाही	s̪ɪpäːɦiː
सिफ़त	s̪ɪfət̪
सिफ़त	s̪ɪpʰət̪
सिफ़र	s̪ɪfəɾ
सिफ़र	s̪ɪpʰəɾ
सिफ़ारत	s̪ɪfäːɾət̪
सिफ़ारत	s̪ɪpʰäːɾət̪
सिफ़ारतख़ाना	s̪ɪfäːɾət̪xäːn̪äː
सिफ़ारतख़ाना	s̪ɪpʰäːɾət̪kʰäːn̪äː
सिफ़ारिश	s̪ɪfäːɾɪʃ
सिफ़ारिश	s̪ɪpʰäːɾɪʃ
सिमटना	s̪ɪməʈn̪äː
सिया	s̪ijäː
सियापति	s̪ijäːpət̪iː
सियाप्पा	s̪ijäːp̚päː
सियार	s̪ijäːɾ
सियालकोट	s̪ijäːl̪koːʈ
सियाह	s̪ijäːɦ
सियाही	s̪ijäːɦiː
सियोल	s̪ijoːl̪
सिर	s̪ɪɾ
सिरका	s̪ɪɾkäː
सिरदर्द	s̪ɪɾd̪əɾd̪
सिरहाना	s̪ɪɾɦäːn̪äː
सिरा	s̪ɪɾäː
सिर्फ	s̪ɪɾf
सिर्फ	s̪ɪɾpʰ
सिलपट	s̪ɪl̪pəʈ
सिलवट	s̪ɪl̪ʋəʈ
सिलवाना	s̪ɪl̪ʋäːn̪äː
सिलसिला	s̪ɪl̪s̪ɪl̪äː
सिलाई	s̪ɪl̪äːiː
सिसकना	s̪ɪs̪əkn̪äː
सी	s̪iː
सींग	s̪ĩːŋɡ
सीखना	s̪iːkʰn̪äː
सीख़चा	s̪iːkʰt͡ʃäː
सीख़चा	s̪iːxt͡ʃäː
सीट	s̪iːʈ
सीठा	s̪iːʈʰäː
सीढ़ी	s̪iːɽʱiː
सीता	s̪iːt̪äː
सीताफल	s̪iːt̪äːpʰəl̪
सीधा	s̪iːd̪ʱäː
सीना	s̪iːn̪äː
सीनेट	s̪iːn̪eːʈ
सीनेटर	s̪iːn̪eːʈəɾ
सीमा	s̪iːmäː
सीमित	s̪iːmɪt̪
सीरत	s̪iːɾət̪
सीरिया	s̪iːɾijäː
सीस	s̪iːs̪
सुंदर	s̪ʊ̃n̪d̪əɾ
सुंदरता	s̪ʊ̃n̪d̪əɾt̪äː
सुअर	s̪ʊəɾ
सुई	s̪uːiː
सुईकार	s̪ʊiːkäːɾ
सुईदाब	s̪ʊiːd̪äːb
सुक़रात	s̪ʊkɾäːt̪
सुक़रात	s̪ʊqɾäːt̪
सुकून	s̪ʊkũːn̪
सुख	s̪ʊkʰ
सुखपूर्वक	s̪ʊkʰpuːɾʋək
सुखमय	s̪ʊkʰməj
सुखाना	s̪ʊkʰäːn̪äː
सुगंध	s̪ʊɡə̃n̪d̪ʱ
सुगन्ध	s̪ʊɡə̃n̪d̪ʱ
सुग्गा	s̪ʊɡɡäː
सुचारु	s̪ʊt͡ʃäːɾuː
सुझाना	s̪ʊd͡ʒʱäːn̪äː
सुझाव	s̪ʊd͡ʒʱäːʋ
सुडौल	s̪ʊɖɔːl̪
सुथरा	s̪ʊt̪ʰɾäː
सुधार	s̪ʊd̪ʱäːɾ
सुधारक	s̪ʊd̪ʱäːɾək
सुधारना	s̪ʊd̪ʱäːɾn̪äː
सुधारवादी	s̪ʊd̪ʱäːɾʋäːd̪iː
सुनना	s̪ʊ̃n̪n̪äː
सुनवाई	s̪ʊ̃n̪wäːiː
सुनसान	s̪ʊ̃n̪s̪ä̃ːn̪
सुनहरा	s̪ʊn̪ɛɦɾäː
सुनाई	s̪ʊn̪äːiː
सुनाना	s̪ʊn̪äːn̪äː
सुनामी	s̪ʊn̪äːmiː
सुनार	s̪ʊn̪äːɾ
सुनीत	s̪ʊn̪iːt̪
सुन्दर	s̪ʊ̃n̪d̪əɾ
सुन्नत	s̪ʊ̃n̪n̪ət̪
सुन्नी	s̪ʊ̃n̪n̪iː
सुपुर्द	s̪ʊpʊɾd̪
सुप्रभात	s̪ʊpɾəbʱäːt̪
सुबकना	s̪ʊbəkn̪äː
सुबह	s̪ʊbəɦ
सुबह	s̪ʊbɦᵊ
सुबह	s̪ʊbʱə
सुबोध	s̪ʊboːd̪ʱ
सुभानअल्लाह	s̪ʊbʱä̃ːn̪‿əl̪l̪äːɦ
सुमन	s̪ʊmə̃n̪
सुमात्रा	s̪ʊmäːt̪ɾäː
सुर	s̪ʊɾ
सुरंग	s̪ʊɾə̃ŋɡ
सुरक्षा	s̪ʊɾəkʃäː
सुरक्षाबल	s̪ʊɾəkʃäːbəl̪
सुरत	s̪ʊɾət̪
सुरमा	s̪ʊɾmäː
सुराख़	s̪ʊɾäːkʰ
सुराख़	s̪ʊɾäːx
सुरिनाम	s̪ʊɾɪn̪ä̃ːm
सुरीला	s̪ʊɾiːl̪äː
सुर्ख़ाब	s̪ʊɾkʰäːb
सुर्ख़ाब	s̪ʊɾxäːb
सुर्ख़ी	s̪ʊɾkʰiː
सुर्ख़ी	s̪ʊɾxiː
सुलझा	s̪ʊl̪d͡ʒʱäː
सुलझाना	s̪ʊl̪d͡ʒʱäːn̪äː
सुलभ	s̪ʊl̪əbʱ
सुलवाना	s̪ʊl̪ʋäːn̪äː
सुलह	s̪ʊl̪əɦ
सुलाना	s̪ʊl̪äːn̪äː
सुलेमान	s̪ʊl̪eːmä̃ːn̪
सुल्टाना	s̪ʊl̪ʈäːn̪äː
सुल्ताना	s̪ʊl̪t̪äːn̪äː
सुविख्यात	s̪ʊʋɪkʰjäːt̪
सुविधा	s̪ʊʋɪd̪ʱäː
सुशासन	s̪ʊʃäːs̪ə̃n̪
सुसंगत	s̪ʊs̪ə̃ŋɡət̪
सुसंस्कृत	s̪ʊs̪ə̃n̪s̪kɾɪt̪
सुसज्जित	s̪ʊs̪əd̚d͡ʒɪt̪
सुस्ताना	s̪ʊs̪t̪äːn̪äː
सुस्ती	s̪ʊs̪t̪iː
सुस्वादु	s̪ʊs̪ʋäːd̪uː
सुस्सा	s̪ʊs̪s̪äː
सुहाग	s̪ʊɦäːɡ
सुहाना	s̪ʊɦäːn̪äː
सुहावना	s̪ʊɦäːʋn̪äː
सूँघना	s̪ũːŋɡʱn̪äː
सूंघना	s̪ũːŋɡʱn̪äː
सूंस	s̪ũːn̪s̪
सूअर	s̪uːəɾ
सूआ	s̪uːäː
सूई	s̪uːiː
सूकरमांस	s̪uːkəɾmä̃ːn̪s̪
सूक्ष्मदर्शी	s̪uːkʃməd̪əɾʃiː
सूक्ष्माणु	s̪uːkʃmäːɳuː
सूखना	s̪uːkʰn̪äː
सूखा	s̪uːkʰäː
सूचक	s̪uːt͡ʃək
सूचना	s̪uːt͡ʃn̪äː
सूचनात्मक	s̪uːt͡ʃn̪äːt̪mək
सूचित	s̪uːt͡ʃɪt̪
सूची	s̪uːt͡ʃiː
सूचीबद्ध	s̪uːt͡ʃiːbəd̪d̪ʱ
सूजन	s̪uːd͡ʒə̃n̪
सूजी	s̪uːd͡ʒiː
सूडान	s̪uːɖä̃ːn̪
सूत	s̪uːt̪
सूतिका	s̪uːt̪ɪkäː
सूतिकागार	s̪uːt̪ɪkäːɡäːɾ
सूतिकागृह	s̪uːt̪ɪkäːɡɾɪɦ
सूती	s̪uːt̪iː
सूत्र	s̪uːt̪ɾᵊ
सूद	s̪uːd̪
सूना	s̪uːn̪äː
सूनू	s̪uːn̪uː
सूबा	s̪uːbäː
सूर	s̪uːɾ
सूरज	s̪uːɾəd͡ʒ
सूरजमुखी	s̪uːɾəd͡ʒmʊkʰiː
सूरिया	s̪uːɾijäː
सूर्य	s̪uːɾjᵊ
सूर्यकांति	s̪uːɾjəkä̃ːn̪t̪iː
सूर्यकान्ति	s̪uːɾjəkä̃ːn̪t̪iː
सूर्यास्त	s̪uːɾjäːs̪t̪
सूर्योदय	s̪uːɾjoːd̪əj
सृजन	s̪ɾɪd͡ʒə̃n̪
सृष्टि	s̪ɾɪʃʈiː
से	s̪eː
सेंकना	s̪ẽːŋkn̪äː
सेंट	s̪ẽːɳʈ
सेंटी	s̪ẽːɳʈiː
सेंटीमीटर	s̪ẽːɳʈiːmiːʈəɾ
सेज	s̪eːd͡ʒ
सेटिंग	s̪eːʈɪ̃ŋɡ
सेटेलाईट	s̪eːʈeːl̪äːiːʈ
सेठ	s̪eːʈʰ
सेना	s̪eːn̪äː
सेनेगल	s̪eːn̪eːɡəl̪
सेब	s̪eːb
सेर	s̪eːɾ
सेल	s̪eːl̪
सेल्फ़ी	s̪eːl̪fiː
सेल्फ़ी	s̪eːl̪pʰiː
सेवँई	s̪eːʋə̃iː
सेवक	s̪eːʋək
सेवा	s̪eːʋäː
सेवानिवृत्त	s̪eːʋäːn̪ɪʋɾɪt̪t̪
सेवानिवृत्ति	s̪eːʋäːn̪ɪʋɾɪt̪̚t̪iː
सेविका	s̪eːʋɪkäː
सेहत	s̪eːɦət̪
सेहतमंद	s̪eːɦət̪mə̃n̪d̪
सेहरा	s̪eːɦɾäː
सेही	s̪eːɦiː
सैंतालीस	s̪ɛ̃ːn̪t̪äːl̪iːs̪
सैंतीस	s̪ɛ̃ːn̪t̪iːs̪
सैकंड	s̪ɛːkə̃ɳɖ
सैकड़ा	s̪ɛːkɽäː
सैकण्ड	s̪ɛːkə̃ɳɖ
सैकता	s̪ɛːkt̪äː
सैद्धांतिक	s̪ɛːd̪̚d̪ʱä̃ːn̪t̪ɪk
सैनिक	s̪ɛːn̪ɪk
सैन्य	s̪ɛ̃ːn̪jᵊ
सैर	s̪ɛːɾ
सैलाब	s̪ɛːl̪äːb
सॉकर	s̪ɔkəɾ
सॉफ़्टवेयर	s̪ɔfʈəʋeːjəɾ
सॉफ़्टवेयर	s̪ɔpʰʈəʋeːjəɾ
सॉरी	s̪ɔɾiː
सॉसेज	s̪ɔs̪eːd͡ʒ
सो	s̪oː
सोआ	s̪oːäː
सोखना	s̪oːkʰn̪äː
सोग	s̪oːɡ
सोचना	s̪oːt͡ʃn̪äː
सोची	s̪oːt͡ʃiː
सोणिया	s̪oːɳijäː
सोता	s̪oːt̪äː
सोना	s̪oːn̪äː
सोनार	s̪oːn̪äːɾ
सोमवार	soːmwaːɾ
सोमालिया	s̪oːmäːl̪ijäː
सोमाली	s̪oːmäːl̪iː
सोलह	s̪oːl̪äːɦ
सोलह	s̪oːl̪əɦ
सोवियत	s̪oːʋijət̪
सोशलिस्ट	s̪oːʃl̪ɪs̪ʈ
सोहाग	s̪oːɦäːɡ
सौ	s̪ɔː
सौंदर्यशास्त्र	s̪ɔ̃ːn̪d̪əɾjəʃäːs̪t̪ɾᵊ
सौंपना	s̪ɔ̃ːmpn̪äː
सौंफ	s̪ɔ̃ːf
सौंफ	s̪ɔ̃ːmpʰ
सौंफ	s̪ɔ̃ːpʰ
सौंह	s̪ɔ̃ːɦ
सौगंद	s̪ɔːɡə̃n̪d̪
सौगन्द	s̪ɔːɡə̃n̪d̪
सौत	s̪ɔːt̪
सौतेला	s̪ɔːt̪eːl̪äː
सौदा	s̪ɔːd̪äː
सौदागर	s̪ɔːd̪äːɡəɾ
सौन्दर्य	s̪ɔ̃ːn̪d̪əɾjᵊ
सौभाग्य	s̪ɔːbʱäːɡjᵊ
सौम्य	s̪ɔ̃ːmjᵊ
सौर	s̪ɔːɾ
सौरमंडल	s̪ɔːɾmə̃ɳɖəl̪
सौराष्ट्र	s̪ɔːɾäːʃʈɾᵊ
सौर्य	s̪ɔːɾjᵊ
स्कर्ट	s̪kəɾʈ
स्कूल	s̪kuːl̪
स्कूली	s̪kuːl̪iː
स्कॉट्स	s̪kɔʈs̪
स्क्रीनिंग	s̪kɾiːn̪ɪ̃ŋɡ
स्खलन	s̪kʰəl̪ə̃n̪
स्टाक	s̪ʈäːk
स्टार	s̪ʈäːɾ
स्टेटस	s̪ʈeːʈəs̪
स्टेडियम	s̪ʈeːɖijə̃m
स्टेथोस्कोप	s̪ʈeːt̪ʰoːs̪koːp
स्टेशन	s̪ɪʈeːʃə̃n̪
स्टेशन	s̪ʈeːʃə̃n̪
स्टेशन	ɪs̪ʈeːʃə̃n̪
स्तंभ	s̪t̪ə̃mbʱ
स्तंभन	s̪t̪ə̃mbʱə̃n̪
स्तनधारी	s̪t̪ə̃n̪d̪ʱäːɾiː
स्तनपायी	s̪t̪ə̃n̪päːjiː
स्तर	s̪t̪əɾ
स्तुति	s̪t̪ʊt̪iː
स्तूप	s̪t̪uːp
स्तूप	s̪t̪uːpəᵊ
स्त्री	s̪t̪ɾiː
स्त्रीत्व	s̪t̪ɾiːt̪wᵊ
स्त्रीलिंग	s̪t̪ɾiːl̪ɪ̃ŋɡ
स्त्रोत	s̪t̪ɾoːt̪
स्थगित	s̪t̪ʰəɡɪt̪
स्थल	s̪t̪ʰəl̪
स्थलीय	s̪t̪ʰəl̪iːjᵊ
स्थाई	s̪t̪ʰäːiː
स्थान	s̪t̪ʰä̃ːn̪
स्थानांतरण	s̪t̪ʰäːn̪ä̃ːn̪t̪ɾə̃ɳ
स्थानीय	s̪t̪ʰäːn̪iːjᵊ
स्थापत्य	s̪t̪ʰäːpət̪jᵊ
स्थापना	s̪t̪ʰäːpn̪äː
स्थापित	s̪t̪ʰäːpɪt̪
स्थायी	s̪t̪ʰäːjiː
स्थायीकार	s̪t̪ʰäːjiːkäːɾ
स्थित	s̪t̪ʰɪt̪
स्थिति	s̪t̪ʰɪt̪iː
स्थितिज	s̪t̪ʰɪt̪ɪd͡ʒ
स्थिर	s̪t̪ʰɪɾ
स्थूल	s̪t̪ʰuːl̪
स्नातक	s̪n̪äːt̪ək
स्नातकोत्तर	s̪n̪äːt̪əkoːt̪̚t̪əɾ
स्नान	s̪n̪ä̃ːn̪
स्नानघर	s̪n̪ä̃ːn̪ɡʱəɾ
स्नानागार	s̪n̪äːn̪äːɡäːɾ
स्नायु	s̪n̪äːjuː
स्निग्ध	s̪n̪ɪɡd̪ʱ
स्नेह	s̪n̪eːɦ
स्नेही	s̪n̪eːɦiː
स्पघेटी	s̪pəɡʱeːʈiː
स्पर्श	s̪pəɾʃ
स्पष्ट	s̪pəʂʈ
स्पष्टतः	s̪pəʃʈət̪əɦ
स्पेन	s̪pẽːn̪
स्पेनी	s̪peːn̪iː
स्पैनिश	s̪pɛːn̪ɪʃ
स्फटयातु	s̪pʰəʈjäːt̪uː
स्मरण	s̪məɾə̃ɳ
स्मरणशक्ति	s̪məɾə̃ɳʃəkt̪iː
स्मरणीय	s̪məɾɳiːjᵊ
स्मारक	s̪mäːɾək
स्मार्टफ़ोन	s̪mäːɾʈfõːn̪
स्मार्टफ़ोन	s̪mäːɾʈpʰõːn̪
स्मृति	s̪mɾɪt̪iː
स्मेरता	s̪meːɾt̪äː
स्यंदन	s̪jə̃n̪d̪ə̃n̪
स्याह	s̪jäːɦ
स्याही	s̪jäːɦiː
स्यूत	s̪juːt̪
स्रोत	s̪ɾoːt̪
स्लाइस	s̪l̪äːɪs̪
स्लोवाकिया	s̪l̪oːʋäːkijäː
स्लोवेनियन	s̪l̪oːʋeːn̪ijə̃n̪
स्लोवेनिया	s̪l̪oːʋeːn̪ijäː
स्वकीय	s̪ʋəkiːjᵊ
स्वकीया	s̪ʋəkiːjäː
स्वचालित	s̪ʋət͡ʃäːl̪ɪt̪
स्वच्छ	s̪ʋət̚t͡ʃʰ
स्वच्छता	s̪ʋət̚t͡ʃʰt̪äː
स्वजन	s̪ʋəd͡ʒə̃n̪
स्वतंत्र	s̪ʋət̪ə̃n̪t̪ɾᵊ
स्वतंत्रता	s̪ʋət̪ə̃n̪t̪ɾət̪äː
स्वतः	s̪ʋət̪əɦ
स्वदेशी	s̪ʋəd̪eːʃiː
स्वभाव	s̪ʋəbʱäːʋ
स्वयं	s̪ʋəjə̃m
स्वर	s̪ʋəɾ
स्वराक्षर	s̪ʋəɾäːkʃəɾ
स्वर्ग	s̪ʋəɾɡ
स्वर्गवासी	s̪ʋəɾɡʋäːs̪iː
स्वर्णकार	s̪ʋəɾɳəkäːɾ
स्वर्णमंदिर	s̪ʋəɾɳmə̃n̪d̪ɪɾ
स्वशिक्षा	s̪ʋəʃɪkʃäː
स्वस्तिक	s̪ʋəs̪t̪ɪk
स्वस्थ	s̪ʋəs̪t̪ʰ
स्वाँग	s̪ʋä̃ːŋɡ
स्वांग	s̪ʋä̃ːŋɡ
स्वागत	s̪ʋäːɡət̪
स्वाद	s̪ʋäːd̪
स्वादु	s̪ʋäːd̪uː
स्वाध्याय	s̪ʋäːd̪ʱjäːj
स्वाभाविक	s̪ʋäːbʱäːʋɪk
स्वामित्व	s̪ʋäːmɪt̪wᵊ
स्वामी	s̪ʋäːmiː
स्वायत्त	s̪ʋäːjət̪t̪
स्वायत्तता	s̪ʋäːjət̪̚t̪ət̪äː
स्वार्थ	s̪ʋäːɾt̪ʰ
स्वार्थी	s̪ʋäːɾt̪ʰiː
स्वास्थ्य	s̪ʋäːs̪t̪ʰjə
स्वाहिली	s̪ʋäːɦɪl̪iː
स्विट्ज़रलैंड	s̪ʋɪʈd͡ʒəɾl̪ɛ̃ːɳɖ
स्विट्ज़रलैंड	s̪ʋɪʈzəɾl̪ɛ̃ːɳɖ
स्विट्ज़रलैण्ड	s̪ʋɪʈd͡ʒəɾl̪ɛ̃ːɳɖ
स्विट्ज़रलैण्ड	s̪ʋɪʈzəɾl̪ɛ̃ːɳɖ
स्वीकार	s̪ʋiːkäːɾ
स्वीकारना	s̪ʋiːkäːɾn̪äː
स्वीकारात्मक	s̪ʋiːkäːɾäːt̪mək
स्वीकृत	s̪ʋiːkɾɪt̪
स्वीकृति	s̪ʋiːkɾɪt̪iː
स्वीडन	s̪ʋiːɖə̃n̪
स्वेच्छा	s̪ʋeːt̚t͡ʃʰäː
स्वेदक	s̪ʋeːd̪ək
स्वेदन	s̪ʋeːd̪ə̃n̪
हँस	ɦə̃s̪
हँसना	ɦə̃s̪n̪äː
हँसली	ɦə̃s̪l̪iː
हँसाना	ɦə̃s̪äːn̪äː
हँसिया	ɦə̃s̪ijäː
हँसी	ɦə̃s̪iː
हंगरी	ɦə̃ŋɡəɾiː
हंगरी	ɦə̃ŋɡɾiː
हंगामा	ɦə̃ŋɡäːmäː
हंगुल	ɦə̃ŋɡʊl̪
हंटर	ɦə̃ɳʈəɾ
हंस	ɦə̃n̪s̪
हकलाना	ɦəkl̪äːn̪äː
हकीम	ɦəkĩːm
हगना	ɦəɡn̪äː
हज़ार	ɦəd͡ʒäːɾ
हज़ार	ɦəzäːɾ
हज़ारहा	ɦəd͡ʒäːɾɦäː
हज़ारहा	ɦəzäːɾɦäː
हज़्म	ɦəd͡ʒə̃m
हज़्म	ɦəzə̃m
हजामत	ɦəd͡ʒäːmət̪
हज्ज	ɦəd̚d͡ʒ
हटना	ɦəʈn̪äː
हटाना	ɦəʈäːn̪äː
हड़गिल्ला	ɦəɽɡɪl̪l̪äː
हड़ताल	ɦəɽt̪äːl̪
हड़ताली	ɦəɽt̪äːl̪iː
हड़बड़ाना	ɦəɽbəɽäːn̪äː
हड्डी	ɦəɖ̚ɖiː
हताश	ɦət̪äːʃ
हताशा	ɦət̪äːʃäː
हताहत	ɦət̪äːɦət̪
हतोत्साहित	ɦət̪oːt̪s̪äːɦɪt̪
हत्या	ɦət̪jäː
हत्यारा	ɦət̪jäːɾäː
हथकरघा	ɦət̪ʰkəɾɡʱäː
हथगोला	ɦət̪ʰɡoːl̪äː
हथियार	ɦət̪ʰijäːɾ
हथियारबंद	ɦət̪ʰijäːɾbə̃n̪d̪
हथेली	ɦət̪ʰeːl̪iː
हथौड़ा	ɦət̪ʰɔːɽäː
हथ्यार	ɦət̪ʰjäːɾ
हदीस	ɦəd̪iːs̪
हनीमून	ɦən̪iːmũːn̪
हनुमान	ɦən̪ʊmä̃ːn̪
हबक्क़ूक़	ɦəbək̚kʊk
हम	ɦə̃m
हमको	ɦə̃mkoː
हमला	ɦə̃ml̪äː
हमलावर	ɦə̃ml̪äːʋəɾ
हमशक्ल	ɦə̃mʃəkl̪ᵊ
हमसफ़र	ɦə̃ms̪əfəɾ
हमसफ़र	ɦə̃ms̪əpʰəɾ
हमसाया	ɦə̃ms̪äːjäː
हमाम	ɦəmä̃ːm
हमारा	ɦəmäːɾäː
हमाहमी	ɦəmäːɦəmiː
हयात	ɦəjäːt̪
हरमसरा	ɦəɾə̃m‿s̪əɾäː
हरा	ɦəɾaː
हराना	ɦəɾäːn̪äː
हराम	ɦəɾä̃ːm
हरामख़ोर	ɦəɾä̃ːmkʰoːɾ
हरामख़ोर	ɦəɾä̃ːmxoːɾ
हरामज़ादा	ɦəɾä̃ːmd͡ʒäːd̪äː
हरामज़ादा	ɦəɾä̃ːmzäːd̪äː
हरामी	ɦəɾäːmiː
हरिजन	ɦəɾɪd͡ʒə̃n̪
हरियाणवी	ɦəɾijä̃ːɳwiː
हरियाणा	ɦəɾijäːɳäː
हरियाली	ɦəɾijäːl̪iː
हरिस	ɦəɾɪs̪
हर्ष	ɦəɾʃ
हर्षित	ɦəɾʃɪt̪
हल	ɦəl̪
हलंत	ɦəl̪ə̃n̪t̪
हलक़	ɦəl̪k
हलक़	ɦəl̪q
हलक़ा	ɦəl̪käː
हलक़ा	ɦəl̪qäː
हलचल	ɦəl̪t͡ʃəl̪
हलदी	ɦəl̪d̪iː
हलफ़नामा	ɦəl̪əfn̪äːmäː
हलफ़नामा	ɦəl̪əpʰn̪äːmäː
हलब	ɦəl̪əb
हलवा	ɦəl̪ʋäː
हलाक	ɦəl̪äːk
हलाल	ɦəl̪äːl̪
हलो	ɦəl̪oː
हल्क़ा	ɦəl̪käː
हल्क़ा	ɦəl̪qäː
हल्का	ɦəl̪käː
हल्दी	ɦəl̪d̪iː
हल्ला	ɦəl̪l̪äː
हवलदार	ɦəʋəl̪d̪äːɾ
हवस	ɦəʋəs̪
हवा	ɦəʋäː
हवाई	ɦəʋäːiː
हवाला	ɦəʋäːl̪äː
हवालात	ɦəʋäːl̪äːt̪
हवेली	ɦəʋeːl̪iː
हसरत	ɦəs̪ɾət̪
हसीन	ɦəs̪ĩːn̪
हसीना	ɦəs̪iːn̪äː
हस्तक्षेप	ɦəs̪t̪əkʃeːp
हस्तत्राण	ɦəs̪t̪ət̪ɾä̃ːɳ
हस्तमैथुन	ɦəs̪t̪mɛːt̪ʰʊ̃n̪
हस्तलिखित	ɦəs̪t̪l̪ɪkʰɪt̪
हस्तशिल्प	ɦəs̪t̪əʃɪl̪p
हस्ताक्षर	ɦəs̪t̪äːkʃəɾ
हस्ती	ɦəs̪t̪iː
हाँ	ɦä̃ː
हाँगर	ɦä̃ːŋɡəɾ
हाइड्रोजन	ɦäːɪɖɾoːd͡ʒə̃n̪
हाइपरटेक्स्ट	ɦäːɪpəɾʈeːks̪ʈ
हाउस	ɦäːʊs̪
हाज़िर	ɦäːd͡ʒɪɾ
हाज़िर	ɦäːzɪɾ
हाज़िरजवाब	ɦäːd͡ʒɪɾd͡ʒəʋäːb
हाज़िरजवाब	ɦäːzɪɾd͡ʒəʋäːb
हाज़िरजवाबी	ɦäːd͡ʒɪɾd͡ʒəʋäːbiː
हाज़िरजवाबी	ɦäːzɪɾd͡ʒəʋäːbiː
हाजिरा	ɦäːd͡ʒɪɾäː
हाथ	ɦäːt̪ʰ
हाथी	ɦäːt̪ʰiː
हादसा	ɦäːd̪s̪äː
हाफ़िज़ा	ɦäːfɪzäː
हाफ़िज़ा	ɦäːpʰɪd͡ʒäː
हामी	ɦäːmiː
हाय	ɦäːj
हार	ɦäːɾ
हार्दिक	ɦäːɾd̪ɪk
हाल	ɦäːl̪
हालत	ɦäːl̪ət̪
हालाँकि	ɦäːl̪ä̃ːkiː
हालात	ɦäːl̪äːt̪
हालिया	ɦäːl̪ijäː
हास	ɦäːs̪
हासिल	ɦäːs̪ɪl̪
हास्यास्पद	ɦäːs̪jäːs̪pəd̪
हिंग्लिश	ɦɪ̃ŋɡl̪ɪʃ
हिंडोला	ɦɪ̃ɳɖoːl̪äː
हिंद	ɦɪ̃n̪d̪
हिंदको	ɦɪ̃n̪d̪koː
हिंदवी	ɦɪ̃n̪d̪wiː
हिंदवी	ɦɪ̃n̪d̪əʋiː
हिंदी	ɦɪ̃n̪d̪iː
हिंदुत्व	ɦɪ̃n̪d̪ʊt̪wᵊ
हिंदुत्ववादी	ɦɪ̃n̪d̪ʊt̪wəʋäːd̪iː
हिंदुस्तान	ɦɪ̃n̪d̪ʊs̪t̪ä̃ːn̪
हिंदुस्तानी	ɦɪ̃n̪d̪ʊs̪t̪äːn̪iː
हिंदू	ɦɪ̃n̪d̪uː
हिंसा	ɦɪ̃n̪s̪äː
हिंसात्मक	ɦɪ̃n̪s̪äːt̪mək
हिक्का	ɦɪk̚käː
हिचकना	ɦɪt͡ʃəkn̪äː
हिचकिचाना	ɦɪt͡ʃkɪt͡ʃäːn̪äː
हिजड़ा	ɦɪd͡ʒɽäː
हितकार	ɦɪt̪käːɾ
हितकारिणी	ɦɪt̪käːɾɪɳiː
हितकारी	ɦɪt̪käːɾiː
हितैषी	ɦɪt̪ɛːʃiː
हिन्दचीन	ɦɪ̃n̪d̪t͡ʃĩːn̪
हिन्दवी	ɦɪ̃n̪d̪wiː
हिन्दवी	ɦɪ̃n̪d̪əʋiː
हिन्दी	ɦɪ̃n̪d̪iː
हिन्दुस्तान	ɦɪ̃n̪d̪ʊs̪t̪ä̃ːn̪
हिन्दुस्तानी	ɦɪ̃n̪d̪ʊs̪t̪äːn̪iː
हिन्दू	ɦɪ̃n̪d̪uː
हिम	ɦɪ̃m
हिमपात	ɦɪ̃mpäːt̪
हिमशैल	ɦɪ̃mʃɛːl̪
हिमस्खलन	ɦɪ̃ms̪kʰəl̪ə̃n̪
हिमांक	ɦɪmä̃ːk
हिमाक़त	ɦɪmäːkət̪
हिमाक़त	ɦɪmäːqət̪
हिमाद्रि	ɦɪmäːd̪ɾiː
हिमालय	ɦɪmɑːləj
हिमालय	ɦɪmɑːlɛ
हिम्मतवर	ɦɪ̃mmət̪wəɾ
हिया	ɦijäː
हिरन	ɦɪɾə̃n̪
हिरासत	ɦɪɾäːs̪ət̪
हिलवाना	ɦɪl̪ʋäːn̪äː
हिसाब	ɦɪs̪äːb
हिस्सा	ɦɪs̪s̪äː
हिस्सेदार	ɦɪs̪s̪eːd̪äːɾ
हिस्सेदारी	ɦɪs̪s̪eːd̪äːɾiː
हींग	ɦĩːŋɡ
हीजड़ा	ɦiːd͡ʒɽäː
हीन	ɦĩːn̪
हीरा	ɦiːɾäː
हीलियम	ɦiːl̪ijə̃m
हुआ	ɦʊäː
हुक्म	ɦʊkʊ̃m
हुक्मरान	ɦʊkmɾä̃ːn̪
हुड़दंगबाज़	ɦʊɽd̪ə̃ŋɡbäːd͡ʒ
हुड़दंगबाज़	ɦʊɽd̪ə̃ŋɡbäːz
हुम्मुस	ɦʊ̃mmʊs̪
हुस्न	ɦʊs̪n̪
हृदयहीन	ɦɾɪd̪əjɦĩːn̪
हृदयाघात	ɦɾɪd̪əjäːɡʱäːt̪
हेज़लनट	ɦeːd͡ʒəl̪n̪əʈ
हेज़लनट	ɦeːzəl̪n̪əʈ
हेटौडा	ɦeːʈɔːɖäː
हेलिकॉप्टर	ɦeːl̪ɪkɔpʈəɾ
हेलीकॉप्टर	ɦeːl̪iːkɔpʈəɾ
हेलो	ɦeːl̪oː
हैज़ा	ɦɛːd͡ʒäː
हैज़ा	ɦɛːzäː
हैदराबाद	ɦɛːd̪ɾäːbäːd̪
हैरान	ɦɛːɾä̃ːn̪
हैरानी	ɦɛːɾäːn̪iː
हैवान	ɦɛːʋä̃ːn̪
हैवानियत	ɦɛːʋäːn̪ijət̪
हैसियत	ɦɛːs̪ijət̪
हॉलैंड	ɦɔl̪ɛ̃ːɳɖ
होंठ	ɦõːɳʈʰ
होंठलाली	ɦõːɳʈʰl̪äːl̪iː
होंडुरस	ɦõːɳɖʊɾəs̪
होगा	ɦoːɡäː
होटल	ɦoːʈəl̪
होता	ɦoːt̪äː
होनहार	ɦõːn̪ɦäːɾ
होना	ɦoːn̪äː
होनेवाला	ɦoːn̪eːʋäːl̪äː
होनेवाली	ɦoːn̪eːʋäːl̪iː
होन्शू	ɦõːn̪ʃuː
होबार्ट	ɦoːbäːɾʈ
होली	ɦoːl̪iː
होशंगाबाद	ɦoːʃə̃ŋɡäːbäːd̪
होशियार	ɦoːʃijäːɾ
हौवा	ɦə̯uʋäː
हौसला	ɦɔːs̪l̪äː
ह्रस्व	ɦɾəs̪ʋᵊ
ह्वेल	ɦʋeːl̪
ॐ	õːm
