أجنَبي	.ʔec.ne.bî
أجنَبی	.ʔec.ne.bî
ئا	.ʔa
ئاب	.ʔab
ئابوری	.ʔa.bu.rî
ئابووری	.ʔa.bû.rî
ئابووریی	.ʔa.bû.rîy
ئابوورییان	.ʔa.bû.rî.yan
ئابوورییەوە	.ʔa.bû.rî.ye.we
ئابی	.ʔa.bî
ئاخافتن	.ʔa.xaf.tin
ئاخاوتن	.ʔa.xaw.tin
ئاخر	.ʔa.xir
ئاخوندی	.ʔa.xun.dî
ئاخۆ	.ʔa.xo
ئادانا	.ʔa.da.na
ئارادایە	.ʔa.ra.da.ye
ئاراس	.ʔa.ras
ئاراستە	.ʔa.ras.te
ئاراستەی	.ʔa.ras.tey
ئارام	.ʔa.ram
ئارامدا	.ʔa.ram.da
ئارامی	.ʔa.ra.mî
ئاراوە	.ʔa.ra.we
ئارخا	.ʔar.xa
ئارەزوو	.ʔa.re.zû
ئارەزووی	.ʔa.re.zûy
ئازاد	.ʔa.zad
ئازادانە	.ʔa.za.da.ne
ئازادکردنی	.ʔa.zad.kir.di.nî
ئازادی	.ʔa.za.dî
ئازادیخواز	.ʔa.za.dî.xwaz
ئازادیخوازی	.ʔa.za.dîx.wa.zî
ئازادیی	.ʔa.za.dîy
ئازادییا	.ʔa.za.dî.ya
ئازادییە	.ʔa.za.dî.ye
ئازادیێ	.ʔa.zad.yê
ئازادە	.ʔa.za.de
ئازار	.ʔa.zar
ئازاری	.ʔa.za.rî
ئاسان	.ʔa.san
ئاسانتر	.ʔa.san.tir
ئاسانی	.ʔa.sa.nî
ئاسایش	.ʔa.sa.yiş
ئاسایشی	.ʔa.sa.yi.şî
ئاسایی	.ʔa.sa.yî
ئاساییترین	.ʔa.sa.yît.rîn
ئاساییی	.ʔa.sa.yîy
ئاسایییە	.ʔa.sa.yî.ye
ئاسایییەکان	.ʔa.sa.yî.ye.kan
ئاست	.ʔast
ئاستی	.ʔas.tî
ئاستێکدان	.ʔas.têk.dan
ئاستێکی	.ʔas.tê.kî
ئاستە	.ʔas.te
ئاستەنگەکان	.ʔas.ten.ge.kan
ئاسمان	.ʔas.man
ئاسمانی	.ʔas.ma.nî
ئاسمانیی	.ʔas.ma.nîy
ئاسن	.ʔa.sin
ئاسوودەتر	.ʔa.sû.de.tir
ئاسۆ	.ʔa.so
ئاسۆی	.ʔa.soy
ئاسیا	.ʔas.ya
ئاسیایی	.ʔas.ya.yî
ئاشتی	.ʔaş.tî
ئاشنا	.ʔaş.na
ئاشوورییەوە	.ʔa.şû.rî.ye.we
ئاشکرا	.ʔaş.ki.ra
ئاشکرای	.ʔaş.ki.ray
ئاشکرایکرد	.ʔaş.ki.ray.kird
ئاشکرایە	.ʔaş.ki.ra.ye
ئاغا	.ʔa.ẍa
ئاغای	.ʔa.ẍay
ئافراند	.ʔaf.rand
ئافراندنی	.ʔaf.ran.di.nî
ئافرەت	.ʔaf.ret
ئافرەتان	.ʔaf.re.tan
ئافرەتانی	.ʔa.fi.re.ta.nî
ئافرەتی	.ʔaf.re.tî
ئاقاری	.ʔa.qa.rî
ئاقارێکدا	.ʔa.qa.rêk.da
ئاقارێکی	.ʔa.qa.rê.kî
ئاقارەدا	.ʔa.qa.re.da
ئاقارەکە	.ʔa.qa.re.ke
ئالان	.ʔa.lan
ئامادە	.ʔa.ma.de
ئامادەبوون	.ʔa.ma.de.bûn
ئامادەبوونی	.ʔa.ma.de.bû.nî
ئامادەن	.ʔa.ma.den
ئامادەکاری	.ʔa.ma.de.ka.rî
ئامادەکاریگەلێکی	.ʔa.ma.de.ka.rî.ge.lê.kî
ئامادەکارییەکاندا	.ʔa.ma.de.ka.rî.ye.kan.da
ئامادەکراوەکانی	.ʔa.ma.de.ki.ra.we.ka.nî
ئامادەکردنی	.ʔa.ma.de.kir.di.nî
ئامادەی	.ʔa.ma.dey
ئامادەیی	.ʔa.ma.de.yî
ئامادەیە	.ʔa.ma.de.ye
ئاماری	.ʔa.ma.rî
ئامارێک	.ʔa.ma.rêk
ئامارێکی	.ʔa.ma.rê.kî
ئامارەکانی	.ʔa.ma.re.ka.nî
ئامانج	.ʔa.manc
ئامانجم	.ʔa.man.cim
ئامانجی	.ʔa.man.cî
ئامانجە	.ʔa.man.ce
ئامانجەکانی	.ʔa.man.ce.ka.nî
ئامانجەکانیان	.ʔa.man.ce.kan.yan
ئاماژە	.ʔa.ma.je
ئاماژەمان	.ʔa.ma.je.man
ئاماژەی	.ʔa.ma.jey
ئاماژەیان	.ʔa.ma.je.yan
ئاماژەیە	.ʔa.ma.je.ye
ئاماژەیەکی	.ʔa.ma.je.ye.kî
ئامرازی	.ʔam.ra.zî
ئامریکا	.ʔam.rî.ka
ئامریکایییەکاندان	.ʔam.rî.ka.yî.ye.kan.dan
ئامۆژگاری	.ʔa.moj.ga.rî
ئامۆژگارییان	.ʔa.moj.ga.rî.yan
ئامێری	.ʔa.mê.rî
ئامێرێک	.ʔa.mê.rêk
ئامێرە	.ʔa.mê.re
ئامەد	.ʔa.med
ئامەدی	.ʔa.me.dî
ئانا	.ʔa.na
ئانتەر	.ʔan.ter
ئانتەرەوە	.ʔan.te.re.we
ئانکارا	.ʔan.ka.ra
ئانکارادا	.ʔan.ka.ra.da
ئانکارادایە	.ʔan.ka.ra.da.ye
ئانگژا	.ʔan.gi.ja
ئاهەنگی	.ʔa.hen.gî
ئاو	.ʔaw
ئاوا	.ʔa.wa
ئاوات	.ʔa.wat
ئاوارە	.ʔa.wa.re
ئاوارەکان	.ʔa.wa.re.kan
ئاوارەکانی	.ʔa.wa.re.ka.nî
ئاوارەی	.ʔa.wa.rey
ئاواز	.ʔa.waz
ئاوازی	.ʔa.wa.zî
ئاوای	.ʔa.way
ئاوایی	.ʔa.wa.yî
ئاوایییەکانیان	.ʔa.wa.yî.ye.kan.yan
ئاوریان	.ʔa.wir.yan
ئاوی	.ʔa.wî
ئاوێزە	.ʔa.wê.ze
ئاوێنە	.ʔa.wê.ne
ئاوێنەی	.ʔa.wê.ney
ئاوەدانی	.ʔa.we.da.nî
ئاوەڵاوە	.ʔa.we.ła.we
ئاپۆ	.ʔa.po
ئاڕاستەی	.ʔa.řas.tey
ئاژانس	.ʔa.jans
ئاژانسی	.ʔa.jan.sî
ئاژاولەی	.ʔa.jaw.ley
ئاژەڵ	.ʔa.jeł
ئاڤەستا	.ʔa.ves.ta
ئاکادمی	.ʔa.kad.mî
ئاکار	.ʔa.kar
ئاکاری	.ʔa.ka.rî
ئاکارەکانی	.ʔa.ka.re.ka.nî
ئاکام	.ʔa.kam
ئاکامدا	.ʔa.kam.da
ئاکامی	.ʔa.ka.mî
ئاکامە	.ʔa.ka.me
ئاکامەکان	.ʔa.ka.me.kan
ئاکشەنەر	.ʔak.şe.ner
ئاکینان	.ʔa.kî.nan
ئاگادار	.ʔa.ga.dar
ئاگادارنەبوونی	.ʔa.ga.dar.ne.bû.nî
ئاگاداری	.ʔa.ga.da.rî
ئاگادارینامەکان	.ʔa.ga.da.rî.na.me.kan
ئاگادارینامەکەدا	.ʔa.ga.da.rî.na.me.ke.da
ئاگادارینامەی	.ʔa.ga.da.rî.na.mey
ئاگاداریی	.ʔa.ga.da.rîy
ئاگادارییان	.ʔa.ga.da.rî.yan
ئاگاهی	.ʔa.ga.hî
ئاگای	.ʔa.gay
ئاگر	.ʔa.gir
ئاگری	.ʔa.gi.rî
ئاڵا	.ʔa.ła
ئاڵای	.ʔa.łay
ئاڵبانییەکان	.ʔał.ba.nî.ye.kan
ئاڵمان	.ʔał.man
ئاڵماندا	.ʔał.man.da
ئاڵمانێدا	.ʔał.ma.nê.da
ئاڵن	.ʔa.łin
ئاڵوگۆڕی	.ʔa.łu.go.řî
ئاڵوگۆڕییەکان	.ʔa.łu.go.řî.ye.kan
ئاڵۆز	.ʔa.łoz
ئاڵۆزی	.ʔa.ło.zî
ئای	.ʔay
ئایا	.ʔa.ya
ئایار	.ʔa.yar
ئایندە	.ʔa.yin.de
ئایندەی	.ʔa.yin.dey
ئاینی	.ʔay.nî
ئایین	.ʔa.yîn
ئایینی	.ʔa.yî.nî
ئایینیش	.ʔa.yî.nîş
ئایینین	.ʔa.yî.nîn
ئایینیی	.ʔa.yî.nîy
ئایینییان	.ʔa.yî.nî.yan
ئایینییە	.ʔa.yî.nî.ye
ئایینییەکان	.ʔa.yî.nî.ye.kan
ئایینییەکانی	.ʔa.yî.nî.ye.ka.nî
ئایینییەکانە	.ʔa.yî.nî.ye.ka.ne
ئزمیر	.ʔiz.mîr
ئوزچەلک	.ʔuz.çelk
ئوسامە	.ʔu.sa.me
ئوسترالیا	.ʔus.ti.ral.ya
ئومێد	.ʔu.mêd
ئومێدی	.ʔu.mê.dî
ئونال	.ʔu.nal
ئوڤاجک	.ʔu.vack
ئوگرەتی	.ʔug.re.tî
ئۆباما	.ʔo.ba.ma
ئۆتۆمبێل	.ʔo.tom.bêl
ئۆتۆمبێلی	.ʔo.tom.bê.lî
ئۆتۆمبێلێکی	.ʔo.tom.bê.lê.kî
ئۆتۆمبێلەکانی	.ʔo.tom.bê.le.ka.nî
ئۆجالان	.ʔo.ca.lan
ئۆدە	.ʔo.de
ئۆدەی	.ʔo.dey
ئۆدەیان	.ʔo.de.yan
ئۆسکاری	.ʔos.ka.rî
ئۆسێ	.ʔo.sê
ئۆفسێتی	.ʔof.sê.tî
ئۆپۆزسیۆن	.ʔo.po.zis.yon
ئۆپۆزسیۆنی	.ʔo.po.zis.yo.nî
ئۆپۆزیسیۆن	.ʔo.po.zîs.yon
ئۆکرانیا	.ʔok.ran.ya
ئۆگرەتی	.ʔog.re.tî
ئۆگرەتیش	.ʔog.re.tîş
ئۆگرەتییە	.ʔog.re.tî.ye
ئۆگرەتییەکانی	.ʔog.re.tî.ye.ka.nî
ئی	.ʔî
ئیئتیلافی	.ʔîʔ.tî.la.fî
ئیبراهیم	.ʔîb.ra.hîm
ئیتالی	.ʔî.ta.lî
ئیتالیا	.ʔî.tal.ya
ئیتر	.ʔî.tir
ئیتلاعاتی	.ʔît.la.ƹa.tî
ئیحسان	.ʔîḧ.san
ئیخوان	.ʔîx.wan
ئیداری	.ʔî.da.rî
ئیدارەی	.ʔî.da.rey
ئیدانەی	.ʔî.da.ney
ئیدی	.ʔî.dî
ئیرادەی	.ʔî.ra.dey
ئیسرائیل	.ʔîs.ra.ʔîl
ئیسراییلیش	.ʔîs.ra.yî.lîş
ئیسلام	.ʔîs.lam
ئیسلامدا	.ʔîs.lam.da
ئیسلامی	.ʔîs.la.mî
ئیسلامیدا	.ʔîs.la.mî.da
ئیسلامیی	.ʔîs.la.mîy
ئیسلامییە	.ʔîs.la.mî.ye
ئیسلامییەکان	.ʔîs.la.mî.ye.kan
ئیسلامیەکان	.ʔîs.lam.ye.kan
ئیسماعیل	.ʔîs.ma.ƹîl
ئیسمایل	.ʔîs.ma.yil
ئیسپانی	.ʔîs.pa.nî
ئیسپانیا	.ʔîs.pan.ya
ئیش	.ʔîş
ئیشکەکان	.ʔîş.ke.kan
ئیشی	.ʔî.şî
ئیعدام	.ʔîƹ.dam
ئیعدامی	.ʔîƹ.da.mî
ئیلام	.ʔî.lam
ئیلهام	.ʔîl.ham
ئیمارات	.ʔî.ma.rat
ئیمام	.ʔî.mam
ئیمرالی	.ʔîm.ra.lî
ئیمزا	.ʔîm.za
ئیمپراتۆری	.ʔîm.pi.ra.to.rî
ئیمپەراتۆریی	.ʔîm.pe.ra.to.rîy
ئیمە	.ʔî.me
ئیمەیل	.ʔî.meyl
ئیمەیلەوە	.ʔî.mey.le.we
ئینتێرنێتەوە	.ʔîn.têr.nê.te.we
ئینتەرنت	.ʔîn.ter.nit
ئینتەرنێت	.ʔîn.ter.nêt
ئینتەرنەت	.ʔîn.ter.net
ئینتەرنەتدا	.ʔîn.ter.net.da
ئینتەرنەتی	.ʔîn.ter.ne.tî
ئینتەرنەتیش	.ʔîn.ter.ne.tîş
ئینتەرنەتیی	.ʔîn.ter.ne.tîy
ئینتەرنەتەوە	.ʔîn.ter.ne.te.we
ئینجا	.ʔîn.ca
ئینجیل	.ʔîn.cîl
ئینجیلی	.ʔîn.cî.lî
ئینجیلیان	.ʔîn.cîl.yan
ئینسان	.ʔîn.san
ئینسانی	.ʔîn.sa.nî
ئینقلابی	.ʔîn.qi.la.bî
ئینگلتەرا	.ʔîn.gil.te.ra
ئینگلیز	.ʔîn.gi.lîz
ئینگلیزی	.ʔîn.gi.lî.zî
ئینگلیس	.ʔîn.gi.lîs
ئینگلیسی	.ʔîn.gi.lî.sî
ئینگلیسییەکان	.ʔîn.gi.lî.sî.ye.kan
ئێدگار	.ʔêd.gar
ئێراق	.ʔê.raq
ئێران	.ʔê.ran
ئێراندا	.ʔê.ran.da
ئێرانی	.ʔê.ra.nî
ئێرانیش	.ʔê.ra.nîş
ئێرانیشدا	.ʔê.ra.nîş.da
ئێرانییەکان	.ʔê.ra.nî.ye.kan
ئێرانە	.ʔê.ra.ne
ئێرانەوە	.ʔê.ra.ne.we
ئێرە	.ʔê.re
ئێزدی	.ʔêz.dî
ئێستا	.ʔês.ta
ئێستادا	.ʔês.ta.da
ئێستاش	.ʔês.taş
ئێستاکانێ	.ʔês.ta.ka.nê
ئێستاکانێش	.ʔês.ta.ka.nêş
ئێستاکە	.ʔês.ta.ke
ئێستاکەش	.ʔês.ta.keş
ئێستاکەی	.ʔês.ta.key
ئێستای	.ʔês.tay
ئێستە	.ʔês.te
ئێستەش	.ʔês.teş
ئێستەکانێ	.ʔês.te.ka.nê
ئێلیفسن	.ʔê.lîf.sin
ئێلیۆت	.ʔêl.yot
ئێمە	.ʔê.me
ئێمەدا	.ʔê.me.da
ئێمەش	.ʔê.meş
ئێمەوە	.ʔê.me.we
ئێمەی	.ʔê.mey
ئێمەیە	.ʔê.me.ye
ئێن	.ʔên
ئێوارە	.ʔê.wa.re
ئێوارەی	.ʔê.wa.rey
ئێوە	.ʔê.we
ئێوەش	.ʔê.weş
ئێوەی	.ʔê.wey
ئێکجار	.ʔêk.car
ئە	.ʔe
ئەبوبەکر	.ʔe.bu.be.kir
ئەبێ	.ʔe.bê
ئەبێت	.ʔe.bêt
ئەتۆ	.ʔe.to
ئەتۆمی	.ʔe.to.mî
ئەحمەد	.ʔeḧ.med
ئەحمەدی	.ʔeḧ.me.dî
ئەخلاقی	.ʔex.la.qî
ئەدا	.ʔe.da
ئەدات	.ʔe.dat
ئەدریش	.ʔed.rîş
ئەدی	.ʔe.dî
ئەدەب	.ʔe.deb
ئەدەبی	.ʔe.de.bî
ئەدەبیاتی	.ʔe.deb.ya.tî
ئەدەبیی	.ʔe.de.bîy
ئەدەبییانەوە	.ʔe.de.bî.ya.ne.we
ئەدەبییانەوەیە	.ʔe.de.bî.ya.ne.we.ye
ئەدەبییەکان	.ʔe.de.bî.ye.kan
ئەدەن	.ʔe.den
ئەرتش	.ʔer.tiş
ئەرتشی	.ʔer.ti.şî
ئەرتشیدا	.ʔer.ti.şî.da
ئەرتشیی	.ʔer.ti.şîy
ئەرتشییە	.ʔer.ti.şî.ye
ئەرتەشی	.ʔer.te.şî
ئەرتەشیدا	.ʔer.te.şî.da
ئەرجەنتین	.ʔer.cen.tîn
ئەرخەنی	.ʔer.xe.nî
ئەردۆغان	.ʔer.do.ẍan
ئەردۆن	.ʔer.don
ئەرزەڕۆم	.ʔer.ze.řom
ئەرسەلان	.ʔer.se.lan
ئەرشیڤی	.ʔer.şî.vî
ئەرمەنستاندا	.ʔer.me.nis.tan.da
ئەرمەنستانیش	.ʔer.me.nis.ta.nîş
ئەرمەنی	.ʔer.me.nî
ئەرمەنییەکان	.ʔer.me.nî.ye.kan
ئەرنێست	.ʔer.nêst
ئەرک	.ʔerk
ئەرکی	.ʔer.kî
ئەرکێکی	.ʔer.kê.kî
ئەرکێکە	.ʔer.kê.ke
ئەرکە	.ʔer.ke
ئەرکەکانی	.ʔer.ke.ka.nî
ئەرێ	.ʔe.rê
ئەرێنی	.ʔe.rê.nî
ئەرەن	.ʔe.ren
ئەز	.ʔez
ئەزرا	.ʔez.ra
ئەزموون	.ʔez.mûn
ئەزموونی	.ʔez.mû.nî
ئەزموونە	.ʔez.mû.ne
ئەزموونەکانی	.ʔez.mû.ne.ka.nî
ئەستاند	.ʔes.tand
ئەستۆ	.ʔes.to
ئەستۆی	.ʔes.toy
ئەستۆیە	.ʔes.to.ye
ئەستێرە	.ʔes.tê.re
ئەستێرەی	.ʔes.tê.rey
ئەستەمە	.ʔes.te.me
ئەسپ	.ʔesp
ئەسپێردرایە	.ʔes.pêr.di.ra.ye
ئەسڵانی	.ʔes.ła.nî
ئەسەد	.ʔe.sed
ئەشکەنجانە	.ʔeş.ken.ca.ne
ئەشکەنجە	.ʔeş.ken.ce
ئەشکەنجەدا	.ʔeş.ken.ce.da
ئەشکەنجەش	.ʔeş.ken.ceş
ئەشکەنجەکراوەکان	.ʔeş.ken.ce.ki.ra.we.kan
ئەشکەنجەی	.ʔeş.ken.cey
ئەشکەنجەیان	.ʔeş.ken.ce.yan
ئەفریقا	.ʔef.rî.qa
ئەفسانە	.ʔef.sa.ne
ئەفسەری	.ʔef.se.rî
ئەفغانستان	.ʔef.ẍa.nis.tan
ئەلئەسەد	.ʔel.ʔe.sed
ئەلجەواز	.ʔel.ce.waz
ئەلعەرەب	.ʔel.ƹe.reb
ئەلفوبێی	.ʔel.fu.bêy
ئەلقاعیدە	.ʔel.qa.ƹî.de
ئەلکوردی	.ʔel.kur.dî
ئەلەکساندر	.ʔe.lek.san.dir
ئەم	.ʔem
ئەمان	.ʔe.man
ئەمانە	.ʔe.ma.ne
ئەمانەش	.ʔe.ma.neş
ئەمانەن	.ʔe.ma.nen
ئەمانەیە	.ʔe.ma.ne.ye
ئەماژەیە	.ʔe.ma.je.ye
ئەمجارە	.ʔem.ca.re
ئەمجارەیان	.ʔem.ca.re.yan
ئەمرۆ	.ʔem.ro
ئەمریکا	.ʔem.rî.ka
ئەمریکادا	.ʔem.rî.ka.da
ئەمریکاوە	.ʔem.rî.ka.we
ئەمریکای	.ʔem.rî.kay
ئەمریکی	.ʔem.rî.kî
ئەمریکییەکان	.ʔem.rî.kî.ye.kan
ئەمساڵ	.ʔem.sał
ئەمساڵدا	.ʔem.sał.da
ئەمشەو	.ʔem.şew
ئەمن	.ʔe.min
ئەمنی	.ʔem.nî
ئەمنیش	.ʔe.mi.nîş
ئەمنیی	.ʔem.nîy
ئەمنییەکان	.ʔem.nî.ye.kan
ئەمنییەکانی	.ʔem.nî.ye.ka.nî
ئەمنییەکانەوە	.ʔem.nî.ye.ka.ne.we
ئەمنیەتی	[.ʔem.nye.tî]
ئەمپەراتووریی	.ʔem.pe.ra.tû.rîy
ئەمڕۆ	.ʔem.řo
ئەمڕۆش	.ʔem.řoş
ئەمڕۆکە	.ʔem.řo.ke
ئەمڕۆی	.ʔem.řoy
ئەمیر	.ʔe.mîr
ئەمیش	.ʔe.mîş
ئەمین	.ʔe.mîn
ئەمینداری	.ʔe.mîn.da.rî
ئەمە	.ʔe.me
ئەمەریکا	.ʔe.me.rî.ka
ئەمەریکی	.ʔe.me.rî.kî
ئەمەش	.ʔe.meş
ئەمەکێکی	.ʔe.me.kê.kî
ئەمەکەش	.ʔe.me.keş
ئەمەی	.ʔe.mey
ئەمەیان	.ʔe.me.yan
ئەمەیش	.ʔe.meyş
ئەمەیە	.ʔe.me.ye
ئەنبار	.ʔen.bar
ئەنجام	.ʔen.cam
ئەنجامدا	.ʔen.cam.da
ئەنجامدانی	.ʔen.cam.da.nî
ئەنجامداوە	.ʔen.cam.da.we
ئەنجامدرا	.ʔen.cam.di.ra
ئەنجامدراوە	.ʔen.cam.di.ra.we
ئەنجامی	.ʔen.ca.mî
ئەنجامێکی	.ʔen.ca.mê.kî
ئەنجامە	.ʔen.ca.me
ئەنجامەکانی	.ʔen.ca.me.ka.nî
ئەنجومەن	.ʔen.cu.men
ئەنجومەنی	.ʔen.cu.me.nî
ئەنجوومەنی	.ʔen.cû.me.nî
ئەندازیاری	.ʔen.daz.ya.rî
ئەندام	.ʔen.dam
ئەندامان	.ʔen.da.man
ئەندامانی	.ʔen.da.ma.nî
ئەندامایەتی	.ʔen.da.ma.ye.tî
ئەندامایەتیی	.ʔen.da.ma.ye.tîy
ئەندامی	.ʔen.da.mî
ئەندامێتی	.ʔen.da.mê.tî
ئەندامێکی	.ʔen.da.mê.kî
ئەندامەکانی	.ʔen.da.me.ka.nî
ئەندامەکانیان	.ʔen.da.me.kan.yan
ئەنستیتووی	.ʔe.nis.tî.tûy
ئەنستیتووە	.ʔe.nis.tî.tu.we
ئەنستیتووەکان	.ʔe.nis.tî.tu.we.kan
ئەنفال	.ʔen.fal
ئەنقەرە	.ʔen.qe.re
ئەنوەر	.ʔen.wer
ئەنیستیتووی	.ʔe.nîs.tî.tûy
ئەنیستیتووە	.ʔe.nîs.tî.tu.we
ئەهلی	.ʔeh.lî
ئەو	.ʔew
ئەوا	.ʔe.wa
ئەوان	.ʔe.wan
ئەواندا	.ʔe.wan.da
ئەواندایە	.ʔe.wan.da.ye
ئەوانی	.ʔe.wa.nî
ئەوانیش	.ʔe.wa.nîş
ئەوانە	.ʔe.wa.ne
ئەوانەدا	.ʔe.wa.ne.da
ئەوانەش	.ʔe.wa.neş
ئەوانەوە	.ʔe.wa.ne.we
ئەوانەی	.ʔe.wa.ney
ئەوتۆ	.ʔew.to
ئەوتۆی	.ʔew.toy
ئەوجا	.ʔew.ca
ئەودا	.ʔew.da
ئەورووپا	.ʔew.rû.pa
ئەورووپادا	.ʔew.rû.pa.da
ئەورووپاش	.ʔew.rû.paş
ئەورووپاوە	.ʔew.rû.pa.we
ئەورووپای	.ʔew.rû.pay
ئەورووپی	.ʔew.rû.pî
ئەوروپا	.ʔew.ru.pa
ئەوروپادا	.ʔew.ru.pa.da
ئەوروپای	.ʔew.ru.pay
ئەوروپی	.ʔew.ru.pî
ئەوسا	.ʔew.sa
ئەوقاف	.ʔew.qaf
ئەوپەڕی	.ʔew.pe.řî
ئەوڕۆ	.ʔew.řo
ئەوڕۆکانێ	.ʔew.řo.ka.nê
ئەوکات	.ʔew.kat
ئەوکاتە	.ʔew.ka.te
ئەوکاتەی	.ʔew.ka.tey
ئەوی	.ʔe.wî
ئەویان	.ʔew.yan
ئەویش	.ʔe.wîş
ئەوین	.ʔe.wîn
ئەوێ	.ʔe.wê
ئەوە	.ʔe.we
ئەوەبوو	.ʔe.we.bû
ئەوەتا	.ʔe.we.ta
ئەوەدا	.ʔe.we.da
ئەوەش	.ʔe.weş
ئەوەشدا	.ʔe.weş.da
ئەوەشی	.ʔe.we.şî
ئەوەم	.ʔe.wem
ئەوەمان	.ʔe.we.man
ئەوەندە	.ʔe.wen.de
ئەوەندەی	.ʔe.wen.dey
ئەوەوە	.ʔe.we.we
ئەوەکی	.ʔe.we.kî
ئەوەی	.ʔe.wey
ئەوەیان	.ʔe.we.yan
ئەوەیش	.ʔe.weyş
ئەوەیە	.ʔe.we.ye
ئەژانسی	.ʔe.jan.sî
ئەژمار	.ʔej.mar
ئەژمارانە	.ʔej.ma.ra.ne
ئەژماری	.ʔej.ma.rî
ئەژمارێک	.ʔej.ma.rêk
ئەژمارێکی	.ʔej.ma.rê.kî
ئەژمارە	.ʔej.ma.re
ئەژمارەدا	.ʔej.ma.re.da
ئەژمارەکانی	.ʔej.ma.re.ka.nî
ئەڤ	.ʔev
ئەڤیندارانە	.ʔe.vîn.da.ra.ne
ئەڤیندارانەی	.ʔe.vîn.da.ra.ney
ئەکات	.ʔe.kat
ئەکادیمی	.ʔe.ka.dî.mî
ئەکتەر	.ʔek.ter
ئەکتەری	.ʔek.te.rî
ئەکرد	.ʔe.kird
ئەکرێت	.ʔe.ki.rêt
ئەکرەم	.ʔe.ki.rem
ئەکەم	.ʔe.kem
ئەکەن	.ʔe.ken
ئەگینا	.ʔe.gî.na
ئەگەر	.ʔe.ger
ئەگەرچی	.ʔe.ger.çî
ئەگەری	.ʔe.ge.rî
ئەگەریش	.ʔe.ge.rîş
ئەڵماندایە	.ʔeł.man.da.ye
ئەڵمانی	.ʔeł.ma.nî
ئەڵمانیا	.ʔeł.man.ya
ئەڵمانێ	.ʔeł.ma.nê
ئەڵڵا	.ʔeł.ła
ئەڵێ	.ʔe.łê
ئەڵێت	.ʔe.łêt
ئەی	.ʔey
ئەیاد	.ʔe.yad
ئەیلول	.ʔey.lul
ئەیلوولی	.ʔey.lû.lî
با	.ba
بابان	.ba.ban
بابی	.ba.bî
بابە	.ba.be
بابەت	.ba.bet
بابەتانێک	.ba.be.ta.nêk
بابەتانەدا	.ba.be.ta.ne.da
بابەتانەی	.ba.be.ta.ney
بابەتی	.ba.be.tî
بابەتێک	.ba.be.têk
بابەتێکی	.ba.be.tê.kî
بابەتە	.ba.be.te
بابەتەوە	.ba.be.te.we
بابەتەکاندا	.ba.be.te.kan.da
بابەتەکانی	.ba.be.te.ka.nî
بابەتەکانیان	.ba.be.te.kan.yan
بابەتەکە	.ba.be.te.ke
بابەکان	.ba.be.kan
باتلێر	.bat.lêr
باتمان	.bat.man
باتی	.ba.tî
باج	.bac
باجی	.ba.cî
باجیشی	.ba.cî.şî
باجێکی	.ba.cê.kî
باجە	.ba.ce
باجەکان	.ba.ce.kan
باجەکانی	.ba.ce.ka.nî
باجەکە	.ba.ce.ke
بادینان	.ba.dî.nan
بار	.bar
باران	.ba.ran
باراک	.ba.rak
بارزانی	.bar.za.nî
بارودۆخانەدا	.ba.ru.do.xa.ne.da
بارودۆخی	.ba.ru.do.xî
بارودۆخێکدا	.ba.ru.do.xêk.da
بارودۆخێکی	.ba.ru.do.xê.kî
بارودۆخە	.ba.ru.do.xe
بارودۆخەدا	.ba.ru.do.xe.da
بارودۆخەکە	.ba.ru.do.xe.ke
بارگواستنەوە	.bar.gwas.ti.ne.we
باری	.ba.rî
بارە	.ba.re
بارەوە	.ba.re.we
بارەگای	.ba.re.gay
بارەی	.ba.rey
بارەیەوە	.ba.re.ye.we
بازاڕ	.ba.zař
بازاڕدۆزینەوە	.ba.zař.do.zî.ne.we
بازاڕی	.ba.za.řî
بازاڕەکان	.ba.za.ře.kan
بازاڕەکانی	.ba.za.ře.ka.nî
بازرگانانە	.ba.zir.ga.na.ne
بازرگانی	.ba.zir.ga.nî
بازرگانیی	.ba.zir.ga.nîy
بازرگانییان	.ba.zir.ga.nî.yan
بازرگانەکان	.ba.zir.ga.ne.kan
بازرگانەکانیشەوە	.ba.zir.ga.ne.ka.nî.şe.we
بازنەی	.baz.ney
باس	.bas
باسانە	.ba.sa.ne
باسم	.ba.sim
باسمان	.bas.man
باسکردنی	.bas.kir.di.nî
باسی	.ba.sî
باسیان	.bas.yan
باسێک	.ba.sêk
باسێکی	.ba.sê.kî
باسێکیش	.ba.sê.kîş
باسە	.ba.se
باسەکانی	.ba.se.ka.nî
باش	.baş
باشتر	.baş.tir
باشترین	.baş.ti.rîn
باشترە	.baş.ti.re
باشور	.ba.şur
باشوری	.ba.şu.rî
باشوور	.ba.şûr
باشووردا	.ba.şûr.da
باشووری	.ba.şû.rî
باشی	.ba.şî
باشیان	.baş.yan
باشیشی	.ba.şî.şî
باشە	.ba.şe
باغجالر	.baẍ.ca.lir
باقی	.ba.qî
بالای	.ba.lay
بان	.ban
بانکی	.ban.kî
بانگ	.bang
بانگهێشت	.bang.hêşt
بانگهێشتنامەی	.bang.hêşt.na.mey
بانگهێشتکراو	.bang.hêşt.ki.raw
بانگهێشتی	.bang.hêş.tî
بانگی	.ban.gî
بانگەشە	.ban.ge.şe
بانگەشەی	.ban.ge.şey
بانگەوازی	.ban.ge.wa.zî
بانە	.ba.ne
باو	.baw
باوک	.bawk
باوکم	.baw.kim
باوکی	.baw.kî
باوە	.ba.we
باوەشی	.ba.we.şî
باوەڕ	.ba.weř
باوەڕی	.ba.we.řî
باوەڕیان	.ba.weř.yan
باوەڕە	.ba.we.ře
باکور	.ba.kur
باکوری	.ba.ku.rî
باکوور	.ba.kûr
باکووری	.ba.kû.rî
باڵا	.ba.ła
باڵاخانەی	.ba.ła.xa.ney
باڵاخانەیەکی	.ba.ła.xa.ne.ye.kî
باڵای	.ba.łay
باڵبەستیان	.bał.best.yan
باڵی	.ba.łî
باڵیۆزی	.bał.yo.zî
باڵەک	.ba.łek
بایرن	.bay.rin
بایز	.ba.yiz
بایوغلو	.ba.yuẍ.lu
بایەخ	.ba.yex
بایەخانە	.ba.ye.xa.ne
بایەختر	.ba.yex.tir
بایەخی	.ba.ye.xî
بایەخێکی	.ba.ye.xê.kî
بایەخێکێ	.ba.ye.xê.kê
ببات	.bi.bat
بباتەوە	.bi.ba.te.we
ببرێتە	.bib.rê.te
ببن	.bi.bin
ببنە	.bi.bi.ne,.bib.ne
ببنەوە	.bib.ne.we,.bi.bi.ne.we
ببووی	.bi.bûy
ببووە	.bi.bu.we
ببووەوە	.bi.bu.we.we
ببیندرێ	.bi.bîn.di.rê
ببیندرێنەوە	.bi.bîn.di.rê.ne.we
ببینمەوە	.bi.bîn.me.we
ببینن	.bi.bî.nin
ببینین	.bi.bî.nîn
ببینێت	.bi.bî.nêt
ببینە	.bi.bî.ne
ببێت	.bi.bêt
ببێتە	.bi.bê.te
ببێتەوە	.bi.bê.te.we
ببەستێتەوە	.bi.bes.tê.te.we
ببەن	.bi.ben
بتواندرێ	.bit.wan.di.rê
بتوانم	.bit.wa.nim,.bi.twa.nim
بتوانن	.bi.twa.nin,.bit.wa.nin
بتوانین	.bi.twa.nîn
بتوانێ	.bit.wa.nê,.bi.twa.nê
بتوانێت	.bi.twa.nêt
بخات	.bi.xat
بخاتە	.bi.xa.te
بخرێتە	.bi.xi.rê.te,.bix.rê.te
بخوێننەوە	.bi.xwê.ni.ne.we
بخەنە	.bi.xe.ne
بخەینە	.bi.xey.ne
بدا	.bi.da
بدات	.bi.dat
بداتە	.bi.da.te
بداتەوە	.bi.da.te.we
بدرێ	.bid.rê
بدرێت	.bi.di.rêt,.bid.rêt
بدلیس	.bid.lîs
بدۆزمەوە	.bi.doz.me.we
بدۆزنەوە	.bi.do.zi.ne.we
بدۆزێتەوە	.bi.do.zê.te.we
بدینرێنەوە	.bi.dîn.rê.ne.we
بدینمەوە	.bi.dîn.me.we
بدینێتەوە	.bi.dî.nê.te.we
بدە	.bi.de
بدەم	.bi.dem
بدەن	.bi.den
بدەنەوە	.bi.de.ne.we
بدەین	.bi.deyn
برا	.bi.ra
برادەرانەیان	.bi.ra.de.ra.ne.yan
بران	.bi.ran
براهیم	.bi.ra.hîm
براوەی	.bi.ra.wey
براکان	.bi.ra.kan
براکەشی	.bi.ra.ke.şî
براکەی	.bi.ra.key
برای	.bi.ray
برایانی	.bi.ra.ya.nî
برایم	.bi.raym
برایەتی	.bi.ra.ye.tî
برد	.bird
بردبوو	.bir.di.bû
بردن	.bir.din
بردنم	.bir.di.nim
بردنی	.bir.di.nî
بردنەوەی	.bir.di.ne.wey
بردووە	.bir.du.we
بردە	.bir.de
بردەوە	.bir.de.we
برووشوور	.bi.rû.şûr
بری	.bi.rî
بریار	.bir.yar
بریتانیا	.bi.rî.tan.ya
بریتانیای	.bi.rî.tan.yay
بریتانییەکان	.bi.rî.ta.nî.ye.kan
بریتی	.bi.rî.tî
بریتین	.bi.rî.tîn
بریتییە	.bi.rî.tî.ye
بریتیە	.bi.rît.ye
بریندار	.bi.rîn.dar
برینداربوون	.bi.rîn.dar.bûn
برینداری	.bi.rîn.da.rî
بزاندرێن	.bi.zan.di.rên
بزانم	.bi.za.nim
بزانن	.bi.za.nin
بزانین	.bi.za.nîn
بزانێت	.bi.za.nêt
بزانە	.bi.za.ne
بزاڤانێک	.bi.za.va.nêk
بزاڤدا	.bi.zav.da
بزاڤی	.bi.za.vî
بزاڤێکیان	.bi.za.vêk.yan
بزاڤە	.bi.za.ve
بزاڤەکان	.bi.za.ve.kan
بزاڤەکانی	.bi.za.ve.ka.nî
بزاڤەکانیش	.bi.za.ve.ka.nîş
بزاڤەکە	.bi.za.ve.ke
بزاڤەکەدا	.bi.za.ve.ke.da
بزوتنەوەی	.bi.zut.ne.wey
بزووتنەوە	.bi.zût.ne.we
بزووتنەوەی	.bi.zût.ne.wey
بزووتنەوەیەکی	.bi.zût.ne.we.ye.kî
بستێنن	.bis.tê.nin
بستێنێ	.bis.tê.nê
بسڕنەوە	.bis.ři.ne.we
بسڕێتەوە	.bis.řê.te.we
بشبووبێ	.biş.bû.bê
بغازیچی	.bi.ẍa.zî.çî
بفرۆشێ	.bif.ro.şê
بلیمەتانە	.bi.lî.me.ta.ne
بم	.bim
بمانەوێت	.bi.ma.ne.wêt
بمێننەوە	.bi.mên.ne.we
بمێنێتەوە	.bi.mê.nê.te.we
بن	.bin
بناسێنێ	.bi.na.sê.nê
بناغە	.bi.na.ẍe
بناغەی	.bi.na.ẍey
بندەستی	.bin.des.tî
بنواڕنە	.bi.nwa.ři.ne
بنووسرێ	.bi.nûs.rê
بنووسن	.bi.nû.sin
بنووسین	.bi.nû.sîn
بنووسە	.bi.nû.se
بنچینەی	.bin.çî.ney
بنچینەیەیە	.bin.çî.ne.ye.ye
بنکە	.bin.ke
بنکەکانی	.bin.ke.ka.nî
بنکەی	.bin.key
بنکەیەکی	.bin.ke.ye.kî
بنیات	.bin.yat
بنیاتنانی	.bin.yat.na.nî
بنێت	.bi.nêt
بنێردرێ	.bi.nêr.di.rê
بنێردرێن	.bi.nêr.di.rên
بنێرن	.bi.nê.rin
بنێرێ	.bi.nê.rê
بنێن	.bi.nên
بنەما	.bi.ne.ma
بنەماکانی	.bi.ne.ma.ka.nî
بنەماڵە	.bi.ne.ma.łe
بنەماڵەکەی	.bi.ne.ma.łe.key
بنەماڵەی	.bi.ne.ma.łey
بنەمای	.bi.ne.may
بنەمایەکی	.bi.ne.ma.ye.kî
بنەڕەتدا	.bi.ne.řet.da
بنەڕەتی	.bi.ne.ře.tî
بنەڕەتییەکان	.bi.ne.ře.tî.ye.kan
بنەڕەتەوە	.bi.ne.ře.te.we
بهێنرێ	.bi.hên.rê
بهێنرێت	.bi.hên.rêt
بهێنن	.bi.hê.nin
بهێنین	.bi.hê.nîn
بهێنێت	.bi.hê.nêt
بهێنێتە	.bi.hê.nê.te
بهێنە	.bi.hê.ne
بهێڵێتەوە	.bi.hê.łê.te.we
بو	.bu
بوار	.bwar
بواری	.bwa.rî
بوارێکدا	.bwa.rêk.da
بوارە	.bwa.re
بوارەدا	.bwa.re.da
بوارەکانی	.bwa.re.ka.nî
بوارەکە	.bwa.re.ke
بوایە	.bwa.ye
بودجە	.bud.ce
بودجەی	.bud.cey
بورهان	.bur.han
بون	.bun
بونی	.bu.nî
بوو	.bû
بووبوو	.bû.bû
بووبووم	.bû.bûm
بووبوون	.bû.bûn
بووبێ	.bû.bê
بووبێت	.bû.bêt
بووم	.bûm
بوون	.bûn
بوونی	.bû.nî
بوونیان	.bûn.yan
بوونە	.bû.ne
بوونەتە	.bû.ne.te
بوونەتەوە	.bû.ne.te.we
بوونەوە	.bû.ne.we
بوونەوەم	.bû.ne.wem
بوونەوەی	.bû.ne.wey
بوونەوەیەکی	.bû.ne.we.ye.kî
بووون	.bû.win
بووژانەوەیە	.bû.ja.ne.we.ye
بووی	.bûy
بووین	.bûyn
بووە	.bu.we
بووەتە	.bu.we.te
بووەتەوە	.bu.we.te.we
بووەوە	.bu.we.we
بپارێزن	.bi.pa.rê.zin
بپارێزێ	.bi.pa.rê.zê
بپارێزێت	.bi.pa.rê.zêt
بچن	.bi.çin
بچنە	.bi.çi.ne
بچووک	.bi.çûk
بچووکی	.bi.çû.kî
بچوک	.bi.çuk
بچینە	.bi.çî.ne
بچێت	.bi.çêt
بچێتە	.bi.çê.te
بڕا	.bi.řa
بڕانی	.bi.řa.nî
بڕبڕەیانە	.biř.bi.ře.ya.ne
بڕوا	.biř.wa
بڕوات	.biř.wat
بڕوانامەی	.biř.wa.na.mey
بڕوانە	.biř.wa.ne
بڕوای	.biř.way
بڕوایان	.biř.wa.yan
بڕگەی	.biř.gey
بڕۆ	.bi.řo
بڕۆن	.bi.řon
بڕی	.bi.řî
بڕیار	.biř.yar
بڕیاردان	.biř.yar.dan
بڕیاردەدەن	.biř.yar.de.den
بڕیارنامە	.biř.yar.na.me
بڕیارنامەکە	.biř.yar.na.me.ke
بڕیارنامەی	.biř.yar.na.mey
بڕیارنامەیە	.biř.yar.na.me.ye
بڕیارنامەیەک	.biř.yar.na.me.yek
بڕیارنامەیەکی	.biř.yar.na.me.ye.kî
بڕیاری	.biř.ya.rî
بڕیاریان	.biř.yar.yan
بڕیاریدا	.biř.ya.rî.da
بڕیارێکی	.biř.ya.rê.kî
بڕیارە	.biř.ya.re
بڕیارەکانی	.biř.ya.re.ka.nî
بڕیارەی	.biř.ya.rey
بڕیبوون	.bi.řî.bûn
بڕینی	.bi.řî.nî
بڕێک	.bi.řêk
بڕێکی	.bi.řê.kî
بڕە	.bi.ře
بڕەخسێ	.bi.řex.sê
بژاردا	.bi.jar.da
بژی	.bi.jî
بژین	.bi.jîn
بژیوی	.bi.jî.wî
بژێوی	.bi.jê.wî
بکا	.bi.ka
بکات	.bi.kat
بکاتە	.bi.ka.te
بکاتەوە	.bi.ka.te.we
بکردایە	.bi.kir.da.ye
بکرێ	.bi.ki.rê
بکرێت	.bi.ki.rêt
بکرێتە	.bi.ki.rê.te
بکرێتەوە	.bi.ki.rê.te.we
بکرێن	.bi.ki.rên
بکرێنەوە	.bi.ki.rê.ne.we
بکڕن	.bi.ki.řin
بکۆچدرێن	.bi.koç.di.rên
بکە	.bi.ke
بکەم	.bi.kem
بکەمەوە	.bi.ke.me.we
بکەن	.bi.ken
بکەنە	.bi.ke.ne
بکەنەوە	.bi.ke.ne.we
بکەوێت	.bi.ke.wêt
بکەوێتە	.bi.ke.wê.te
بکەی	.bi.key
بکەیت	.bi.keyt
بکەین	.bi.keyn
بکەینەوە	.bi.key.ne.we
بگات	.bi.gat
بگاتە	.bi.ga.te
بگرن	.bi.gi.rin
بگرین	.bi.gi.rîn
بگرێ	.bi.gi.rê
بگرێت	.bi.gi.rêt
بگرێتەوە	.bi.gi.rê.te.we
بگرە	.bi.gi.re
بگونجێ	.bi.gun.cê
بگۆڕێت	.bi.go.řêt
بگیردرێن	.bi.gîr.di.rên
بگیرێت	.bi.gî.rêt
بگەن	.bi.gen
بگەنە	.bi.ge.ne
بگەڕێتەوە	.bi.ge.řê.te.we
بگەڕێنەوە	.bi.ge.řê.ne.we
بگەیەنن	.bi.ge.ye.nin
بگەیەنێت	.bi.ge.ye.nêt
بڵاو	.bi.ław
بڵاوببووەوە	.bi.ław.bi.bu.we.we
بڵاوبوونەوە	.bi.ław.bû.ne.we
بڵاوبوونەوەی	.bi.ław.bû.ne.wey
بڵاوبکرێنەوە	.bi.ław.bi.ki.rê.ne.we
بڵاودەکاتەوە	.bi.ław.de.ka.te.we
بڵاودەکردەوە	.bi.ław.de.kir.de.we
بڵاودەکرێتەوە	.bi.ław.de.ki.rê.te.we
بڵاودەکرێنەوە	.bi.ław.de.ki.rê.ne.we
بڵاودەکەنەوە	.bi.ław.de.ke.ne.we
بڵاوکرابوونەوە	.bi.ław.ki.ra.bû.ne.we
بڵاوکرانی	.bi.ław.ki.ra.nî
بڵاوکرانەوە	.bi.ław.ki.ra.ne.we
بڵاوکراو	.bi.ław.ki.raw
بڵاوکراونەتە	.bi.ław.ki.raw.ne.te
بڵاوکراونەتەوە	.bi.ław.ki.raw.ne.te.we
بڵاوکراوی	.bi.ław.ki.ra.wî
بڵاوکراوە	.bi.ław.ki.ra.we
بڵاوکراوەتەوە	.bi.ław.ki.ra.we.te.we
بڵاوکراوەکان	.bi.ław.ki.ra.we.kan
بڵاوکراوەکانی	.bi.ław.ki.ra.we.ka.nî
بڵاوکرایەوە	.bi.ław.ki.ra.ye.we
بڵاوکردنەوە	.bi.ław.kir.di.ne.we
بڵاوکردنەوەدایە	.bi.ław.kir.di.ne.we.da.ye
بڵاوکردنەوەشی	.bi.ław.kir.di.ne.we.şî
بڵاوکردنەوەوە	.bi.ław.kir.di.ne.we.we
بڵاوکردنەوەکەیان	.bi.ław.kir.di.ne.we.ke.yan
بڵاوکردنەوەی	.bi.ław.kir.di.ne.wey
بڵاوکردنەوەیان	.bi.ław.kir.di.ne.we.yan
بڵاوکردنەوەیە	.bi.ław.kir.di.ne.we.ye
بڵاوکردووەتەوە	.bi.ław.kir.du.we.te.we
بڵاوکردەوە	.bi.ław.kir.de.we
بڵاوکرنەوەی	.bi.ław.kir.ne.wey
بڵاوکەر	.bi.ław.ker
بڵاوکەرانەوە	.bi.ław.ke.ra.ne.we
بڵاوکەری	.bi.ław.ke.rî
بڵاوکەرە	.bi.ław.ke.re
بڵاوکەرەوە	.bi.ław.ke.re.we
بڵاوکەرەوەی	.bi.ław.ke.re.wey
بڵاوکەرەکان	.bi.ław.ke.re.kan
بڵاوکەرەکانی	.bi.ław.ke.re.ka.nî
بڵاوی	.bi.ła.wî
بڵاویان	.bi.ław.yan
بڵاویکردبوونەوە	.bi.ła.wî.kir.di.bû.ne.we
بڵاویکردۆتەوە	.bi.ła.wî.kir.do.te.we
بڵاویکردەوە	.bi.ła.wî.kir.de.we
بڵاوێزی	.bi.ła.wê.zî
بڵوێزی	.bił.wê.zî
بڵیتی	.bi.łî.tî
بڵیند	.bi.łînd
بڵیندی	.bi.łîn.dî
بڵێ	.bi.łê
بڵێت	.bi.łêt
بڵێم	.bi.łêm
بڵێن	.bi.łên
بڵێی	.bi.łêy
بڵێین	.bi.łêyn
بڵەین	.bi.łeyn
بۆ	.bo
بۆئەوەی	.bo.ʔe.wey
بۆت	.bot
بۆتان	.bo.tan
بۆتانەوە	.bo.ta.ne.we
بۆتە	.bo.te
بۆتەوە	.bo.te.we
بۆخۆم	.bo.xom
بۆخۆی	.bo.xoy
بۆخۆیان	.bo.xo.yan
بۆردومان	.bor.du.man
بۆرژوازی	.bor.jwa.zî
بۆزارسلان	.bo.zar.si.lan
بۆسۆ	.bo.so
بۆسەر	.bo.ser
بۆشایی	.bo.şa.yî
بۆلای	.bo.lay
بۆم	.bom
بۆمان	.bo.man
بۆمبی	.bom.bî
بۆنی	.bo.nî
بۆنە	.bo.ne
بۆنەوە	.bo.ne.we
بۆنەکەی	.bo.ne.key
بۆنەی	.bo.ney
بۆنەیەوە	.bo.ne.ye.we
بۆوە	.bo.we
بۆچوون	.bo.çûn
بۆچوونی	.bo.çû.nî
بۆچوونیان	.bo.çûn.yan
بۆچوونێکی	.bo.çû.nê.kî
بۆچوونە	.bo.çû.ne
بۆچوونەدا	.bo.çû.ne.da
بۆچوونەوە	.bo.çû.ne.we
بۆچوونەکاندا	.bo.çû.ne.kan.da
بۆچوونەکانی	.bo.çû.ne.ka.nî
بۆچوونەکانیان	.bo.çû.ne.kan.yan
بۆچی	.bo.çî
بۆڕ	.boř
بۆکان	.bo.kan
بۆی	.boy
بۆیان	.bo.yan
بۆیە	.bo.ye
بۆیەش	.bo.yeş
بی	.bî
بیاتی	.bya.tî
بیاندیننەوە	.byan.dî.ni.ne.we
بیانفرۆشن	.byan.fi.ro.şin
بیانووی	.bya.nûy
بیانی	.bya.nî
بیانەوێ	.bya.ne.wê
بیبیسە	.bî.bî.se
بیت	.bît
بیخوێننەوە	.bî.xwê.ni.ne.we
بیر	.bîr
بیرم	.bî.rim
بیرماندا	.bîr.man.da
بیروباسیان	.bî.ru.bas.yan
بیروباوەڕی	.bî.ru.ba.we.řî
بیروبڕوایان	.bî.ru.biř.wa.yan
بیروبۆچوونی	.bî.ru.bo.çû.nî
بیروبۆچوونەکانی	.bî.ru.bo.çû.ne.ka.nî
بیروڕا	.bî.ru.řa
بیروڕاکان	.bî.ru.řa.kan
بیروڕای	.bî.ru.řay
بیرکردنەوە	.bîr.kir.di.ne.we
بیرکردنەوەی	.bîr.kir.di.ne.wey
بیرۆکە	.bî.ro.ke
بیرۆکەی	.bî.ro.key
بیری	.bî.rî
بیریشی	.bî.rî.şî
بیرە	.bî.re
بیرەوەری	.bî.re.we.rî
بیزانم	.bî.za.nim
بیست	.bîst
بیستەم	.bîs.tem
بیسەلمێنن	.bî.sel.mê.nin
بین	.bîn
بیناسێنین	.bî.na.sê.nîn
بینای	.bî.nay
بینراوەکانی	.bîn.ra.we.ka.nî
بینی	.bî.nî
بینیمان	.bî.nî.man
بینین	.bî.nîn
بینیندا	.bî.nîn.da
بینینی	.bî.nî.nî
بینیوە	.bî.nî.we
بینەر	.bî.ner
بیپشکنێ	.bî.piş.ki.nê
بیچمی	.bîç.mî
بیگاتێ	.bî.ga.tê
بیەوێ	.bye.wê
بیەوێت	.bye.wêt
بێ	.bê
بێبڕوایییەش	.bê.biř.wa.yî.yeş
بێبەری	.bê.be.rî
بێبەرین	.bê.be.rîn
بێبەش	.bê.beş
بێبەشکرابوون	.bê.beş.ki.ra.bûn
بێبەشەکاندا	.bê.be.şe.kan.da
بێت	.bêt
بێتە	.bê.te
بێتەوە	.bê.te.we
بێجگە	.bêc.ge
بێدەرەتانی	.bê.de.re.ta.nî
بێدەنگ	.bê.deng
بێدەنگی	.bê.den.gî
بێدەنگییەکی	.bê.den.gî.ye.kî
بێرەجووک	.bê.re.cûk
بێزار	.bê.zar
بێسنی	.bês.nî
بێن	.bên
بێنن	.bê.nin
بێوار	.bê.war
بێژم	.bê.jim
بێژین	.bê.jîn
بێکاری	.bê.ka.rî
بێکەس	.bê.kes
بێگانە	.bê.ga.ne
بێگانەکانیشیان	.bê.ga.ne.ka.nîş.yan
بێگومان	.bê.gu.man
بە	.be
بەئاسانی	.be.ʔa.sa.nî
بەئاشکرا	.be.ʔaş.ki.ra
بەئامادەبوونی	.be.ʔa.ma.de.bû.nî
بەباشی	.be.ba.şî
بەبڕوای	.beb.řway
بەبڕی	.be.bi.řî
بەبۆنەی	.be.bo.ney
بەبێ	.be.bê
بەتاڵ	.be.tał
بەتایبەت	.be.tay.bet
بەتایبەتی	.be.tay.be.tî
بەتایبەتیش	.be.tay.be.tîş
بەتوندی	.be.tun.dî
بەتەما	.be.te.ma
بەتەمای	.be.te.may
بەتەنها	.be.ten.ha
بەتەنیا	.be.ten.ya
بەتەواوی	.be.te.wa.wî
بەتەواوەتی	.be.te.wa.we.tî
بەجۆرێک	.be.co.rêk
بەجێ	.be.cê
بەجێدەهێڵێ	.be.cê.de.hê.łê
بەجێهێشت	.be.cê.hêşt
بەجێگەیە	.be.cê.ge.ye
بەحرەین	.beḧ.reyn
بەختیار	.bext.yar
بەختەوەری	.bex.te.we.rî
بەخشی	.bex.şî
بەخشینی	.bex.şî.nî
بەخۆوە	.be.xo.we
بەخۆپەرمانیان	.be.xo.per.man.yan
بەخۆڕایی	.be.xo.řa.yî
بەخۆی	.be.xoy
بەخۆیەوە	.be.xo.ye.we
بەخێرایی	.be.xê.ra.yî
بەداخەوە	.be.da.xe.we
بەدرخان	.be.dir.xan
بەدرخانەکان	.be.dir.xa.ne.kan
بەدرخانەکانەوە	.be.dir.xa.ne.ka.ne.we
بەدرێژایی	.be.di.rê.ja.yî
بەدرەددین	.bed.red.dîn
بەدواداچوون	.bed.wa.da.çûn
بەدواداچوونی	.be.dwa.da.çû.nî
بەدواوە	.be.dwa.we
بەدوای	.be.dway
بەدوور	.be.dûr
بەدژی	.bed.jî
بەدڵنیاییەوە	.bed.łi.nyay.ye.we
بەدی	.be.dî
بەدیهێنانی	.be.dî.hê.na.nî
بەدەر	.be.der
بەدەست	.be.dest
بەدەستهێنا	.be.dest.hê.na
بەدەستهێنانی	.be.dest.hê.na.nî
بەدەستهێناوە	.be.des.ti.hê.na.we
بەدەستی	.be.des.tî
بەدەستەوە	.be.des.te.we
بەدەم	.be.dem
بەدەگمەن	.be.deg.men
بەر	.ber
بەرازیل	.be.ra.zîl
بەرازیلی	.be.ra.zî.lî
بەراستی	.be.ras.tî
بەرامبەر	.be.ram.ber
بەرامبەردا	.be.ram.ber.da
بەرانبەر	.be.ran.ber
بەراورد	.be.ra.wird
بەراوەرد	.be.ra.werd
بەربڵاوانە	.ber.bi.ła.wa.ne
بەربەرەکانیی	.ber.be.re.ka.nîy
بەربەست	.ber.best
بەرتیلی	.ber.tî.lî
بەرتیلەوە	.ber.tî.le.we
بەرجەستە	.ber.ces.te
بەرخۆدانی	.ber.xo.da.nî
بەرد	.berd
بەردرام	.ber.di.ram
بەردی	.ber.dî
بەردەست	.ber.dest
بەردەم	.ber.dem
بەردەوام	.ber.de.wam
بەردەوامن	.ber.de.wa.min
بەردەوامی	.ber.de.wa.mî
بەردەوامیی	.ber.de.wa.mîy
بەردەوامە	.ber.de.wa.me
بەردەگرێ	.ber.deg.rê
بەرز	.berz
بەرزبوونەوەی	.berz.bû.ne.wey
بەرزتری	.berz.ti.rî
بەرزترین	.be.riz.ti.rîn
بەرزنجی	.ber.zin.cî
بەرزکردنەوەی	.berz.kir.di.ne.wey
بەرزی	.ber.zî
بەرزە	.ber.ze
بەرشەلۆنە	.ber.şe.lo.ne
بەرشەلۆنەی	.ber.şe.lo.ney
بەرفراوان	.ber.fi.ra.wan
بەرقەوڵ	.ber.qewł
بەرلین	.ber.lîn
بەرلەوەی	.ber.le.wey
بەرمیل	.ber.mîl
بەرن	.be.rin
بەرنامە	.ber.na.me
بەرنامەکانی	.ber.na.me.ka.nî
بەرنامەگەلەش	.ber.na.me.ge.leş
بەرنامەی	.ber.na.mey
بەرنامەیەکی	.ber.na.me.ye.kî
بەرهەم	.ber.hem
بەرهەمان	.ber.he.man
بەرهەمانی	.ber.he.ma.nî
بەرهەمانێک	.ber.he.ma.nêk
بەرهەمانە	.ber.he.ma.ne
بەرهەمهێنان	.ber.hem.hê.nan
بەرهەمهێنانی	.ber.hem.hê.na.nî
بەرهەمی	.ber.he.mî
بەرهەمیان	.ber.hem.yan
بەرهەمێک	.ber.he.mêk
بەرهەمێکی	.ber.he.mê.kî
بەرهەمە	.ber.he.me
بەرهەمەکان	.ber.he.me.kan
بەرهەمەکانی	.ber.he.me.ka.nî
بەرهەمەکانیان	.ber.he.me.kan.yan
بەرهەمەکە	.ber.he.me.ke
بەرهەمەکەی	.ber.he.me.key
بەرهەڵست	.ber.he.łist
بەرهەڵستی	.ber.he.łis.tî
بەرهەڵستە	.ber.he.łis.te
بەرهەڵستەکان	.ber.he.łis.te.kan
بەروار	.ber.war
بەرواری	.ber.wa.rî
بەرپرس	.ber.pirs
بەرپرسان	.ber.pir.san
بەرپرسانی	.ber.pir.sa.nî
بەرپرسی	.ber.pir.sî
بەرپرسیار	.ber.pirs.yar
بەرپرسیارێتی	.ber.pirs.ya.rê.tî
بەرپرسێکی	.ber.pir.sê.kî
بەرپرسە	.ber.pir.se
بەرپرسەکانی	.ber.pir.se.ka.nî
بەرچاو	.ber.çaw
بەرچاوترن	.ber.çaw.ti.rin
بەرچاوی	.ber.ça.wî
بەرژەوەندی	.ber.je.wen.dî
بەرژەوەندیی	.ber.je.wen.dîy
بەرژەوەندییە	.ber.je.wen.dî.ye
بەرژەوەندییەکانی	.ber.je.wen.dî.ye.ka.nî
بەرکراون	.ber.ki.ra.win
بەرگری	.ber.gi.rî
بەرگریکردن	.ber.gi.rî.kir.din
بەرگریی	.ber.gi.rîy
بەرگرییان	.ber.gi.rî.yan
بەرگرییەک	.ber.gi.rî.yek
بەرگرییەکان	.ber.gi.rî.ye.kan
بەرگی	.ber.gî
بەرگەکانی	.ber.ge.ka.nî
بەرگەی	.ber.gey
بەری	.be.rî
بەریان	.ber.yan
بەریتانی	.be.rî.ta.nî
بەریتانیا	.be.rî.tan.ya
بەرین	.be.rîn
بەرینایی	.be.rî.na.yî
بەرێ	.be.rê
بەرێز	.be.rêz
بەرێوە	.be.rê.we
بەرێوەبەرایەتی	.be.rê.we.be.ra.ye.tî
بەرێوەبەری	.be.rê.we.be.rî
بەرێوەچوو	.be.rê.we.çû
بەرە	.be.re
بەرەنگاربوونەوەی	.be.ren.gar.bû.ne.wey
بەرەنگاری	.be.ren.ga.rî
بەرەنگارییەکان	.be.ren.ga.rî.ye.kan
بەرەو	.be.rew
بەرەوڕووی	.be.rew.řûy
بەرەوە	.be.re.we
بەرەکانی	.be.re.ka.nî
بەرەکانیان	.be.re.kan.yan
بەرەی	.be.rey
بەزۆر	.be.zor
بەزۆری	.be.zo.rî
بەزەیی	.be.ze.yî
بەس	.bes
بەستن	.bes.tin
بەستنی	.bes.ti.nî
بەستنەوەی	.bes.ti.ne.wey
بەسرە	.bes.re
بەسوود	.be.sûd
بەسە	.be.se
بەسەر	.be.ser
بەسەردا	.be.ser.da
بەسەردەبا	.be.ser.de.ba
بەسەرهاتی	.be.ser.ha.tî
بەسەرۆکایەتی	.be.se.ro.ka.ye.tî
بەش	.beş
بەشار	.be.şar
بەشدار	.beş.dar
بەشداران	.beş.da.ran
بەشدارانە	.beş.da.ra.ne
بەشداربوون	.beş.dar.bûn
بەشدارن	.beş.da.rin
بەشداری	.beş.da.rî
بەشداریان	.beş.dar.yan
بەشداریکردن	.beş.da.rî.kir.din
بەشداریکردنی	.beş.da.rî.kir.di.nî
بەشداریی	.beş.da.rîy
بەشدارییان	.beş.da.rî.yan
بەشدارەکان	.beş.da.re.kan
بەشدارەکانی	.beş.da.re.ka.nî
بەشکچی	.be.şik.çî
بەشی	.be.şî
بەشێوەی	.be.şê.wey
بەشێوەیەک	.be.şê.we.yek
بەشێوەیەکی	.be.şê.we.ye.kî
بەشێک	.be.şêk
بەشێکی	.be.şê.kî
بەشێکیان	.be.şêk.yan
بەشێکە	.be.şê.ke
بەشە	.be.şe
بەشەکانی	.be.şe.ka.nî
بەشەی	.be.şey
بەعس	.be.ƹis
بەعسی	.beƹ.sî
بەعسەکان	.beƹ.se.kan
بەغدا	.beẍ.da
بەغدای	.beẍ.day
بەفر	.be.fir
بەفەرمی	.be.fer.mî
بەلاش	.be.laş
بەلام	.be.lam
بەلاوەنانی	.be.la.we.na.nî
بەلای	.be.lay
بەلجیکا	.bel.cî.ka
بەلکی	.bel.kî
بەلەکی	.be.le.kî
بەم	.bem
بەماناتر	.be.ma.na.tir
بەمانای	.be.ma.nay
بەمانەش	.be.ma.neş
بەمەبەستی	.be.me.bes.tî
بەمەش	.be.meş
بەناو	.be.naw
بەناوبانگ	.be.naw.bang
بەناوبانگی	.be.naw.ban.gî
بەناوبانگەکان	.be.naw.ban.ge.kan
بەناوی	.be.na.wî
بەند	.bend
بەندبکرێ	.bend.bi.ki.rê
بەندکراو	.bend.ki.raw
بەندکراوە	.bend.ki.ra.we
بەندی	.ben.dî
بەندیخاناندا	.ben.dî.xa.nan.da
بەندیخانە	.ben.dî.xa.ne
بەندیخانەدا	.ben.dî.xa.ne.da
بەندیخانەکان	.ben.dî.xa.ne.kan
بەندیخانەکاندا	.ben.dî.xa.ne.kan.da
بەندیخانەکەیە	.ben.dî.xa.ne.ke.ye
بەندیخانەی	.ben.dî.xa.ney
بەندیخانەیە	.ben.dî.xa.ne.ye
بەندیخانەیەکی	.ben.dî.xa.ne.ye.kî
بەندێکی	.ben.dê.kî
بەندە	.ben.de
بەندەکانی	.ben.de.ka.nî
بەنرخە	.be.nir.xe
بەنزین	.ben.zîn
بەنێوبانگ	.be.nêw.bang
بەنێوبانگترین	.be.nêw.bang.ti.rîn
بەنێوبانگەکان	.be.nêw.ban.ge.kan
بەنێوی	.be.nê.wî
بەها	.be.ha
بەهار	.be.har
بەهاری	.be.ha.rî
بەهاوکاری	.be.haw.ka.rî
بەهای	.be.hay
بەهرۆز	.beh.roz
بەهۆی	.be.hoy
بەهۆیەوە	.be.ho.ye.we
بەهیچ	.be.hîç
بەهێز	.be.hêz
بەهێزتر	.be.hêz.tir
بەهێزکردنی	.be.hêz.kir.di.nî
بەهێزی	.be.hê.zî
بەهێزە	.be.hê.ze
بەهەر	.be.her
بەهەشت	.be.heşt
بەهەمان	.be.he.man
بەهەموو	.be.he.mû
بەو	.bew
بەوپەڕی	.bew.pe.řî
بەوە	.be.we
بەوەدا	.be.we.da
بەوەش	.be.weş
بەوەشدا	.be.weş.da
بەوەشکرد	.be.weş.kird
بەوەشەوە	.be.we.şe.we
بەوەکرد	.be.we.kird
بەوەی	.be.wey
بەپێچەوانەوە	.be.pê.çe.wa.ne.we
بەپێچەوانەی	.be.pê.çe.wa.ney
بەپێی	.be.pêy
بەپەلە	.be.pe.le
بەچاکی	.be.ça.kî
بەچەند	.be.çend
بەڕاستی	.be.řas.tî
بەڕای	.be.řay
بەڕووی	.be.řûy
بەڕێ	.be.řê
بەڕێز	.be.řêz
بەڕێزان	.be.řê.zan
بەڕێوبەرەکانی	.be.řêw.be.re.ka.nî
بەڕێوە	.be.řê.we
بەڕێوەبربوو	.be.řê.we.bi.ri.bû
بەڕێوەبردنی	.be.řê.we.bir.di.nî
بەڕێوەبەران	.be.řê.we.be.ran
بەڕێوەبەرانی	.be.řê.we.be.ra.nî
بەڕێوەبەرانیکی	.be.řê.we.be.ra.nî.kî
بەڕێوەبەرایەتی	.be.řê.we.be.ra.ye.tî
بەڕێوەبەرایەتیی	.be.řê.we.be.ra.ye.tîy
بەڕێوەبەرایەتییە	.be.řê.we.be.ra.ye.tî.ye
بەڕێوەبەرایەتییەکان	.be.řê.we.be.ra.ye.tî.ye.kan
بەڕێوەبەرایەتییەکە	.be.řê.we.be.ra.ye.tî.ye.ke
بەڕێوەبەری	.be.řê.we.be.rî
بەڕێوەبەریی	.be.řê.we.be.rîy
بەڕێوەبەرە	.be.řê.we.be.re
بەڕێوەبەرەکان	.be.řê.we.be.re.kan
بەڕێوەبەرەکانی	.be.řê.we.be.re.ka.nî
بەڕێوەدەبران	.be.řê.we.de.bi.ran
بەڕێوەدەچوو	.be.řê.we.de.çû
بەڕێوەدەچوون	.be.řê.we.de.çûn
بەڕێوەدەچێت	.be.řê.we.de.çêt
بەڕێوەچوو	.be.řê.we.çû
بەڕێوەچوونی	.be.řê.we.çû.nî
بەڕێوەی	.be.řê.wey
بەڕێوەیان	.be.řê.we.yan
بەکار	.be.kar
بەکاربهێندرێ	.be.kar.bi.hên.di.rê
بەکاردەهێنران	.be.kar.de.hên.ran
بەکارهێنانی	.be.kar.hê.na.nî
بەکارهێندرابوون	.be.kar.hên.di.ra.bûn
بەکارهێنەری	.be.kar.hê.ne.rî
بەکارهێنەرەکانی	.be.kar.hê.ne.re.ka.nî
بەکارکرد	.be.kar.kird
بەکاری	.be.ka.rî
بەکارەکان	.be.ka.re.kan
بەکر	.be.kir
بەکرێ	.be.ki.rê
بەکورتی	.be.kur.tî
بەکوردی	.be.kur.dî
بەکۆمەڵ	.be.ko.meł
بەکۆچ	.be.koç
بەگ	.beg
بەگشتی	.be.giş.tî
بەگوێرەی	.be.gwê.rey
بەگژیاندا	.be.gij.yan.da
بەڵام	.be.łam
بەڵکو	.beł.ku
بەڵکوو	.beł.kû
بەڵکە	.beł.ke
بەڵکەم	.beł.kem
بەڵگە	.beł.ge
بەڵگەی	.beł.gey
بەڵێ	.be.łê
بەڵێن	.be.łên
بەڵێنی	.be.łê.nî
بەیان	.be.yan
بەیاننامەی	.be.yan.na.mey
بەیاننامەیەکدا	.be.yan.na.me.yek.da
بەیانی	.be.ya.nî
بەیبوون	.bey.bûn
بەیرووت	.bey.rût
بەیرووتدا	.bey.rût.da
بەیرووتیان	.bey.rût.yan
بەیرووتێ	.bey.rû.tê
بەیرووتەوە	.bey.rû.te.we
بەینێکی	.bey.nê.kî
بەیەک	.be.yek
بەیەکەوە	.be.ye.ke.we
ت	.ti
تا	.ta
تائێستا	.ta.ʔês.ta
تائێستاش	.ta.ʔês.taş
تابلۆ	.tab.lo
تابلۆی	.tab.loy
تابوو	.ta.bû
تاد	.tad
تاران	.ta.ran
تاریق	.ta.rîq
تاریک	.ta.rîk
تاریکی	.ta.rî.kî
تازە	.ta.ze
تازەش	.ta.zeş
تازەلاوەکان	.ta.ze.la.we.kan
تازەلەچاپدراو	.ta.ze.le.çap.di.raw
تازەلەچاپدراوەکان	.ta.ze.le.çap.di.ra.we.kan
تازەنووسەر	.ta.ze.nû.ser
تازەنووسەرەکان	.ta.ze.nû.se.re.kan
تازەکاندا	.ta.ze.kan.da
تازەی	.ta.zey
تاش	.taş
تاقمی	.taq.mî
تاقمە	.taq.me
تاقی	.ta.qî
تاقیکردنەوەی	.ta.qî.kir.di.ne.wey
تاقە	.ta.qe
تامەزرۆییی	.ta.mez.ro.yîy
تامەزرۆیییەکی	.ta.mez.ro.yî.ye.kî
تاهیر	.ta.hîr
تاوان	.ta.wan
تاوانبار	.ta.wan.bar
تاوانبارکارییەکی	.ta.wan.bar.ka.rî.ye.kî
تاوانبارکردنی	.ta.wan.bar.kir.di.nî
تاوانباریگەلەدا	.ta.wan.ba.rî.ge.le.da
تاوانباریی	.ta.wan.ba.rîy
تاوانی	.ta.wa.nî
تاوانێک	.ta.wa.nêk
تاوانە	.ta.wa.ne
تاوانەکانی	.ta.wa.ne.ka.nî
تاوانەکەت	.ta.wa.ne.ket
تاوتوێ	.taw.twê
تاوتوێکردنی	.taw.twê.kir.di.nî
تاوەکو	.ta.we.ku
تاک	.tak
تاکو	.ta.ku
تاکوو	.ta.kû
تاکی	.ta.kî
تاکێکی	.ta.kê.kî
تاکە	.ta.ke
تاکەکان	.ta.ke.kan
تاکەکانی	.ta.ke.ka.nî
تاکەکەسی	.ta.ke.ke.sî
تاڵ	.tał
تاڵەبانی	.ta.łe.ba.nî
تایبەت	.tay.bet
تایبەتدا	.tay.bet.da
تایبەتمەندی	.tay.bet.men.dî
تایبەتی	.tay.be.tî
تایبەتیان	.tay.bet.yan
تایبەتیدا	.tay.be.tî.da
تایبەتیش	.tay.be.tîş
تایبەتییەکانی	.tay.be.tî.ye.ka.nî
تایبەتییەکانیان	.tay.be.tî.ye.kan.yan
تایبەتە	.tay.be.te
تایمز	.taymz
تر	.tir
تراک	.ti.rak
تربەسپی	.tir.be.si.pî
تردا	.tir.da
ترس	.tirs
ترسان	.tir.san
ترساون	.tir.sa.win
ترسناک	.tirs.nak
ترسی	.tir.sî
ترسە	.tir.se
ترووسکاییی	.ti.rûs.ka.yîy
تری	.ti.rî
تریان	.tir.yan
تریش	.ti.rîş
تریشەوە	.ti.rî.şe.we
ترین	.ti.rîn
ترە	.ti.re
ترەوە	.ti.re.we
تشرینی	.tiş.rî.nî
تلێفۆن	.ti.lê.fon
تلێفۆنەوە	.ti.lê.fo.ne.we
تمەن	.ti.men
توانا	.twa.na
تواناکانی	.twa.na.ka.nî
توانای	.twa.nay
توانایی	.twa.na.yî
توانی	.twa.nî
توانیان	.twan.yan
توانیاندا	.twan.yan.da
توانیم	.twa.nîm
توانیویانە	.twa.nîw.ya.ne
توانیویە	.twa.nîw.ye
توانیویەتی	.twa.nîw.ye.tî
تورک	.turk
تورکمان	.tur.ki.man
تورکمەن	.turk.men
تورکی	.tur.kî
تورکیا	.turk.ya
تورکیادا	.turk.ya.da
تورکیاش	.turk.yaş
تورکیان	.turk.yan
تورکیاوە	.turk.ya.we
تورکیای	.turk.yay
تورکیایان	.turk.ya.yan
تورکیایە	.turk.ya.ye
تورکیدا	.tur.kî.da
تورکیشی	.tur.kî.şî
تورکیی	.tur.kîy
تورکییان	.tur.kî.yan
تورکییە	.tur.kî.ye
تورکییەوە	.tur.kî.ye.we
تورکییەکان	.tur.kî.ye.kan
تورکییەکاندا	.tur.kî.ye.kan.da
تورکییەکانیان	.tur.kî.ye.kan.yan
تورکیە	.turk.ye
تورکیەکانیان	.turk.ye.kan.yan
تورکەکان	.tur.ke.kan
تورکەکاندا	.tur.ke.kan.da
تورکەکانن	.tur.ke.ka.nin
تورکەکانیشدا	.tur.ke.ka.nîş.da
تورکەکانە	.tur.ke.ka.ne
توشی	.tu.şî
توند	.tund
توندوتیژانەتر	.tun.du.tî.ja.ne.tir
توندوتیژی	.tun.du.tî.jî
توندوتیژیی	.tun.du.tî.jîy
توندوتێژی	.tun.du.tê.jî
توندی	.tun.dî
تونس	.tu.nis
توورەج	.tû.rec
تووش	.tûş
تووشی	.tû.şî
تووڕە	.tû.ře
توێژینەوە	.twê.jî.ne.we
توێژینەوەکانی	.twê.jî.ne.we.ka.nî
توێژینەوەی	.twê.jî.ne.wey
توێژینەوەیەک	.twê.jî.ne.we.yek
توێژینەوەیەکم	.twê.jî.ne.we.ye.kim
توێژەرێکی	.twê.je.rê.kî
تکایە	.ti.ka.ye
تۆ	.to
تۆرەمەی	.to.re.mey
تۆزێک	.to.zêk
تۆسقاڵێکیش	.tos.qa.łê.kîş
تۆش	.toş
تۆفیق	.to.fîq
تۆم	.tom
تۆمار	.to.mar
تۆماردەکرێن	.to.mar.de.ki.rên
تۆمارنەکراون	.to.mar.ne.ki.ra.win
تۆمارنەکراوەکان	.to.mar.ne.ki.ra.we.kan
تۆمارنەکردنی	.to.mar.ne.kir.di.nî
تۆمارکرا	.to.mar.ki.ra
تۆمارکراون	.to.mar.ki.ra.win
تۆمارکراوە	.to.mar.ki.ra.we
تۆمارکرد	.to.mar.kird
تۆمارکردن	.to.mar.kir.din
تۆمارکردنی	.to.mar.kir.di.nî
تۆماری	.to.ma.rî
تۆمارەکان	.to.ma.re.kan
تۆمارەکانی	.to.ma.re.ka.nî
تۆمەتبار	.to.met.bar
تۆمەتی	.to.me.tî
تۆن	.ton
تۆپ	.top
تۆپی	.to.pî
تۆڕی	.to.řî
تۆڕێکی	.to.řê.kî
تۆڵە	.to.łe
تۆی	.toy
تی	.tî
تیا	.tya
تیرۆر	.tî.ror
تیرۆرکردنی	.tî.ror.kir.di.nî
تیرۆری	.tî.ro.rî
تیرۆریست	.tî.ro.rîst
تیرۆریستان	.tî.ro.rîs.tan
تیرۆریستانی	.tî.ro.rîs.ta.nî
تیرۆریستی	.tî.ro.rîs.tî
تیرۆژ	.tî.roj
تیرێژ	.tî.rêj
تیشک	.tîşk
تیشکی	.tîş.kî
تیمی	.tî.mî
تیپی	.tî.pî
تیژی	.tî.jî
تیۆری	.tyo.rî
تیۆریی	.tyo.rîy
تیۆرییەکی	.tyo.rî.ye.kî
تێ	.tê
تێبکۆشن	.tê.bi.ko.şin
تێبینی	.tê.bî.nî
تێبینیگەلی	.tê.bî.nî.ge.lî
تێدا	.tê.da
تێدایە	.tê.da.ye
تێدەپەڕێ	.tê.de.pe.řê
تێدەچوو	.tê.de.çû
تێدەچێ	.tê.de.çê
تێدەکۆشا	.tê.de.ko.şa
تێدەکۆشان	.tê.de.ko.şan
تێدەکۆشن	.tê.de.ko.şin
تێدەکۆشی	.tê.de.ko.şî
تێدەکۆشێ	.tê.de.ko.şê
تێر	.têr
تێرمینۆلۆژی	.têr.mî.no.lo.jî
تێرمینۆلۆژیکی	.têr.mî.no.lo.jî.kî
تێرمینۆلۆژیی	.têr.mî.no.lo.jîy
تێرۆریزم	.tê.ro.rî.zim
تێرۆریزمەوە	.tê.ro.rîz.me.we
تێزی	.tê.zî
تێزێک	.tê.zêk
تێپەڕ	.tê.peř
تێپەڕبوونی	.tê.peř.bû.nî
تێپەڕی	.tê.pe.řî
تێپەڕینی	.tê.pe.řî.nî
تێچوون	.tê.çûn
تێچووون	.tê.çû.win
تێڕوانینی	.tê.řwa.nî.nî
تێک	.têk
تێکدانی	.têk.da.nî
تێکنیکانی	.têk.nî.ka.nî
تێکچوونی	.têk.çû.nî
تێکڕا	.têk.řa
تێکڕای	.têk.řay
تێکۆشان	.tê.ko.şan
تێکۆشانی	.tê.ko.şa.nî
تێکۆشی	.tê.ko.şî
تێکۆشیبوو	.tê.ko.şî.bû
تێکۆشین	.tê.ko.şîn
تێکۆشیون	.tê.ko.şî.win
تێکۆشیوە	.tê.ko.şî.we
تێکەڵ	.tê.keł
تێگەیشتن	.tê.geyş.tin
تێگەیشتنی	.tê.geyş.ti.nî
تێیاندا	.tê.yan.da
تێیدا	.têy.da
تە	.te
تەئکیدی	.teʔ.kî.dî
تەبایی	.te.ba.yî
تەرخان	.ter.xan
تەرمی	.ter.mî
تەسلیم	.tes.lîm
تەشهیر	.teş.hîr
تەقسیم	.teq.sîm
تەقینەوە	.te.qî.ne.we
تەقینەوەی	.te.qî.ne.wey
تەقە	.te.qe
تەقەمەنی	.te.qe.me.nî
تەقەی	.te.qey
تەلڤیزیۆنی	.tel.vîz.yo.nî
تەلڤیزیۆنییەکان	.tel.vîz.yo.nî.ye.kan
تەلێفۆن	.te.lê.fon
تەلەب	.te.leb
تەلەفزیۆن	.te.le.fiz.yon
تەلەفزیۆنی	.te.le.fiz.yo.nî
تەلەفۆن	.te.le.fon
تەلەفیزیۆنی	.te.le.fîz.yo.nî
تەلەڤیزیۆن	.te.le.vîz.yon
تەلەڤیزیۆنی	.te.le.vîz.yo.nî
تەلەڤیزیۆنییەکانی	.te.le.vîz.yo.nî.ye.ka.nî
تەلەڤیزیۆنە	.te.le.vîz.yo.ne
تەلەڤیزیۆنەکان	.te.le.vîz.yo.ne.kan
تەماشا	.te.ma.şa
تەماشای	.te.ma.şay
تەماوی	.te.ma.wî
تەمموز	.tem.muz
تەمووزی	.te.mû.zî
تەمۆ	.te.mo
تەمەن	.te.men
تەمەنی	.te.me.nî
تەمەنیان	.te.men.yan
تەنانەت	.te.na.net
تەندروست	.ten.di.rust
تەندروستی	.ten.di.rus.tî
تەندروستیی	.ten.di.rus.tîy
تەنگاوییەک	.ten.ga.wî.yek
تەنگدا	.ten.gi.da
تەنیا	.ten.ya
تەنیایی	.ten.ya.yî
تەنیاییدا	.ten.ya.yî.da
تەنیشت	.te.nîşt
تەها	.te.ha
تەواو	.te.waw
تەواوبوونی	.te.waw.bû.nî
تەواوکردنی	.te.waw.kir.di.nî
تەواوی	.te.wa.wî
تەواویی	.te.wa.wîy
تەواوەتی	.te.wa.we.tî
تەواوەتیی	.te.wa.we.tîy
تەواوەوە	.te.wa.we.we
تەوەری	.te.we.rî
تەوەرەکانی	.te.we.re.ka.nî
تەوەرەکانیان	.te.we.re.kan.yan
تەک	.tek
تەکنیکی	.tek.nî.kî
تەکنیکییەوە	.tek.nî.kî.ye.we
تەکنەلۆژیا	.tek.ne.loj.ya
تەکنەلۆژیای	.tek.ne.loj.yay
تەیب	.te.yib
جا	.ca
جار	.car
جاران	.ca.ran
جارانیش	.ca.ra.nîş
جارانەی	.ca.ra.ney
جارجار	.car.car
جارجاریش	.car.ca.rîş
جاروبار	.ca.ru.bar
جاروبارنامە	.ca.ru.bar.na.me
جاری	.ca.rî
جاریش	.ca.rîş
جارێ	.ca.rê
جارێک	.ca.rêk
جارێکی	.ca.rê.kî
جارێکیتر	.ca.rê.kî.tir
جارە	.ca.re
جاف	.caf
جامی	.ca.mî
جان	.can
جاندان	.can.dan
جببە	.cib.be
جببەش	.cib.beş
جددی	.cid.dî
جزیر	.ci.zîr
جزیری	.ci.zî.rî
جغارەکانیان	.ci.ẍa.re.kan.yan
جل	.cil
جلوبەرگی	.ci.lu.ber.gî
جلی	.ci.lî
جم	.cim
جوان	.cwan
جوانتان	.cwan.tan
جوانتر	.cwan.tir
جوانترین	.cwan.ti.rîn
جوانی	.cwa.nî
جوانیان	.cwan.yan
جوانە	.cwa.ne
جودا	.cu.da
جوغرافییەکانەوە	.cuẍ.ra.fî.ye.ka.ne.we
جومهووریەت	.cum.hûr.yet
جوولەکەکان	.cû.le.ke.kan
جووڵ	.cûł
جوێ	.cwê
جگە	.ci.ge
جگەر	.ci.ger
جگەرخوێن	.ci.ger.xwên
جگەرخوێنیش	.ci.ger.xwê.nîş
جگەرە	.ci.ge.re
جۆر	.cor
جۆراو	.co.raw
جۆراوجۆر	.co.raw.cor
جۆراوجۆری	.co.raw.co.rî
جۆراوجۆرەوە	.co.raw.co.re.we
جۆراوجۆرەکانی	.co.raw.co.re.ka.nî
جۆربەجۆر	.cor.be.cor
جۆربەجۆری	.cor.be.co.rî
جۆربەجۆریان	.cor.be.cor.yan
جۆربەجۆرەوە	.cor.be.co.re.we
جۆربەجۆرەکان	.cor.be.co.re.kan
جۆربەجۆرەکاندا	.cor.be.co.re.kan.da
جۆربەجۆرەکانی	.cor.be.co.re.ka.nî
جۆربەجۆرەکانەوە	.cor.be.co.re.ka.ne.we
جۆرج	.corc
جۆری	.co.rî
جۆرێک	.co.rêk
جۆرێکی	.co.rê.kî
جۆرە	.co.re
جۆرەکانی	.co.re.ka.nî
جۆرەی	.co.rey
جۆن	.con
جی	.cî
جیا	.cya
جیابوونەوە	.cya.bû.ne.we
جیاتی	.cya.tî
جیاجیا	.cya.cya
جیاجیاکانی	.cya.cya.ka.nî
جیاواز	.cya.waz
جیاوازن	.cya.wa.zin
جیاوازی	.cya.wa.zî
جیاوازیان	.cya.waz.yan
جیاوازیی	.cya.wa.zîy
جیاوازییان	.cya.wa.zî.yan
جیاوازییەکان	.cya.wa.zî.ye.kan
جیاوازییەکی	.cya.wa.zî.ye.kî
جیاوازە	.cya.wa.ze
جیاوازەوە	.cya.wa.ze.we
جیاوازەکان	.cya.wa.ze.kan
جیاوازەکانی	.cya.wa.ze.ka.nî
جیاکارییە	.cya.ka.rî.ye
جیاکراونەتەوە	.cya.ki.raw.ne.te.we
جیاکردنەوەی	.cya.kir.di.ne.wey
جیایی	.cya.yî
جیددی	.cîd.dî
جینۆساید	.cî.no.sayd
جیهاد	.cî.had
جیهان	.cî.han
جیهاندا	.cî.han.da
جیهانی	.cî.ha.nî
جیهانیدا	.cî.ha.nî.da
جیهانیی	.cî.ha.nîy
جیهانە	.cî.ha.ne
جیهانەوە	.cî.ha.ne.we
جێ	.cê
جێبەجێ	.cê.be.cê
جێبەجێنەکرانی	.cê.be.cê.ne.ki.ra.nî
جێبەجێکردنی	.cê.be.cê.kir.di.nî
جێبەجێی	.cê.be.cêy
جێگاکەی	.cê.ga.key
جێگای	.cê.gay
جێگایەک	.cê.ga.yek
جێگری	.cê.gi.rî
جێگریی	.cê.gi.rîy
جێگیر	.cê.gîr
جێگە	.cê.ge
جێگەی	.cê.gey
جێی	.cêy
جە	.ce
جەبار	.ce.bar
جەخت	.cext
جەختی	.cex.tî
جەختیشیان	.cex.tîş.yan
جەستە	.ces.te
جەستەی	.ces.tey
جەستەیی	.ces.te.yî
جەعفەر	.ceƹ.fer
جەفەر	.ce.fer
جەلادەت	.ce.la.det
جەلال	.ce.lal
جەلەولا	.ce.lew.la
جەمال	.ce.mal
جەماوەر	.ce.ma.wer
جەماوەری	.ce.ma.we.rî
جەمیل	.ce.mîl
جەنابی	.ce.na.bî
جەنگ	.ceng
جەنگی	.cen.gî
جەنگەوە	.cen.ge.we
جەنگەکە	.cen.ge.ke
جەنگەیەدا	.cen.ge.ye.da
جەوهەر	.cew.her
جەوهەری	.cew.he.rî
جەژن	.ce.jin
جەژنی	.cej.nî
جەڤدەت	.cev.det
حاجی	.ḧa.cî
حاستیدا	.ḧas.tî.da
حافیز	.ḧa.fîz
حاندی	.ḧan.dî
حاکم	.ḧa.kim
حاڵ	.ḧał
حاڵی	.ḧa.łî
حاڵێک	.ḧa.łêk
حاڵێکدا	.ḧa.łêk.da
حاڵێکدایە	.ḧa.łêk.da.ye
حاڵەت	.ḧa.łet
حاڵەتی	.ḧa.łe.tî
حاڵەتێکی	.ḧa.łe.tê.kî
حاڵەتە	.ḧa.łe.te
حدک	.ḧi.dik
حدکا	.ḧid.ka
حزبە	.ḧiz.be
حساب	.ḧi.sab
حسابی	.ḧi.sa.bî
حسنێ	.ḧis.nê
حورییەت	.ḧu.rî.yet
حوزنی	.ḧuz.nî
حوزەیران	.ḧu.zey.ran
حوسێن	.ḧu.sên
حوسێنی	.ḧu.sê.nî
حوسەین	.ḧu.seyn
حوکم	.ḧu.kim
حوکمڕانی	.ḧu.kim.řa.nî
حوکمی	.ḧuk.mî
حکومەت	.ḧi.ku.met
حکومەتی	.ḧi.ku.me.tî
حکومەتێکی	.ḧi.ku.me.tê.kî
حکومەتەکەی	.ḧi.ku.me.te.key
حکوومەت	.ḧi.kû.met
حکوومەتدا	.ḧi.kû.met.da
حکوومەتی	.ḧi.kû.me.tî
حکوومەتیدا	.ḧi.kû.me.tî.da
حکوومەتییە	.ḧi.kû.me.tî.ye
حکوومەتییەکان	.ḧi.kû.me.tî.ye.kan
حکوومەتێکی	.ḧi.kû.me.tê.kî
حکوومەتە	.ḧi.kû.me.te
حکوومەتەوە	.ḧi.kû.me.te.we
حکوومەتەکانی	.ḧi.kû.me.te.ka.nî
حیزب	.ḧîzb
حیزبی	.ḧîz.bî
حیزبێک	.ḧîz.bêk
حیزبێکی	.ḧîz.bê.kî
حیزبە	.ḧîz.be
حیزبەکان	.ḧîz.be.kan
حیزبەکانی	.ḧîz.be.ka.nî
حەز	.ḧez
حەزرەتی	.ḧez.re.tî
حەزم	.ḧe.zim
حەزی	.ḧe.zî
حەستەم	.ḧes.tem
حەستەمەشدا	.ḧes.te.meş.da
حەسیچە	.ḧe.sî.çe
حەسیچەن	.ḧe.sî.çen
حەسەن	.ḧe.sen
حەسەنێ	.ḧe.se.nê
حەشاردنەوە	.ḧe.şar.di.ne.we
حەفتەیەک	.ḧef.te.yek
حەق	.ḧeq
حەقیقەت	.ḧe.qî.qet
حەلەب	.ḧe.leb
حەلەبدا	.ḧe.leb.da
حەلەبێ	.ḧe.le.bê
حەمسۆرۆ	.ḧem.so.ro
حەمکە	.ḧem.ke
حەمۆ	.ḧe.mo
حەمۆدا	.ḧe.mo.da
حەمۆی	.ḧe.moy
حەمید	.ḧe.mîd
حەمە	.ḧe.me
حەمەد	.ḧe.med
حەمەی	.ḧe.mey
حەوت	.ḧewt
حەوتەمین	.ḧew.te.mîn
حەولیان	.ḧewl.yan
حەکاری	.ḧe.ka.rî
حەکیم	.ḧe.kîm
حەکیمخان	.ḧe.kîm.xan
حەیدەر	.ḧey.der
خاتوو	.xa.tû
خارپێت	.xar.pêt
خارپێتیش	.xar.pê.tîş
خاس	.xas
خاسی	.xa.sî
خاسە	.xa.se
خالدی	.xa.li.dî
خالید	.xa.lîd
خامنەیی	.xam.ne.yî
خان	.xan
خانم	.xa.nim
خانمە	.xa.ni.me
خانوو	.xa.nû
خانووبەرەی	.xa.nû.be.rey
خانووی	.xa.nûy
خانوویەکی	.xa.nû.ye.kî
خانووەکە	.xa.nu.we.ke
خانی	.xa.nî
خانەقین	.xa.ne.qîn
خانەوادەی	.xa.ne.wa.dey
خانەی	.xa.ney
خاوێن	.xa.wên
خاوەن	.xa.wen
خاوەنان	.xa.we.nan
خاوەنانەش	.xa.we.na.neş
خاوەنداریی	.xa.wen.da.rîy
خاوەندارێتیشی	.xa.wen.da.rê.tî.şî
خاوەنی	.xa.we.nî
خاوەنێکی	.xa.we.nê.kî
خاوەنە	.xa.we.ne
خاوەنەکان	.xa.we.ne.kan
خاوەنەکانی	.xa.we.ne.ka.nî
خاوەنەکانیان	.xa.we.ne.kan.yan
خاوەنەکانیانە	.xa.we.ne.kan.ya.ne
خاوەنەکەش	.xa.we.ne.keş
خاوەنەکەی	.xa.we.ne.key
خاک	.xak
خاکی	.xa.kî
خاڵ	.xał
خاڵی	.xa.łî
خاڵێکی	.xa.łê.kî
خاڵە	.xa.łe
خاڵەکانی	.xa.łe.ka.nî
خایاند	.xa.yand
خایاندی	.xa.yan.dî
خدر	.xi.dir
خرا	.xi.ra
خراوە	.xi.ra.we
خراوەتە	.xi.ra.we.te
خراپ	.xi.rap
خراپتر	.xi.rap.tir
خراپی	.xi.ra.pî
خراپە	.xi.ra.pe
خرایە	.xi.ra.ye
خزم	.xi.zim
خزماتگوزارییەکانی	.xiz.mat.gu.za.rî.ye.ka.nî
خزمەت	.xiz.met
خزمەتکردنی	.xiz.met.kir.di.nî
خزمەتگوزاری	.xiz.met.gu.za.rî
خزمەتگوزارییەک	.xiz.met.gu.za.rî.yek
خزمەتگوزارییەکانی	.xiz.met.gu.za.rî.ye.ka.nî
خزمەتگۆزاریی	.xiz.met.go.za.rîy
خزمەتگۆزارییەکانی	.xiz.met.go.za.rî.ye.ka.nî
خزمەتی	.xiz.me.tî
خزمەکانیان	.xiz.me.kan.yan
خزمەکانیش	.xiz.me.ka.nîş
خستنی	.xis.ti.nî
خستنە	.xis.ti.ne
خستۆتە	.xis.to.te
خستە	.xis.te
خستەڕوو	.xis.te.řû
خشتەکەی	.xiş.te.key
خشتەی	.xiş.tey
خنجیلانەی	.xin.cî.la.ney
خوا	.xwa
خوار	.xwar
خوارد	.xward
خواردن	.xwar.din
خواردنی	.xwar.di.nî
خواردنەوە	.xwar.di.ne.we
خواردنەوەی	.xwar.di.ne.wey
خوارێ	.xwa.rê
خوارێیە	.xwa.rê.ye
خوارەوە	.xwa.re.we
خوارەوەی	.xwa.re.wey
خوازیاری	.xwaz.ya.rî
خواست	.xwast
خواستی	.xwas.tî
خوای	.xway
خوایە	.xwa.ye
خود	.xud
خودا	.xu.da
خودای	.xu.day
خودایە	.xu.da.ye
خودی	.xu.dî
خورماتوو	.xur.ma.tû
خوشک	.xuşk
خوشکی	.xuş.kî
خول	.xul
خولقابێ	.xul.qa.bê
خولقاندنی	.xul.qan.di.nî
خولقێندراون	.xul.qên.di.ra.win
خولی	.xu.lî
خولە	.xu.le
خولەک	.xu.lek
خولەکی	.xu.le.kî
خولەکە	.xu.le.ke
خولەکەکانی	.xu.le.ke.ka.nî
خومەینی	.xu.mey.nî
خوناڤ	.xu.nav
خونتا	.xun.ta
خونتای	.xun.tay
خونتایەکی	.xun.ta.ye.kî
خووی	.xûy
خوویان	.xû.yan
خوێن	.xwên
خوێناوی	.xwê.na.wî
خوێندبوویان	.xwên.di.bû.yan
خوێندن	.xwên.din
خوێندنگە	.xwên.din.ge
خوێندنگەکان	.xwên.din.ge.kan
خوێندنگەکاندا	.xwên.din.ge.kan.da
خوێندنگەیان	.xwên.din.ge.yan
خوێندنگەیەک	.xwên.din.ge.yek
خوێندنگەیەکی	.xwên.din.ge.ye.kî
خوێندنی	.xwên.di.nî
خوێندنەوە	.xwên.di.ne.we
خوێندنەوەکانی	.xwên.di.ne.we.ka.nî
خوێندنەوەی	.xwên.di.ne.wey
خوێندنەوەیان	.xwên.di.ne.we.yan
خوێندوویانە	.xwên.dû.ya.ne
خوێندووە	.xwên.du.we
خوێندکار	.xwênd.kar
خوێندکاران	.xwênd.ka.ran
خوێندکارانی	.xwênd.ka.ra.nî
خوێندکاری	.xwênd.ka.rî
خوێندکاریدا	.xwênd.ka.rî.da
خوێندکارێک	.xwênd.ka.rêk
خوێندکارەکان	.xwênd.ka.re.kan
خوێندگەکاندا	.xwênd.ge.kan.da
خوێندگەگەلێک	.xwênd.ge.ge.lêk
خوێندگەی	.xwênd.gey
خوێندەواری	.xwên.de.wa.rî
خوێندەواریی	.xwên.de.wa.rîy
خوێندەوارە	.xwên.de.wa.re
خوێندەوارەکان	.xwên.de.wa.re.kan
خوێندەوە	.xwên.de.we
خوێنرایەوە	.xwên.ra.ye.we
خوێنگەکاندا	.xwên.ge.kan.da
خوێنی	.xwê.nî
خوێنەر	.xwê.ner
خوێنەران	.xwê.ne.ran
خوێنەرانی	.xwê.ne.ra.nî
خوێنەرانیش	.xwê.ne.ra.nîş
خوێنەرانەش	.xwê.ne.ra.neş
خوێنەری	.xwê.ne.rî
خوێنەرە	.xwê.ne.re
خوێنەرەکان	.xwê.ne.re.kan
خوێنەرەکانی	.xwê.ne.re.ka.nî
خوە	.xwe
خوەسنیان	.xwe.sin.yan
خوەندەڤان	.xwen.de.van
خڕ	.xiř
خڕکەمەوە	.xiř.ke.me.we
خڕیان	.xiř.yan
خۆ	.xo
خۆبێژ	.xo.bêj
خۆبەڕێوەبردن	.xo.be.řê.we.bir.din
خۆت	.xot
خۆتان	.xo.tan
خۆتانەوە	.xo.ta.ne.we
خۆتۆمار	.xo.to.mar
خۆتێوەردانی	.xo.tê.wer.da.nî
خۆتێوەردانەکانی	.xo.tê.wer.da.ne.ka.nî
خۆر	.xor
خۆرئاوا	.xor.ʔa.wa
خۆراک	.xo.rak
خۆراکی	.xo.ra.kî
خۆرهەڵاتی	.xor.he.ła.tî
خۆزات	.xo.zat
خۆزگە	.xoz.ge
خۆش	.xoş
خۆشبەختانە	.xoş.bex.ta.ne
خۆشحاڵ	.xoş.ḧał
خۆشحاڵی	.xoş.ḧa.łî
خۆشم	.xo.şim
خۆشگوزەرانی	.xoş.gu.ze.ra.nî
خۆشی	.xo.şî
خۆشیان	.xoş.yan
خۆشە	.xo.şe
خۆشەویست	.xo.şe.wîst
خۆشەویستی	.xo.şe.wîs.tî
خۆم	.xom
خۆمان	.xo.man
خۆمم	.xo.mim
خۆناساندنیان	.xo.na.san.din.yan
خۆوە	.xo.we
خۆپیشاندان	.xo.pî.şan.dan
خۆپیشاندانی	.xo.pî.şan.da.nî
خۆپیشاندەران	.xo.pî.şan.de.ran
خۆڕاگری	.xo.řa.gi.rî
خۆڕایییانە	.xo.řa.yî.ya.ne
خۆکوژی	.xo.ku.jî
خۆڵیان	.xoł.yan
خۆڵەمێش	.xo.łe.mêş
خۆی	.xoy
خۆیان	.xo.yan
خۆیاندا	.xo.yan.da
خۆیانی	.xo.ya.nî
خۆیانە	.xo.ya.ne
خۆیانەوە	.xo.ya.ne.we
خۆیدا	.xoy.da
خۆیشی	.xoy.şî
خۆیی	.xo.yî
خۆیەتی	.xo.ye.tî
خۆیەوە	.xo.ye.we
خێر	.xêr
خێرا	.xê.ra
خێراکار	.xê.ra.kar
خێراکارانێک	.xê.ra.ka.ra.nêk
خێراکارەکان	.xê.ra.ka.re.kan
خێرایی	.xê.ra.yî
خێزان	.xê.zan
خێزانانێکی	.xê.za.na.nê.kî
خێزانی	.xê.za.nî
خێزانە	.xê.za.ne
خێزانەکانیان	.xê.za.ne.kan.yan
خێزانەکەم	.xê.za.ne.kem
خێزانەکەی	.xê.za.ne.key
خێڵە	.xê.łe
خێی	.xêy
خە	.xe
خەبات	.xe.bat
خەباتگێرەکانی	.xe.bat.gê.re.ka.nî
خەباتگێڕی	.xe.bat.gê.řî
خەباتگێڕیی	.xe.bat.gê.řîy
خەباتگێڕە	.xe.bat.gê.ře
خەباتی	.xe.ba.tî
خەباتەکانیان	.xe.ba.te.kan.yan
خەرج	.xerc
خەرجی	.xer.cî
خەریک	.xe.rîk
خەریکن	.xe.rî.kin
خەریکی	.xe.rî.kî
خەریکیان	.xe.rîk.yan
خەریکە	.xe.rî.ke
خەلات	.xe.lat
خەلک	.xelk
خەلکی	.xel.kî
خەلیفە	.xe.lî.fe
خەلیل	.xe.lîl
خەم	.xem
خەمی	.xe.mî
خەو	.xew
خەون	.xewn
خەونی	.xew.nî
خەوی	.xe.wî
خەڵات	.xe.łat
خەڵاتی	.xe.ła.tî
خەڵاتیان	.xe.łat.yan
خەڵاتێکی	.xe.ła.tê.kî
خەڵاتە	.xe.ła.te
خەڵاتەش	.xe.ła.teş
خەڵاتەکان	.xe.ła.te.kan
خەڵاتەکانی	.xe.ła.te.ka.nî
خەڵک	.xełk
خەڵکانی	.xeł.ka.nî
خەڵکدا	.xełk.da
خەڵکی	.xeł.kî
خەڵکێک	.xeł.kêk
خەڵکێکی	.xeł.kê.kî
خەڵکە	.xeł.ke
خەڵکەوە	.xeł.ke.we
خەڵکەکانی	.xeł.ke.ka.nî
خەڵکەکە	.xeł.ke.ke
خەڵکەکەی	.xeł.ke.key
خەیالی	.xe.ya.lî
خەیاڵ	.xe.yał
خەیاڵی	.xe.ya.łî
دا	.da
داب	.dab
دابا	.da.ba
دابخرێ	.da.bi.xi.rê
دابمەزرێ	.da.bi.mez.rê
دابمەزرێن	.da.bi.mez.rên
دابمەزرێندرێ	.da.bi.mez.rên.di.rê
دابمەزرێندرێن	.da.bi.mez.rên.di.rên
دابمەزرێنن	.da.bi.mez.rê.nin
دابنرێت	.da.bi.ni.rêt
دابنێت	.da.bi.nêt
دابنێن	.da.bi.nên
دابوو	.da.bû
دابوون	.da.bûn
دابوونێ	.da.bû.nê
دابووەوە	.da.bu.we.we
دابڕاوەکانی	.da.bi.řa.we.ka.nî
دابین	.da.bîn
دابینکردنی	.da.bîn.kir.di.nî
دابێ	.da.bê
دابێت	.da.bêt
دابەزاندنی	.da.be.zan.di.nî
دابەزاندووە	.da.be.zan.du.we
دابەزینی	.da.be.zî.nî
دابەش	.da.beş
دابەشکردنی	.da.beş.kir.di.nî
دات	.dat
داتێ	.da.tê
داخرا	.da.xi.ra
داخران	.da.xi.ran
داخستنی	.da.xis.ti.nî
داخستین	.da.xis.tîn
داخوازی	.da.xwa.zî
داخوازەکەی	.da.xwa.ze.key
داخەوە	.da.xe.we
داد	.dad
دادئەستێن	.dad.ʔes.tên
دادئەستێنیی	.dad.ʔes.tê.nîy
دادخوازی	.dad.xwa.zî
دادوەر	.dad.wer
دادوەری	.dad.we.rî
دادوەرییەکان	.dad.we.rî.ye.kan
دادپەروەری	.dad.per.we.rî
دادگا	.dad.ga
دادگادا	.dad.ga.da
دادگای	.dad.gay
دادگایی	.dad.ga.yî
دادەشکێ	.da.deş.kê
دادەشکێتەوە	.da.deş.kê.te.we
دادەمەزرێندرێ	.da.de.mez.rên.di.rê
دادەمەزرێنن	.da.de.mez.rê.nin
دادەنرێت	.da.de.ni.rêt
دادەنرێن	.da.de.ni.rên
دادەنێت	.da.de.nêt
دادەنێردرێن	.da.de.nêr.di.rên
دادەنێن	.da.de.nên
دار	.dar
دارا	.da.ra
دارایی	.da.ra.yî
داری	.da.rî
دارێژراوە	.da.rêj.ra.we
داساکاندن	.da.sa.kan.din
داسەپان	.da.se.pan
داسەپاند	.da.se.pand
داسەپاندن	.da.se.pan.din
داسەپانیان	.da.se.pan.yan
داسەپێندراوە	.da.se.pên.di.ra.we
داشکانی	.da.şi.ka.nî
داشکانێکی	.da.şi.ka.nê.kî
داشکانەوە	.da.şi.ka.ne.we
داعش	.da.ƹiş
داعشەوە	.da.ƹi.şe.we
دام	.dam
دامرکاندنی	.da.mir.kan.di.nî
دامرکاودا	.da.mir.kaw.da
دامڕشتبوو	.dam.řiş.ti.bû
دامەزرا	.da.mez.ra
دامەزرابوون	.da.mez.ra.bûn
دامەزراند	.da.mez.rand
دامەزراندن	.da.mez.ran.din
دامەزراندنی	.da.mez.ran.di.nî
دامەزراندووە	.da.mez.ran.du.we
دامەزرانی	.da.mez.ra.nî
دامەزراون	.da.mez.ra.win
دامەزراوە	.da.mez.ra.we
دامەزراوەی	.da.mez.ra.wey
دامەزراوەیەکی	.da.mez.ra.we.ye.kî
دامەزرێندراون	.da.mez.rên.di.ra.win
دامەزرێندراوە	.da.mez.rên.di.ra.we
دامەزرێندرێ	.da.mez.rên.di.rê
دامەزرێنێ	.da.mez.rê.nê
دامەوە	.da.me.we
دان	.dan
دانا	.da.na
دانابوون	.da.na.bûn
دانان	.da.nan
دانانی	.da.na.nî
داناون	.da.na.win
داناوە	.da.na.we
دانراوە	.da.ni.ra.we
دانمارک	.dan.mark
دانوستان	.da.nus.tan
دانووستانی	.da.nûs.ta.nî
دانی	.da.nî
دانیشتن	.da.nîş.tin
دانیشتنی	.da.nîş.ti.nî
دانیشتوان	.da.nîş.twan
دانیشتووان	.da.nîş.tu.wan
دانیشتوواندا	.da.nîş.tu.wan.da
دانیشتووانی	.da.nîş.tu.wa.nî
دانیشتووانە	.da.nîş.tu.wa.ne
دانیشتووایەتیدا	.da.nîş.tu.wa.ye.tî.da
دانیشتووایەتیی	.da.nîş.tu.wa.ye.tîy
دانیشتووایەتییان	.da.nîş.tu.wa.ye.tî.yan
دانیشتوون	.da.nîş.tûn
دانیشتووی	.da.nîş.tûy
دانیشتووە	.da.nîş.tu.we
دانیشتووەکان	.da.nîş.tu.we.kan
دانیشووانی	.da.nî.şu.wa.nî
دانیشێنرابوون	.da.nî.şên.ra.bûn
دانیەل	.dan.yel
دانێن	.da.nên
دانە	.da.ne
دانەبەزێنن	.da.ne.be.zê.nin
دانەمەزراندنی	.da.ne.mez.ran.di.nî
دانەوە	.da.ne.we
دانەوەی	.da.ne.wey
دانەیە	.da.ne.ye
داهات	.da.hat
داهاتوو	.da.ha.tû
داهاتوودا	.da.ha.tû.da
داهاتووشدا	.da.ha.tûş.da
داهاتووی	.da.ha.tûy
داهاتی	.da.ha.tî
داهێزانی	.da.hê.za.nî
داهێنان	.da.hê.nan
داهێنانی	.da.hê.na.nî
داهێنران	.da.hên.ran
داهێنەرانی	.da.hê.ne.ra.nî
داو	.daw
داوا	.da.wa
داواخوازانە	.da.wa.xwa.za.ne
داواخوازیی	.da.wa.xwa.zîy
داواکاری	.da.wa.ka.rî
داواکاریشی	.da.wa.ka.rî.şî
داواکاریی	.da.wa.ka.rîy
داواکارییان	.da.wa.ka.rî.yan
داواکاریییەکە	.da.wa.ka.rîy.ye.ke
داواکارییە	.da.wa.ka.rî.ye
داواکارییەکانی	.da.wa.ka.rî.ye.ka.nî
داواکارییەکیان	.da.wa.ka.rî.yek.yan
داواکارییەکە	.da.wa.ka.rî.ye.ke
داواکارییەی	.da.wa.ka.rî.yey
داواکارەکانی	.da.wa.ka.re.ka.nî
داوای	.da.way
داوایان	.da.wa.yan
داود	.da.wid
داون	.da.win
داونەتەوە	.daw.ne.te.we
داوی	.da.wî
داوە	.da.we
داوەتێ	.da.we.tê
داوەتە	.da.we.te
داوەتەوە	.da.we.te.we
داڕشتنی	.da.řiş.ti.nî
داڕووخانی	.da.řû.xa.nî
داڕووخانە	.da.řû.xa.ne
داڕێژاندنی	.da.řê.jan.di.nî
داڕێژانی	.da.řê.ja.nî
داڕێژراو	.da.řêj.raw
داڕێژەران	.da.řê.je.ran
داڕێژەرانی	.da.řê.je.ra.nî
داڕێژەری	.da.řê.je.rî
داڕێژەرەکانی	.da.řê.je.re.ka.nî
داکۆکی	.da.ko.kî
داگرتن	.da.gir.tin
داگیر	.da.gîr
داگیرکرا	.da.gîr.ki.ra
داگیرکرد	.da.gîr.kird
داگیرکردبوون	.da.gîr.kir.di.bûn
داگیرکردنی	.da.gîr.kir.di.nî
داگیرکەر	.da.gîr.ker
داگیریان	.da.gîr.yan
دایانمەزراندوون	.da.yan.mez.ran.dûn
دایانگرن	.da.yan.gi.rin
دایدەنێن	.day.de.nên
دایک	.dayk
دایکم	.day.kim
دایکی	.day.kî
دایکیان	.dayk.yan
دایکییان	.day.kî.yan
دایکەکان	.day.ke.kan
دایکەکانیانەوە	.day.ke.kan.ya.ne.we
دایە	.da.ye
دایەوە	.da.ye.we
ددان	.di.dan
ددانانم	.di.da.na.nim
در	.dir
درا	.di.ra
درابن	.di.ra.bin
درابوون	.di.ra.bûn
درابوویێ	.di.ra.bû.yê
درابێ	.di.ra.bê
درامای	.di.ra.may
دران	.di.ran
دراو	.di.raw
دراوسێ	.di.raw.sê
دراون	.di.ra.win
دراونەتەوە	.di.raw.ne.te.we
دراوێک	.di.ra.wêk
دراوێکی	.di.ra.wê.kî
دراوە	.di.ra.we
دراوەش	.di.ra.weş
دراوەوە	.di.ra.we.we
درنگی	.di.rin.gî
دروست	.di.rust
دروستبوونی	.di.rust.bû.nî
دروستکراوە	.di.rust.ki.ra.we
دروستکرد	.di.rust.kird
دروستکردنی	.di.rust.kir.di.nî
دروستکردووە	.di.rust.kir.du.we
دروستی	.di.rus.tî
دروشمی	.di.ruş.mî
درووست	.di.rûst
درکێندران	.dir.kên.di.ran
درۆ	.di.ro
درۆشمێکی	.di.roş.mê.kî
درۆشمەکەی	.di.roş.me.key
درێژ	.di.rêj
درێژایی	.di.rê.ja.yî
درێژخایەن	.di.rêj.xa.yen
درێژخایەنەوە	.di.rêj.xa.ye.ne.we
درێژخایەنەکە	.di.rêj.xa.ye.ne.ke
درێژی	.di.rê.jî
درێژیی	.di.rê.jîy
درێژە	.di.rê.je
درێژەی	.di.rê.jey
درەنگ	.di.reng
دزی	.di.zî
دزیی	.di.zîy
دزەکان	.di.ze.kan
دلاوەر	.di.la.wer
دلاوەرێ	.di.la.we.rê
دنیا	.din.ya
دنیادا	.din.ya.da
دنیای	.din.yay
دنە	.di.ne
دنەدەری	.di.ne.de.rî
دهۆک	.di.hok
دهۆکی	.di.ho.kî
دهۆکێ	.di.ho.kê
دوا	.dwa
دوابەدوای	.dwa.be.dway
دواتر	.dwa.tir
دواتری	.dwa.ti.rî
دواتریش	.dwa.ti.rîş
دواجار	.dwa.car
دواخستنی	.dwa.xis.ti.nî
دوازدە	.dwaz.de
دوام	.dwam
دوان	.dwan
دواون	.dwa.win
دواوە	.dwa.we
دواکەوت	.dwa.kewt
دواکەوتنی	.dwa.kew.ti.nî
دواکەوتنە	.dwa.kew.ti.ne
دوای	.dway
دواین	.dwayn
دوایی	.dwa.yî
دواییانەدا	.dway.ya.ne.da
دواییدا	.dwa.yî.da
دوایین	.dwa.yîn
دواییی	.dwa.yîy
دوایییانە	.dwa.yî.ya.ne
دوایییانەدا	.dwa.yî.ya.ne.da
دواییەی	.dway.yey
دوبارە	.du.ba.re
دور	.dur
دوستاخ	.dus.tax
دولاری	.du.la.rî
دوو	.dû
دووبارە	.dû.ba.re
دووبەڵا	.dû.be.ła
دوور	.dûr
دووردەست	.dûr.dest
دوورلەبڕوای	.dûr.le.biř.way
دووری	.dû.rî
دوورە	.dû.re
دوورەنگی	.dû.ren.gî
دوورەوڵاتیدا	.dû.re.wi.ła.tî.da
دووزمانە	.dû.zi.ma.ne
دووزمانەکان	.dû.zi.ma.ne.kan
دووشەممە	.dû.şem.me
دوولایەنەی	.dû.la.ye.ney
دووهەم	.dû.hem
دووهەمدا	.dû.hem.da
دووهەمی	.dû.he.mî
دووهەمیان	.dû.hem.yan
دووهەمین	.dû.he.mîn
دووهەمەکە	.dû.he.me.ke
دووهەمەکەشیان	.dû.he.me.keş.yan
دووپات	.dû.pat
دووپاتکردەوە	.dû.pat.kir.de.we
دووپاتی	.dû.pa.tî
دووکانەکانی	.dû.ka.ne.ka.nî
دووگۆلی	.dû.go.lî
دووی	.dûy
دووەم	.du.wem
دووەمدا	.du.wem.da
دووەمی	.du.we.mî
دووەمیان	.du.wem.yan
دووەمیش	.du.we.mîş
دووەمین	.du.we.mîn
دوچاری	.du.ça.rî
دوژمن	.duj.min
دوژمنانی	.duj.mi.na.nî
دوژمنی	.duj.mi.nî
دوکان	.du.kan
دوێنی	.dwê.nî
دوێنێ	.dwê.nê
دڕووتریشدایە	.di.řû.ti.rîş.da.ye
دژ	.dij
دژایەتی	.di.ja.ye.tî
دژایەتیی	.di.ja.ye.tîy
دژایەتییان	.di.ja.ye.tî.yan
دژوار	.dij.war
دژوارکردنەوەی	.dij.war.kir.di.ne.wey
دژوارە	.dij.wa.re
دژی	.di.jî
دژیان	.dij.yan
دژە	.di.je
دکتۆر	.dik.tor
دڵ	.dił
دڵسۆز	.dił.soz
دڵسۆزی	.dił.so.zî
دڵشاد	.dił.şad
دڵم	.di.łim
دڵنیا	.dił.nya
دڵنیام	.dił.nyam
دڵنیایی	.dił.nya.yî
دڵنیایییەوە	.dił.nya.yî.ye.we
دڵی	.di.łî
دڵە	.di.łe
دڵەڕاوکێی	.di.łe.řaw.kêy
دڵەکاندا	.di.łe.kan.da
دۆخی	.do.xî
دۆخێکدا	.do.xêk.da
دۆخێکی	.do.xê.kî
دۆخە	.do.xe
دۆخەدا	.do.xe.da
دۆخەشدا	.do.xeş.da
دۆخەکە	.do.xe.ke
دۆزراوەکانم	.doz.ra.we.ka.nim
دۆزراوەکانی	.doz.ra.we.ka.nî
دۆزی	.do.zî
دۆزیبووەوە	.do.zî.bu.we.we
دۆزینەوەی	.do.zî.ne.wey
دۆزیونەتەوە	.do.zîw.ne.te.we
دۆست	.dost
دۆستایەتی	.dos.ta.ye.tî
دۆستی	.dos.tî
دۆسیە	.dos.ye
دۆسیەکانی	.dos.ye.ka.nî
دۆسیەکەیان	.dos.ye.ke.yan
دۆسیەگەلی	.dos.ye.ge.lî
دۆسیەی	.dos.yey
دۆسیەیەکی	.dos.ye.ye.kî
دۆقان	.do.qan
دۆلار	.do.lar
دۆلاری	.do.la.rî
دی	.dî
دیا	.dya
دیار	.dyar
دیاربەکر	.dyar.be.kir
دیاربەکردا	.dyar.be.kir.da
دیاربەکردایە	.dyar.be.kir.da.ye
دیاربەکرن	.dyar.be.ki.rin
دیاربەکری	.dyar.be.ki.rî
دیاربەکریش	.dyar.be.ki.rîş
دیاربەکرێ	.dyar.be.ki.rê
دیاربەکرە	.dyar.be.ki.re
دیاربەکرەوە	.dyar.be.ki.re.we
دیاردە	.dyar.de
دیاردەگەلێکی	.dyar.de.ge.lê.kî
دیاردەی	.dyar.dey
دیاردەیە	.dyar.de.ye
دیاردەیەکی	.dyar.de.ye.kî
دیاری	.dya.rî
دیاریکراو	.dya.rî.ki.raw
دیاریکراودا	.dya.rî.ki.raw.da
دیاریکراوی	.dya.rî.ki.ra.wî
دیاریکردنی	.dya.rî.kir.di.nî
دیارە	.dya.re
دیالۆگ	.dya.log
دیالە	.dya.le
دیبوونیەوە	.dî.bûn.ye.we
دیت	.dît
دیتم	.dî.tim
دیتمەوە	.dît.me.we
دیتنی	.dî.ti.nî
دیتەوە	.dî.te.we
دیجلە	.dîc.le
دیجیتاڵی	.dî.cî.ta.łî
دیدار	.dî.dar
دیداری	.dî.da.rî
دیدارەدا	.dî.da.re.da
دیدی	.dî.dî
دیسان	.dî.san
دیسانەوە	.dî.sa.ne.we
دیش	.dîş
دیموکراتی	.dî.muk.ra.tî
دیمۆکراتیکە	.dî.mok.ra.tî.ke
دیمۆکراتیکەکانی	.dî.mok.ra.tî.ke.ka.nî
دیمەشق	.dî.meşq
دیمەنی	.dî.me.nî
دین	.dîn
دینار	.dî.nar
دیناری	.dî.na.rî
دینی	.dî.nî
دیواری	.dî.wa.rî
دیوانی	.dî.wa.nî
دیونەتەوە	.dîw.ne.te.we
دیوی	.dî.wî
دیویانە	.dîw.ya.ne
دیوە	.dî.we
دیوەتەوە	.dî.we.te.we
دیکتاتۆر	.dîk.ta.tor
دیکتاتۆری	.dîk.ta.to.rî
دیکە	.dî.ke
دیکەدا	.dî.ke.da
دیکەش	.dî.keş
دیکەشی	.dî.ke.şî
دیکەشیان	.dî.keş.yan
دیکەشەوە	.dî.ke.şe.we
دیکەوە	.dî.ke.we
دیکەی	.dî.key
دیکەیان	.dî.ke.yan
دێ	.dê
دێت	.dêt
دێتە	.dê.te
دێتەوە	.dê.te.we
دێرسم	.dêr.sim
دێرسیم	.dêr.sîm
دێرک	.dê.rik
دێرین	.dê.rîn
دێرینی	.dê.rî.nî
دێفۆ	.dê.fo
دێموکرات	.dê.muk.rat
دێموکراتی	.dê.muk.ra.tî
دێموکراتیک	.dê.muk.ra.tîk
دێموکراسی	.dê.muk.ra.sî
دێن	.dên
دێنن	.dê.nin
دێننە	.dê.ni.ne
دێنێ	.dê.nê
دێنە	.dê.ne
دێپارتمانی	.dê.par.ti.ma.nî
دێڕان	.dê.řan
دێڕانە	.dê.řa.ne
دە	.de
دەبا	.de.ba
دەبات	.de.bat
دەبرا	.de.bi.ra
دەبرد	.de.bird
دەبردن	.de.bir.din
دەبردە	.de.bir.de
دەبرێ	.deb.rê
دەبرێن	.deb.rên
دەبم	.de.bim
دەبن	.de.bin
دەبنە	.de.bi.ne
دەبنەوە	.de.bi.ne.we
دەبوایە	.de.bwa.ye
دەبوو	.de.bû
دەبوون	.de.bûn
دەبووە	.de.bu.we
دەبیت	.de.bît
دەبیست	.de.bîst
دەبین	.de.bîn
دەبیندرا	.de.bîn.di.ra
دەبیندرێ	.de.bîn.di.rê
دەبیندرێنەوە	.de.bîn.di.rê.ne.we
دەبینرێ	.de.bîn.rê
دەبینرێت	.de.bîn.rêt
دەبینرێن	.de.bîn.rên
دەبینم	.de.bî.nim
دەبینن	.de.bî.nin
دەبینی	.de.bî.nî
دەبینین	.de.bî.nîn
دەبینێ	.de.bî.nê
دەبینێت	.de.bî.nêt
دەبینێتەوە	.de.bî.nê.te.we
دەبێ	.de.bê
دەبێت	.de.bêt
دەبێتە	.de.bê.te
دەبێتەوە	.de.bê.te.we
دەبەخشێت	.de.bex.şêt
دەبەستێت	.de.bes.têt
دەبەن	.de.ben
دەبەنگ	.de.beng
دەبەی	.de.bey
دەتاراند	.de.ta.rand
دەتواندرێ	.de.twan.di.rê
دەتواندرێن	.de.twan.di.rên
دەتوانرێ	.de.twan.rê
دەتوانرێت	.de.twan.rêt
دەتوانم	.de.twa.nim
دەتوانن	.de.twa.nin
دەتوانیت	.de.twa.nît
دەتوانین	.de.twa.nîn
دەتوانێ	.de.twa.nê
دەتوانێت	.de.twa.nêt
دەتگوت	.det.gut
دەجووڵانەوەی	.de.cû.ła.ne.wey
دەجووڵێنەوە	.de.cû.łê.ne.we
دەخا	.de.xa
دەخات	.de.xat
دەخاتە	.de.xa.te
دەخایێنێ	.de.xa.yê.nê
دەخران	.de.xi.ran
دەخرێتە	.de.xi.rê.te
دەخرێن	.de.xi.rên
دەخوازێت	.de.xwa.zêt
دەخوێندرانەوە	.dex.wên.di.ra.ne.we
دەخوێننەوە	.de.xwê.ni.ne.we
دەخۆڕی	.de.xo.řî
دەخەمڵێندرێ	.de.xem.łên.di.rê
دەخەنە	.de.xe.ne
دەدا	.de.da
دەدات	.de.dat
دەداتە	.de.da.te
دەداتەوە	.de.da.te.we
دەدام	.de.dam
دەدامەوە	.de.da.me.we
دەدان	.de.dan
دەدانێ	.de.da.nê
دەدرا	.de.di.ra
دەدران	.de.di.ran
دەدرێ	.de.di.rê
دەدرێت	.de.di.rêt
دەدرێن	.de.di.rên
دەدن	.de.din
دەدوان	.ded.wan
دەدۆزرایەوە	.de.doz.ra.ye.we
دەدۆزرێنەوە	.de.doz.rê.ne.we
دەدەم	.de.dem
دەدەن	.de.den
دەدەنێ	.de.de.nê
دەدەنەوە	.de.de.ne.we
دەدەین	.de.deyn
دەر	.der
دەرئەنجامی	.der.ʔen.ca.mî
دەرئەنجامێکی	.der.ʔen.ca.mê.kî
دەربارەی	.der.ba.rey
دەرباز	.der.baz
دەرببڕیبا	.der.bib.řî.ba
دەرببڕیت	.der.bi.bi.řît
دەربخات	.der.bi.xat
دەربڕیبوو	.der.bi.řî.bû
دەربڕین	.der.bi.řîn
دەربڕینی	.der.bi.řî.nî
دەربڕیوە	.der.bi.řî.we
دەربەندیخان	.der.ben.dî.xan
دەرخست	.der.xist
دەرخستم	.der.xis.tim
دەرخستووە	.der.xis.tu.we
دەردەبڕی	.der.deb.řî
دەردەخا	.der.de.xa
دەردەخات	.der.de.xat
دەردەچێت	.der.de.çêt
دەردەکەوت	.der.de.kewt
دەردەکەون	.der.de.ke.win
دەردەکەوێ	.der.de.ke.wê
دەردەکەوێت	.der.de.ke.wêt
دەرفەت	.der.fet
دەرفەتی	.der.fe.tî
دەرفەتێکیان	.der.fe.têk.yan
دەرفەتە	.der.fe.te
دەرمان	.der.man
دەرمانی	.der.ma.nî
دەرناخا	.der.na.xa
دەرنەکەوتووە	.der.ne.kew.tu.we
دەرهاتنی	.der.ha.ti.nî
دەرهێنانی	.der.hê.na.nî
دەرهێنەر	.der.hê.ner
دەرهێنەری	.der.hê.ne.rî
دەرهەق	.der.heq
دەروازەی	.der.wa.zey
دەرونی	.de.ru.nî
دەروونی	.de.rû.nî
دەرووی	.de.rûy
دەرچوو	.der.çû
دەرچوون	.der.çûn
دەرچوونی	.der.çû.nî
دەرچووە	.der.çu.we
دەرکرا	.der.ki.ra
دەرکرد	.der.kird
دەرکردنی	.der.kir.di.nî
دەرکەوت	.der.kewt
دەرکەوتن	.der.kew.tin
دەرکەوتنی	.der.kew.ti.nî
دەرکەوتوون	.der.kew.tûn
دەرکەوتووە	.der.kew.tu.we
دەرکەوێ	.der.ke.wê
دەرگا	.der.ga
دەرگای	.der.gay
دەری	.de.rî
دەریا	.der.ya
دەریانخست	.der.yan.xist
دەریای	.der.yay
دەریایی	.der.ya.yî
دەرێ	.de.rê
دەرەبەگانەدا	.de.re.be.ga.ne.da
دەرەوە	.de.re.we
دەرەوەی	.de.re.wey
دەرەکی	.de.re.kî
دەزاندران	.de.zan.di.ran
دەزانم	.de.za.nim
دەزانن	.de.za.nin
دەزانی	.de.za.nî
دەزانین	.de.za.nîn
دەزانێ	.de.za.nê
دەزانێت	.de.za.nêt
دەزگا	.dez.ga
دەزگاکانی	.dez.ga.ka.nî
دەزگای	.dez.gay
دەزگایەکی	.dez.ga.ye.kî
دەزگە	.dez.ge
دەزگەی	.dez.gey
دەس	.des
دەسبەسەرکردنی	.des.be.ser.kir.di.nî
دەست	.dest
دەستبەجێ	.dest.be.cê
دەستبەدەست	.dest.be.dest
دەستبەرداری	.dest.ber.da.rî
دەستبەست	.dest.best
دەستبەسەر	.dest.be.ser
دەستخۆشی	.dest.xo.şî
دەستدا	.dest.da
دەستدرێژی	.dest.di.rê.jî
دەستم	.des.tim
دەستمان	.dest.man
دەستنووس	.dest.nûs
دەستنووسانێک	.dest.nû.sa.nêk
دەستنووسە	.dest.nû.se
دەستنووسەکانی	.dest.nû.se.ka.nî
دەستنووسەکانیان	.dest.nû.se.kan.yan
دەستنیشان	.dest.nî.şan
دەستنیشانکردنی	.dest.nî.şan.kir.di.nî
دەستنیشانی	.dest.nî.şa.nî
دەستور	.des.tur
دەستوری	.des.tu.rî
دەستوور	.des.tûr
دەستووری	.des.tû.rî
دەستوورەوە	.des.tû.re.we
دەستپێدەکات	.dest.pê.de.kat
دەستپێکردنی	.dest.pê.kird.nî
دەستپێکی	.dest.pê.kî
دەستکەوت	.dest.kewt
دەستکەوتی	.dest.kew.tî
دەستکەوتە	.dest.kew.te
دەستکەوتەکانی	.dest.kew.te.ka.nî
دەستگیر	.dest.gîr
دەستگیرکراوەکانیش	.dest.gîr.ki.ra.we.ka.nîş
دەستگیرکردنی	.dest.gîr.kir.di.nî
دەستی	.des.tî
دەستیان	.dest.yan
دەستیپێکرد	.des.tî.pê.kird
دەستێوەردانی	.des.tê.wer.da.nî
دەستە	.des.te
دەستەبەر	.des.te.ber
دەستەوە	.des.te.we
دەستەڵاتی	.des.te.ła.tî
دەستەی	.des.tey
دەسحەقی	.des.ḧe.qî
دەسحەقێک	.des.ḧe.qêk
دەسووتاندن	.de.sû.tan.din
دەسپێرن	.des.pê.rin
دەسەلات	.de.se.lat
دەسەلمێندرا	.de.sel.mên.di.ra
دەسەڵات	.de.se.łat
دەسەڵاتدا	.de.se.łat.da
دەسەڵاتدار	.de.se.łat.dar
دەسەڵاتداران	.de.se.łat.da.ran
دەسەڵاتدارانی	.de.se.łat.da.ra.nî
دەسەڵاتداری	.de.se.łat.da.rî
دەسەڵاتداریی	.de.se.łat.da.rîy
دەسەڵاتدارەکان	.de.se.łat.da.re.kan
دەسەڵاتدارەکانی	.de.se.łat.da.re.ka.nî
دەسەڵاتی	.de.se.ła.tî
دەسەڵاتێکی	.de.se.ła.tê.kî
دەسەڵاتە	.de.se.ła.te
دەشاردنەوە	.de.şar.di.ne.we
دەشتوانن	.deş.twa.nin
دەشتوانێ	.deş.twa.nê
دەشتی	.deş.tî
دەشزانن	.deş.za.nin
دەشفرۆشرێن	.deş.fi.roş.rên
دەشڵێ	.deş.łê
دەشڵێت	.deş.łêt
دەشیانگوت	.deş.yan.gut
دەشێت	.de.şêt
دەشەلێ	.de.şe.lê
دەفتەری	.def.te.rî
دەفرۆشت	.de.fi.roşt
دەفرۆشتنەوە	.def.roş.ti.ne.we
دەفرۆشدران	.def.roş.di.ran
دەفرۆشدرێن	.def.roş.di.rên
دەفرۆشران	.def.roş.ran
دەفرۆشرێ	.def.roş.rê
دەفرۆشرێن	.def.roş.rên
دەفرۆشن	.def.ro.şin
دەفرۆشێ	.def.ro.şê
دەفەرموێت	.de.fer.mwêt
دەق	.deq
دەقی	.de.qî
دەقە	.de.qe
دەلاڤ	.de.lav
دەلوا	.del.wa
دەم	.dem
دەما	.de.ma
دەمانەوێت	.de.ma.ne.wêt
دەمهەوێ	.dem.he.wê
دەمهەوێت	.dem.he.wêt
دەموونرانەوە	.de.mûn.ra.ne.we
دەمۆکراتیا	.de.mok.rat.ya
دەمی	.de.mî
دەمیش	.de.mîş
دەمیشق	.de.mîşq
دەمیشقیش	.de.mîş.qîş
دەمێنییەوە	.de.mê.nî.ye.we
دەمێنێتەوە	.de.mê.nê.te.we
دەمێک	.de.mêk
دەمەوێ	.de.me.wê
دەن	.den
دەنا	.de.na
دەناردن	.de.nar.din
دەناساند	.de.na.sand
دەناسرێن	.de.nas.rên
دەناسێنن	.de.na.sê.nin
دەنان	.de.nan
دەنووسرێن	.de.nûs.rên
دەنووسن	.de.nû.sin
دەنووسنەوە	.de.nû.si.ne.we
دەنووسی	.de.nû.sî
دەنووسێ	.de.nû.sê
دەنووسێت	.de.nû.sêt
دەنوێندرا	.de.nwên.di.ra
دەنگ	.deng
دەنگدان	.deng.dan
دەنگدانی	.deng.da.nî
دەنگدانەکاندا	.den.gi.da.ne.kan.da
دەنگی	.den.gî
دەنگیان	.deng.yan
دەنگێ	.den.gê
دەنگێکی	.den.gê.kî
دەنگە	.den.ge
دەنگەکان	.den.ge.kan
دەنگەکانی	.den.ge.ka.nî
دەنیز	.de.nîz
دەنێت	.de.nêt
دەنێردران	.de.nêr.di.ran
دەنێردرێن	.de.nêr.di.rên
دەنێردرێنەوە	.de.nêr.di.rê.ne.we
دەنێرن	.de.nê.rin
دەنێرنە	.de.nê.ri.ne
دەنێرێ	.de.nê.rê
دەهات	.de.hat
دەهاتن	.de.ha.tin
دەهاتە	.de.ha.te
دەهاویشتنە	.de.ha.wîş.ti.ne
دەهێنا	.de.hê.na
دەهێندرێن	.de.hên.di.rên
دەهێنرا	.de.hên.ra
دەهێنرێ	.de.hên.rê
دەهێنرێن	.de.hên.rên
دەهێنرێنە	.de.hên.rê.ne
دەهێنن	.de.hê.nin
دەهێنێت	.de.hê.nêt
دەهێوراند	.de.hêw.rand
دەهە	.de.he
دەو	.dew
دەوروبەر	.dew.ru.ber
دەوروبەری	.dew.ru.be.rî
دەوروپشتیان	.dew.ru.pişt.yan
دەوری	.dew.rî
دەورێکی	.dew.rê.kî
دەورەیی	.dew.re.yî
دەولەتی	.dew.le.tî
دەوڵەت	.dew.łet
دەوڵەتانی	.dew.łe.ta.nî
دەوڵەتی	.dew.łe.tî
دەوڵەتێکی	.dew.łe.tê.kî
دەوڵەتە	.dew.łe.te
دەوڵەمەند	.dew.łe.mend
دەویست	.de.wîst
دەوێ	.de.wê
دەوێت	.de.wêt
دەوێرن	.de.wê.rin
دەپارێزرێ	.de.pa.rêz.rê
دەپرسا	.de.pir.sa
دەپرینگانەوە	.de.pi.rîn.ga.ne.we
دەپەرمنە	.de.per.mi.ne
دەپەیڤن	.de.pey.vin
دەچن	.de.çin
دەچنە	.de.çi.ne
دەچوو	.de.çû
دەچووقاند	.de.çû.qand
دەچوومەوە	.de.çû.me.we
دەچوون	.de.çûn
دەچووە	.de.çu.we
دەچێ	.de.çê
دەچێت	.de.çêt
دەچێتە	.de.çê.te
دەڕوات	.de.řwat
دەڕۆن	.de.řon
دەژی	.de.jî
دەژیان	.dej.yan
دەژین	.de.jîn
دەڤەری	.de.ve.rî
دەڤەرێک	.de.ve.rêk
دەڤەرە	.de.ve.re
دەکا	.de.ka
دەکات	.de.kat
دەکاتە	.de.ka.te
دەکاتەوە	.de.ka.te.we
دەکرا	.de.ki.ra
دەکران	.de.ki.ran
دەکرانەوە	.de.ki.ra.ne.we
دەکرایەوە	.de.ki.ra.ye.we
دەکرد	.de.kird
دەکردن	.de.kir.din
دەکردنەوە	.de.kir.di.ne.we
دەکردەوە	.de.kir.de.we
دەکرێ	.de.ki.rê
دەکرێت	.de.ki.rêt
دەکرێتە	.de.ki.rê.te
دەکرێتەوە	.de.ki.rê.te.we
دەکرێن	.de.ki.rên
دەکرێنەوە	.de.ki.rê.ne.we
دەکوژران	.de.kuj.ran
دەکڕدرێن	.de.kiř.di.rên
دەکڕن	.de.ki.řin
دەکڕی	.de.ki.řî
دەکڕێ	.de.ki.řê
دەکۆچێندران	.de.ko.çên.di.ran
دەکەم	.de.kem
دەکەمەوە	.de.ke.me.we
دەکەن	.de.ken
دەکەنە	.de.ke.ne
دەکەنەوە	.de.ke.ne.we
دەکەون	.de.ke.win,.de.kewn
دەکەونە	.de.ke.wi.ne
دەکەوێ	.de.ke.wê
دەکەوێت	.de.ke.wêt
دەکەوێتە	.de.ke.wê.te
دەکەوێتەوە	.de.ke.wê.te.we
دەکەی	.de.key
دەکەیت	.de.keyt
دەکەین	.de.keyn
دەکەینەوە	.de.key.ne.we
دەگا	.de.ga
دەگات	.de.gat
دەگاتێ	.de.ga.tê
دەگاتە	.de.ga.te
دەگرت	.de.girt
دەگرتەوە	.de.gir.te.we
دەگرن	.de.gi.rin
دەگرێ	.de.gi.rê
دەگرێت	.de.gi.rêt
دەگرێتەوە	.de.gi.rê.te.we
دەگمەن	.deg.men
دەگوت	.de.gut
دەگوترێ	.de.gut.rê
دەگوترێت	.de.gut.rêt
دەگۆڕێت	.de.go.řêt
دەگیرا	.de.gî.ra
دەگیران	.de.gî.ran
دەگیردرا	.de.gîr.di.ra
دەگیردرێن	.de.gîr.di.rên
دەگێڕاوە	.de.gê.řa.we
دەگێڕێتەوە	.de.gê.řê.te.we
دەگەرێتەوە	.de.ge.rê.te.we
دەگەل	.de.gel
دەگەڕان	.de.ge.řan
دەگەڕێت	.de.ge.řêt
دەگەڕێتەوە	.de.ge.řê.te.we
دەگەڕێنن	.de.ge.řê.nin
دەگەڵ	.de.geł
دەگەڵی	.de.ge.łî
دەگەڵیان	.de.geł.yan
دەگەیەنێت	.de.ge.ye.nêt
دەڵێ	.de.łê
دەڵێت	.de.łêt
دەڵێم	.de.łêm
دەڵێن	.de.łên
دەڵێیت	.de.łêyt
دەڵێین	.de.łêyn
دەی	.dey
دەیان	.de.yan
دەیانتوانی	.de.yan.twa.nî
دەیانسپێرن	.de.yan.si.pê.rin
دەیانفرۆشن	.de.yan.fi.ro.şin
دەیاننووسی	.de.yan.nû.sî
دەیانهێنینە	.de.yan.hê.nî.ne
دەیانهەوێ	.de.yan.he.wê
دەیانهەوێت	.de.yan.he.wêt
دەیانوێرا	.de.yan.wê.ra
دەیانڕەخسێنێ	.de.yan.řex.sê.nê
دەیانکوت	.de.yan.kut
دەیانکڕن	.de.yan.kiřn
دەیانگوت	.de.yan.gut
دەیانەوێ	.de.ya.ne.wê
دەیتوانی	.dey.twa.nî
دەیزانی	.dey.za.nî
دەیسپێرن	.dey.si.pê.rin
دەینەوە	.dey.ne.we
دەیهەوێت	.dey.he.wêt
دەیویست	.dey.wîst
دەیپشکنیم	.dey.piş.ki.nîm
دەیکات	.dey.kat
دەیکەن	.dey.ken
دەیگوت	.dey.gut
دەیەوێ	.de.ye.wê
دەیەی	.de.yey
رابردم	.ra.bir.dim
رابردوو	.ra.bir.dû
رابردوودا	.ra.bir.dû.da
رابردووی	.ra.bir.dûy
رابردوویەکی	.ra.bir.dû.ye.kî
رابردووەوە	.ra.bir.du.we.we
رابگیردرێ	.ra.bi.gîr.di.rê
رابگەیەندرێ	.ra.bi.ge.yen.di.rê
راحەتتر	.ra.ḧet.tir
رادیۆ	.rad.yo
رادەوەستێندرێن	.ra.de.wes.tên.di.rên
رادەگوێزن	.ra.de.gwê.zin
رادەیە	.ra.de.ye
رادەیەک	.ra.de.yek
رادەیەکی	.ra.de.ye.kî
راست	.rast
راستمان	.rast.man
راستی	.ras.tî
راستیدا	.ras.tî.da
راستیی	.ras.tîy
راستییە	.ras.tî.ye
راستییەکان	.ras.tî.ye.kan
راستییەکەیان	.ras.tî.ye.ke.yan
راستە	.ras.te
راستەقینە	.ras.te.qî.ne
راستەقینەن	.ras.te.qî.nen
راستەقینەکانی	.ras.te.qî.ne.ka.nî
راستەقینەی	.ras.te.qî.ney
راستەوخۆ	.ras.tew.xo
راستەوخۆیان	.ras.tew.xo.yan
راسپاردەکان	.ra.si.par.de.kan
راشکاو	.ra.şi.kaw
رامانەوە	.ra.ma.ne.we
راماونەتەوە	.ra.maw.ne.te.we
رامیار	.ram.yar
رامیارە	.ram.ya.re
رامیز	.ra.mîz
رانەهاتوون	.ra.ne.ha.tûn
راهاتبوون	.ra.ha.ti.bûn
راهێنانی	.ra.hê.na.nî
راوەستێندران	.ra.wes.tên.di.ran
راپرسنامەکان	.ra.pirs.na.me.kan
راپرسنامەکە	.ra.pirs.na.me.ke
راپرسنامەکەیان	.ra.pirs.na.me.ke.yan
راپرسنامەیەکیان	.ra.pirs.na.me.yek.yan
راپۆرتی	.ra.por.tî
راڤە	.ra.ve
راکێشاوە	.ra.kê.şa.we
راگرتنی	.ra.gir.ti.nî
راگواست	.ra.gwast
راگیرکران	.ra.gîr.ki.ran
راگەیاند	.ra.ge.yand
راگەیاندبوو	.ra.ge.yan.di.bû
راگەیاندن	.ra.ge.yan.din
راگەیاندنی	.ra.ge.yan.di.nî
راگەیاندنەکانی	.ra.ge.yan.di.ne.ka.nî
راگەیاندووە	.ra.ge.yan.du.we
راگەیەندرا	.ra.ge.yen.di.ra
راگەیەندراو	.ra.ge.yen.di.raw
راگەیەندراوی	.ra.ge.yen.di.ra.wî
راگەیەندراوە	.ra.ge.yen.di.ra.we
راگەیەندراوەکانی	.ra.ge.yen.di.ra.we.ka.nî
رای	.ray
رایانگواستبوون	.ra.yan.gwas.ti.bûn
رایانگەیاند	.ra.yan.ge.yand
رایبگەیەنن	.ray.bi.ge.ye.nin
رایەڵە	.ra.ye.łe
رحا	.ri.ḧa
رخنەگیر	.rix.ne.gîr
رخنەگیرانە	.rix.ne.gî.ra.ne
رخنەگیری	.rix.ne.gî.rî
رخنەگیریی	.rix.ne.gî.rîy
رزگاری	.riz.ga.rî
رزگاریی	.riz.ga.rîy
رسایتڵەکان	.ri.say.ti.łe.kan
رستانە	.ris.ta.ne
رستەکانی	.ris.te.ka.nî
روانگە	.rwan.ge
روانگەوە	.rwan.ge.we
روانگەگەلێکی	.rwan.ge.ge.lê.kî
روانگەی	.rwan.gey
روانینی	.rwa.nî.nî
روانینیان	.rwa.nîn.yan
رواڵەت	.rwa.łet
روو	.rû
رووداوە	.rû.da.we
رووداوەکانی	.rû.da.we.ka.nî
رووداوەیە	.rû.da.we.ye
رووداوەیەکی	.rû.da.we.ye.kî
روون	.rûn
رووناکبیر	.rû.nak.bîr
رووناکبیرێک	.rû.nak.bî.rêk
روونتر	.rûn.tir
روونی	.rû.nî
روونە	.rû.ne
رووپەڕ	.rû.peř
رووپەڕانیش	.rû.pe.řa.nîş
رووپەڕی	.rû.pe.řî
رووپەڕێک	.rû.pe.řêk
رووپەڕەکانی	.rû.pe.ře.ka.nî
رووی	.rûy
روویان	.rû.yan
رچەی	.ri.çey
رژێم	.ri.jêm
رژێمی	.ri.jê.mî
رژێمەکانی	.ri.jê.me.ka.nî
رۆشان	.ro.şan
رۆمان	.ro.man
رۆمانە	.ro.ma.ne
رۆمانەکان	.ro.ma.ne.kan
رۆناهی	.ro.na.hî
رۆژ	.roj
رۆژا	.ro.ja
رۆژان	.ro.jan
رۆژانی	.ro.ja.nî
رۆژانێکی	.ro.ja.nê.kî
رۆژانە	.ro.ja.ne
رۆژانەی	.ro.ja.ney
رۆژاوا	.ro.ja.wa
رۆژاواش	.ro.ja.waş
رۆژاوای	.ro.ja.way
رۆژاوایی	.ro.ja.wa.yî
رۆژاوایییان	.ro.ja.wa.yî.yan
رۆژنامە	.roj.na.me
رۆژنامەوان	.roj.na.me.wan
رۆژنامەوانانی	.roj.na.me.wa.na.nî
رۆژنامەوانانە	.roj.na.me.wa.na.ne
رۆژنامەوانی	.roj.na.me.wa.nî
رۆژنامەوانیی	.roj.na.me.wa.nîy
رۆژنامەکان	.roj.na.me.kan
رۆژنامەکە	.roj.na.me.ke
رۆژنامەگەل	.roj.na.me.gel
رۆژنامەگەلە	.roj.na.me.ge.le
رۆژنامەی	.roj.na.mey
رۆژنامەیە	.roj.na.me.ye
رۆژنامەیەک	.roj.na.me.yek
رۆژنامەیەکی	.roj.na.me.ye.kî
رۆژهەڵات	.roj.he.łat
رۆژهەڵاتی	.roj.he.ła.tî
رۆژی	.ro.jî
رۆژیدا	.ro.jî.da
رۆژێ	.ro.jê
رۆژێک	.ro.jêk
رۆژە	.ro.je
رۆژەکانی	.ro.je.ka.nî
رۆڵی	.ro.łî
رۆڵێکی	.ro.łê.kî
رۆیاندەکردن	.ro.yan.de.kir.din
رۆیشتە	.royş.te
ریزی	.rî.zî
رێبوارە	.rêb.wa.re
رێبوارەکان	.rêb.wa.re.kan
رێبەرەوە	.rê.be.re.we
رێخراوەکاندا	.rêx.ra.we.kan.da
رێخۆشکەری	.rê.xoş.ke.rî
رێدراوە	.rê.di.ra.we
رێزلێنانی	.rêz.lê.na.nî
رێزمان	.rêz.man
رێزمانی	.rêz.ma.nî
رێزیان	.rêz.yan
رێنووس	.rê.nûs
رێنووسانی	.rê.nû.sa.nî
رێنووسگۆڕاوەکان	.rê.nûs.go.řa.we.kan
رێنووسگۆڕاوەکاندا	.rê.nûs.go.řa.we.kan.da
رێنووسی	.rê.nû.sî
رێنووسە	.rê.nû.se
رێنووسەوە	.rê.nû.se.we
رێپێدان	.rê.pê.dan
رێپێدانی	.rê.pê.da.nî
رێپێدراو	.rê.pê.di.raw
رێپێدراوبوون	.rê.pê.di.raw.bûn
رێپێدراون	.rê.pê.di.ra.win
رێپێنەدان	.rê.pê.ne.dan
رێپێنەدانی	.rê.pê.ne.da.nî
رێپێنەدراو	.rê.pê.ne.di.raw
رێپێنەدراوانە	.rê.pê.ne.di.ra.wa.ne
رێپێنەدراوی	.rê.pê.ne.di.ra.wî
رێپێنەدراویی	.rê.pê.ne.di.ra.wîy
رێپێنەدراوییی	.rê.pê.ne.di.ra.wî.yî
رێپێنەدراوییەکان	.rê.pê.ne.di.ra.wî.ye.kan
رێپێنەدراوییەکاندا	.rê.pê.ne.di.ra.wî.ye.kan.da
رێپێنەدراوە	.rê.pê.ne.di.ra.we
رێپێنەدراوەکان	.rê.pê.ne.di.ra.we.kan
رێژانە	.rê.ja.ne
رێژەی	.rê.jey
رێژەیە	.rê.je.ye
رێک	.rêk
رێکبخا	.rêk.bi.xa
رێکبخردرێ	.rêk.bi.xir.di.rê
رێکبخرێ	.rêk.bix.rê
رێکبخرێن	.rêk.bix.rên
رێکبخەن	.rêk.bi.xen
رێکخرا	.rêk.xi.ra
رێکخرابوو	.rêk.xi.ra.bû
رێکخران	.rêk.xi.ran
رێکخرانەوە	.rêk.xi.ra.ne.we
رێکخراوانە	.rêk.xi.ra.wa.ne
رێکخراوانەیان	.rêk.xi.ra.wa.ne.yan
رێکخراون	.rêk.xi.ra.win
رێکخراونەتەوە	.rêk.xi.raw.ne.te.we
رێکخراوە	.rêk.xi.ra.we
رێکخراوەکان	.rêk.xi.ra.we.kan
رێکخراوەکانی	.rêk.xi.ra.we.ka.nî
رێکخراوەکە	.rêk.xi.ra.we.ke
رێکخراوەکەیان	.rêk.xi.ra.we.ke.yan
رێکخراوەگەلی	.rêk.xi.ra.we.ge.lî
رێکخراوەی	.rêk.xi.ra.wey
رێکخراوەیەک	.rêk.xi.ra.we.yek
رێکخراوەیەکی	.rêk.xi.ra.we.ye.kî
رێکخراوەیەکیان	.rêk.xi.ra.we.yek.yan
رێکخست	.rêk.xist
رێکخستنی	.rêk.xis.ti.nî
رێکخستووە	.rêk.xis.tu.we
رێکخەری	.rêk.xe.rî
رێکخەرە	.rêk.xe.re
رێکخەرەکانی	.rêk.xe.re.ka.nî
رێکدەخرا	.rêk.dex.ra
رێکدەخران	.rêk.dex.ran
رێکدەخرێن	.rêk.dex.rên
رێکدەخەن	.rêk.de.xen
رێکلام	.rêk.lam
رێکوپێکییەکی	.rê.ku.pê.kî.ye.kî
رێکیدەخست	.rê.kî.de.xist
رێگا	.rê.ga
رێگای	.rê.gay
رێی	.rêy
رێیان	.rê.yan
رێیانپێنادرێ	.rê.yan.pê.na.di.rê
رێیپێدەدرێ	.rêy.pê.de.di.rê
رێیپێنادرێ	.rêy.pê.na.di.rê
رەخساند	.rex.sand
رەخنە	.rex.ne
رەزۆیێ	.re.zo.yê
رەش	.reş
رەشیدێ	.re.şî.dê
رەفەکانەوە	.re.fe.ka.ne.we
رەنگ	.reng
رەنگی	.ren.gî
رەنگییەکانیش	.ren.gî.ye.ka.nîş
رەنگە	.ren.ge
رەنێوهاتبوون	.re.nêw.hat.bûn
رەوا	.re.wa
رەواندزی	.re.wan.di.zî
رەوانی	.re.wa.nî
رەوت	.rewt
رەوتی	.rew.tî
رەوتێکی	.rew.tê.kî
رەوشەن	.rew.şen
رەپێیان	.re.pê.yan
رەچاو	.re.çaw
رەچاونەگرتنی	.re.çaw.ne.gir.ti.nî
رەچاوگرتنی	.re.çaw.gir.ti.nî
رەچەڵاکەکانی	.re.çe.ła.ke.ka.nî
رەگەز	.re.gez
رەگەزی	.re.ge.zî
رەگەڵ	.re.geł
زاخۆ	.za.xo
زادە	.za.de
زاراوەکان	.za.ra.we.kan
زاراوەکانی	.za.ra.we.ka.nî
زاراوەی	.za.ra.wey
زارۆکانن	.za.ro.ka.nin
زاری	.za.rî
زارەکی	.za.re.kî
زارەکییانە	.za.re.kî.ya.ne
زازا	.za.za
زازایی	.za.za.yî
زازاییش	.za.za.yîş
زانا	.za.na
زانایان	.za.na.yan
زانایانی	.za.na.ya.nî
زاندرابوو	.zan.di.ra.bû
زانست	.za.nist
زانستگای	.za.nist.gay
زانستگایییان	.za.nist.ga.yî.yan
زانستگایەکی	.za.nist.ga.ye.kî
زانستی	.za.nis.tî
زانستیی	.za.nis.tîy
زانستییەکاندا	.za.nis.tî.ye.kan.da
زانستە	.za.nis.te
زانکۆ	.zan.ko
زانکۆکانی	.zan.ko.ka.nî
زانکۆی	.zan.koy
زانی	.za.nî
زانیاری	.zan.ya.rî
زانیاریگەلێک	.zan.ya.rî.ge.lêk
زانیاریی	.zan.ya.rîy
زانیارییان	.zan.ya.rî.yan
زانیارییەوە	.zan.ya.rî.ye.we
زانیارییەک	.zan.ya.rî.yek
زانیارییەکان	.zan.ya.rî.ye.kan
زانیارییەکانی	.zan.ya.rî.ye.ka.nî
زانیارە	.zan.ya.re
زانیان	.zan.yan
زانیم	.za.nîm
زانین	.za.nîn
زانینی	.za.nî.nî
زانیومە	.za.nîw.me
زانیوە	.za.nî.we
زاگرۆس	.zag.ros
زاڵ	.zał
زاییندراوی	.za.yîn.di.ra.wî
زایینی	.za.yî.nî
زایەندێتی	.za.yen.dê.tî
زمان	.zi.man
زمانانە	.zi.ma.na.ne
زمانانەش	.zi.ma.na.neş
زماندا	.zi.man.da
زمانکوژی	.zi.man.ku.jî
زمانکوژییە	.zi.man.ku.jî.ye
زمانکوژییەک	.zi.man.ku.jî.yek
زمانی	.zi.ma.nî
زمانێک	.zi.ma.nêk
زمانێکی	.zi.ma.nê.kî
زمانە	.zi.ma.ne
زمانەکان	.zi.ma.ne.kan
زمانەکانی	.zi.ma.ne.ka.nî
زمانەکانەوە	.zi.ma.ne.ka.ne.we
زمانەکە	.zi.ma.ne.ke
زمانەکەیان	.zi.ma.ne.ke.yan
زنجیرە	.zin.cî.re
زوان	.zwan
زوانەکاندا	.zwa.ne.kan.da
زوانەکەمان	.zwa.ne.ke.man
زوو	.zû
زووانە	.zu.wa.ne
زووبەزوو	.zû.be.zû
زووتر	.zû.tir
زوڵم	.zu.łim
زڕوزا	.zi.řu.za
زگماکی	.zig.ma.kî
زگماکیی	.zig.ma.kîy
زگماکییان	.zig.ma.kî.yan
زگیان	.zig.yan
زگەکانیان	.zi.ge.kan.yan
زۆر	.zor
زۆربوونی	.zor.bû.nî
زۆربوونەوە	.zor.bû.ne.we
زۆربوونەوەیە	.zor.bû.ne.we.ye
زۆربووەوە	.zor.bu.we.we
زۆربەشیان	.zor.beş.yan
زۆربەی	.zor.bey
زۆربەیان	.zor.be.yan
زۆرتر	.zor.tir
زۆرتربوونەوەشی	.zor.tir.bû.ne.we.şî
زۆرتری	.zor.ti.rî
زۆرتریان	.zor.tir.yan
زۆرتریش	.zor.ti.rîş
زۆرترین	.zor.ti.rîn
زۆرترە	.zor.ti.re
زۆرترەوە	.zor.ti.re.we
زۆرجار	.zor.car
زۆرجاران	.zor.ca.ran
زۆردارانەیە	.zor.da.ra.ne.ye
زۆرم	.zo.rim
زۆرمان	.zor.man
زۆرن	.zo.rin
زۆرکات	.zor.kat
زۆرکارانەی	.zor.ka.ra.ney
زۆرکاری	.zor.ka.rî
زۆرکاریدا	.zor.ka.rî.da
زۆرکارییی	.zor.ka.rî.yî
زۆرکارییە	.zor.ka.rî.ye
زۆرکارییەوە	.zor.ka.rî.ye.we
زۆرکارییەکانی	.zor.ka.rî.ye.ka.nî
زۆرکارییەکی	.zor.ka.rî.ye.kî
زۆرکردنەوەی	.zor.kir.di.ne.wey
زۆری	.zo.rî
زۆریان	.zor.yan
زۆریش	.zo.rîş
زۆریشی	.zo.rî.şî
زۆرینە	.zo.rî.ne
زۆرینەی	.zo.rî.ney
زۆرێک	.zo.rêk
زۆرە	.zo.re
زۆرەوە	.zo.re.we
زیاتر	.zya.tir
زیاتری	.zya.ti.rî
زیاترە	.zya.ti.re
زیاد	.zyad
زیادبوونی	.zyad.bû.nî
زیادکردنی	.zyad.kir.di.nî
زیادی	.zya.dî
زیادەباج	.zya.de.bac
زیان	.zyan
زیانم	.zya.nim
زیانی	.zya.nî
زیانێکی	.zya.nê.kî
زیرەک	.zî.rek
زین	.zîn
زیندان	.zîn.dan
زیندانی	.zîn.da.nî
زیندانیانی	.zîn.dan.ya.nî
زیندانیی	.zîn.da.nîy
زیندانەکانی	.zîn.da.ne.ka.nî
زیندوو	.zîn.dû
زینە	.zî.ne
زێباری	.zê.ba.rî
زێڕ	.zêř
زێڕین	.zê.řîn
زێڕینی	.zê.řî.nî
زەبەند	.ze.bend
زەبەندتریان	.ze.bend.tir.yan
زەحمەت	.zeḧ.met
زەحمەتکێشانی	.zeḧ.met.kê.şa.nî
زەحمەتە	.zeḧ.me.te
زەراق	.ze.raq
زەرد	.zerd
زەمان	.ze.man
زەمینەی	.ze.mî.ney
زەنگی	.zen.gî
زەنگیەوە	.zeng.ye.we
زەوی	.ze.wî
زەڤی	.ze.vî
زەکی	.ze.kî
زەینی	.zey.nî
زەیۆنیستەکان	.ze.yo.nîs.te.kan
س	.si
سا	.sa
سابیر	.sa.bîr
ساتێک	.sa.têk
سادق	.sa.diq
سادە	.sa.de
سارد	.sard
سارێژکەریی	.sa.rêj.ke.rîy
ساز	.saz
سازدانی	.saz.da.nî
سازدەکرێ	.saz.de.ki.rê
سازدەکەن	.saz.de.ken
سازمانی	.saz.ma.nî
سازکرد	.saz.kird
سازکردنی	.saz.kir.di.nî
سازی	.sa.zî
ساغ	.saẍ
سال	.sal
سالار	.sa.lar
سالی	.sa.lî
سامان	.sa.man
سامانی	.sa.ma.nî
سامانە	.sa.ma.ne
سامی	.sa.mî
سان	.san
سانسۆرکردنی	.san.sor.kir.di.nî
ساکار	.sa.kar
ساکارتر	.sa.kar.tir
ساکاری	.sa.ka.rî
ساگنچ	.sa.ginç
ساڵ	.sał
ساڵان	.sa.łan
ساڵاندا	.sa.łan.da
ساڵانی	.sa.ła.nî
ساڵانیان	.sa.łan.yan
ساڵانێک	.sa.ła.nêk
ساڵانێکی	.sa.ła.nê.kî
ساڵانە	.sa.ła.ne
ساڵانەدا	.sa.ła.ne.da
ساڵانەوە	.sa.ła.ne.we
ساڵانەی	.sa.ła.ney
ساڵح	.sa.łiḧ
ساڵدا	.sał.da
ساڵن	.sa.łin
ساڵی	.sa.łî
ساڵیادی	.sał.ya.dî
ساڵیادەکان	.sał.ya.de.kan
ساڵیدا	.sa.łî.da
ساڵێک	.sa.łêk
ساڵێکە	.sa.łê.ke
ساڵە	.sa.łe
ساڵەدا	.sa.łe.da
ساڵەکان	.sa.łe.kan
ساڵەکانی	.sa.łe.ka.nî
ساڵەی	.sa.łey
سایتی	.say.tî
سایەی	.sa.yey
سبەی	.si.bey
سبەینێ	.si.bey.nê
ستاندنیان	.si.tan.din.yan
ستایشی	.si.ta.yi.şî
ستراتیژی	.sit.ra.tî.jî
ستوکهۆڵم	.si.tuk.hołm
ستوکهۆڵمەوە	.si.tuk.hoł.me.we
ستۆکهۆڵم	.si.tok.hołm
ستۆکهۆڵمەوە	.si.tok.hoł.me.we
ستێر	.si.têr
ستێرمان	.si.têr.man
ستەم	.si.tem
ستەمبۆل	.si.tem.bol
ستەمبۆڵ	.si.tem.boł
ستەمبۆڵدا	.si.tem.boł.da
ستەمبۆڵدایە	.si.tem.boł.da.ye
ستەمبۆڵێ	.si.tem.bo.łê
ستەمبۆڵەوە	.si.tem.bo.łe.we
سدیق	.si.dîq
سروشت	.si.ruşt
سروشتی	.si.ruş.tî
سروودی	.si.rû.dî
سروە	.sir.we
سرۆشتییەکان	.si.roş.tî.ye.kan
سزا	.si.za
سزادانی	.si.za.da.nî
سزادران	.si.za.di.ran
سزادرانی	.si.za.di.ra.nî
سزای	.si.zay
سعوودیە	.si.ƹûd.ye
سلێمان	.si.lê.man
سلێمانی	.si.lê.ma.nî
سمایل	.si.mayl
سن	.sin
سنوری	.si.nu.rî
سنوور	.si.nûr
سنوورانە	.si.nû.ra.ne
سنووردار	.si.nûr.dar
سنووردارەوە	.si.nûr.da.re.we
سنووری	.si.nû.rî
سنوورێکدا	.si.nû.rêk.da
سنوورە	.si.nû.re
سنوورەکاندا	.si.nû.re.kan.da
سنوورەکانی	.si.nû.re.ka.nî
سنوورەکە	.si.nû.re.ke
سنە	.si.ne
سواری	.swa.rî
سود	.sud
سودان	.su.dan
سودی	.su.dî
سوری	.su.rî
سوریا	.sur.ya
سوریادا	.sur.ya.da
سوریە	.sur.ye
سوننە	.sun.ne
سووبسید	.sûb.sîd
سووتا	.sû.ta
سوود	.sûd
سوودی	.sû.dî
سوودیی	.sû.dîy
سوودێکی	.sû.dê.kî
سوور	.sûr
سووری	.sû.rî
سووریا	.sûr.ya
سووریادا	.sûr.ya.da
سووریای	.sûr.yay
سووریایەدە	.sûr.ya.ye.de
سوورییانە	.sû.rî.ya.ne
سوورییەکان	.sû.rî.ye.kan
سوورە	.sû.re
سوورەکەی	.sû.re.key
سووچێکی	.sû.çê.kî
سووڕ	.sûř
سووژن	.sû.jin
سووک	.sûk
سووکایەتی	.sû.ka.ye.tî
سووکایەتیی	.sû.ka.ye.tîy
سوپا	.su.pa
سوپاس	.su.pas
سوپاسی	.su.pa.sî
سوپای	.su.pay
سوکایەتی	.su.ka.ye.tî
سوڵتان	.suł.tan
سوڵتانی	.suł.ta.nî
سوید	.swîd
سویددا	.swîd.da
سویدی	.swî.dî
سویدیش	.swî.dîş
سویسدا	.swîs.da
سویسرا	.swîs.ra
سوێندیان	.swênd.yan
سپاردن	.si.par.din
سپای	.si.pay
سپۆرت	.si.port
سپی	.si.pî
سڕانەوەی	.si.řa.ne.wey
سڕینەوەی	.si.řî.ne.wey
سڤیل	.si.vîl
سکاڵای	.si.ka.łay
سکرتێری	.si.kir.tê.rî
سکەنێرێکیان	.si.ke.nê.rêk.yan
سڵاو	.si.ław
سڵاویان	.si.ław.yan
سۆتە	.so.te
سۆران	.so.ran
سۆرانیش	.so.ra.nîş
سۆرانییە	.so.ra.nî.ye
سۆز	.soz
سۆزی	.so.zî
سۆسیال	.sos.yal
سۆسیالیست	.sos.ya.lîst
سۆسیالیستی	.sos.ya.lîs.tî
سۆلژەنیتسین	.sol.je.nît.sîn
سۆنگەی	.son.gey
سۆڤیەت	.sov.yet
سی	.sî
سیابەند	.sya.bend
سیاسی	.sya.sî
سیاسیدا	.sya.sî.da
سیاسیی	.sya.sîy
سیاسییە	.sya.sî.ye
سیاسییەوە	.sya.sî.ye.we
سیاسییەکان	.sya.sî.ye.kan
سیاسییەکاندا	.sya.sî.ye.kan.da
سیاسییەکانی	.sya.sî.ye.ka.nî
سیاسییەکانیان	.sya.sî.ye.kan.yan
سیاسییەکانیش	.sya.sî.ye.ka.nîş
سیاسییەکانیشدا	.sya.sî.ye.ka.nîş.da
سیاسییەکانەوە	.sya.sî.ye.ka.ne.we
سیاسەت	.sya.set
سیاسەتدا	.sya.set.da
سیاسەتی	.sya.se.tî
سیاسەتێکی	.sya.se.tê.kî
سیاسەتە	.sya.se.te
سیاسەتەکانی	.sya.se.te.ka.nî
سیتی	.sî.tî
سیخوڕی	.sî.xu.řî
سیدیی	.sî.dîy
سیدییەکان	.sî.dî.ye.kan
سیروان	.sîr.wan
سیریلیک	.sî.rî.lîk
سیریلیکەوە	.sî.rî.lî.ke.we
سیستمی	.sîs.ti.mî
سیستمێکی	.sîs.ti.mê.kî
سیستمە	.sîs.ti.me
سیستەمی	.sîs.te.mî
سیستەمێکی	.sîs.te.mê.kî
سیستەمە	.sîs.te.me
سیمای	.sî.may
سیمینار	.sî.mî.nar
سیناریۆی	.sî.nar.yoy
سینەما	.sî.ne.ma
سینەماکاری	.sî.ne.ma.ka.rî
سینەمای	.sî.ne.may
سینەمایی	.sî.ne.ma.yî
سێ	.sê
سێبەری	.sê.be.rî
سێدارە	.sê.da.re
سێرت	.sêrt
سێشەممە	.sê.şem.me
سێهەم	.sê.hem
سێهەمییەکە	.sê.he.mî.ye.ke
سێڤر	.sê.vir
سێکس	.sêks
سێکسی	.sêk.sî
سێی	.sêy
سێیەم	.sê.yem
سێیەمی	.sê.ye.mî
سێیەمین	.sê.ye.mîn
سە	.se
سەباح	.se.baḧ
سەبارەت	.se.ba.ret
سەبری	.seb.rî
سەتان	.se.tan
سەتی	.se.tî
سەتیی	.se.tîy
سەتە	.se.te
سەخت	.sext
سەختی	.sex.tî
سەد	.sed
سەدا	.se.da
سەدام	.se.dam
سەدان	.se.dan
سەددام	.sed.dam
سەدر	.se.dir
سەدی	.se.dî
سەدە	.se.de
سەدەکانی	.se.de.ka.nî
سەدەی	.se.dey
سەر	.ser
سەرانسەری	.se.ran.se.rî
سەرانی	.se.ra.nî
سەرباری	.ser.ba.rî
سەرباز	.ser.baz
سەربازانی	.ser.ba.za.nî
سەربازی	.ser.ba.zî
سەربازیی	.ser.ba.zîy
سەربازییەکانی	.ser.ba.zî.ye.ka.nî
سەربازە	.ser.ba.ze
سەربازەکانی	.ser.ba.ze.ka.nî
سەربە	.ser.be
سەربەخۆ	.ser.be.xo
سەربەخۆکان	.ser.be.xo.kan
سەربەخۆی	.ser.be.xoy
سەربەخۆیی	.ser.be.xo.yî
سەربەخۆییی	.ser.be.xo.yîy
سەربەخۆیییان	.ser.be.xo.yî.yan
سەربەخۆیییەکی	.ser.be.xo.yî.ye.kî
سەربەرزیی	.ser.ber.zîy
سەرتاسەری	.ser.ta.se.rî
سەرجەم	.ser.cem
سەرجەمدا	.ser.cem.da
سەرجەمی	.ser.ce.mî
سەرخستنی	.ser.xis.ti.nî
سەردار	.ser.dar
سەردان	.ser.dan
سەردانی	.ser.da.nî
سەردانیان	.ser.dan.yan
سەردانەکەی	.ser.da.ne.key
سەرداگیرا	.ser.da.gî.ra
سەردێڕی	.ser.dê.řî
سەردەشت	.ser.deşt
سەردەم	.ser.dem
سەردەمداریی	.ser.dem.da.rîy
سەردەمی	.ser.de.mî
سەردەمە	.ser.de.me
سەردەمەدا	.ser.de.me.da
سەرسنوور	.ser.si.nûr
سەرسووڕهێنەر	.ser.sûř.hê.ner
سەرسووڕی	.ser.sû.řî
سەرسووڕییانە	.ser.sû.řî.ya.ne
سەرشانی	.ser.şa.nî
سەرقاڵی	.ser.qa.łî
سەرلەبەیانی	.ser.le.be.ya.nî
سەرلەنوێ	.ser.le.nwê
سەرم	.se.rim
سەرمایە	.ser.ma.ye
سەرمایەداری	.ser.ma.ye.da.rî
سەرمایەی	.ser.ma.yey
سەرنج	.se.rinc
سەرنجڕاکێش	.se.rinc.řa.kêş
سەرنجی	.se.rin.cî
سەرنجێکی	.se.rin.cê.kî
سەرهێڵ	.ser.hêł
سەرهەڵدانی	.ser.heł.da.nî
سەرو	.se.ru
سەرووی	.se.rûy
سەروەت	.ser.wet
سەروەری	.ser.we.rî
سەرپەرشتی	.ser.pe.riş.tî
سەرپەرشتیاری	.ser.pe.rişt.ya.rî
سەرچاوکە	.ser.çaw.ke
سەرچاوکەی	.ser.çaw.key
سەرچاوە	.ser.ça.we
سەرچاوەن	.ser.ça.wen
سەرچاوەکان	.ser.ça.we.kan
سەرچاوەکانی	.ser.ça.we.ka.nî
سەرچاوەکە	.ser.ça.we.ke
سەرچاوەی	.ser.ça.wey
سەرچاوەیە	.ser.ça.we.ye
سەرچاوەیەک	.ser.ça.we.yek
سەرچاوەیەکی	.ser.ça.we.ye.kî
سەرڕا	.ser.řa
سەرژمێری	.ser.ji.mê.rî
سەرژمێریی	.ser.ji.mê.rîy
سەرژمێرییە	.ser.ji.mê.rî.ye
سەرژمێرییەدا	.ser.ji.mê.rî.ye.da
سەرژمێرییەکاندا	.ser.ji.mê.rî.ye.kan.da
سەرژمێرییەکی	.ser.ji.mê.rî.ye.kî
سەرژمێرییەکە	.ser.ji.mê.rî.ye.ke
سەرژمێرییەکەدا	.ser.ji.mê.rî.ye.ke.da
سەرژمێرییەکەی	.ser.ji.mê.rî.ye.key
سەرکتێبە	.ser.ki.tê.be
سەرکردایەتی	.ser.kir.da.ye.tî
سەرکردایەتیی	.ser.kir.da.ye.tîy
سەرکردە	.ser.kir.de
سەرکردەکانی	.ser.kir.de.ka.nî
سەرکردەی	.ser.kir.dey
سەرکوت	.ser.kut
سەرکوتی	.ser.ku.tî
سەرکۆماری	.ser.ko.ma.rî
سەرکەوت	.ser.kewt
سەرکەوتن	.ser.kew.tin
سەرکەوتنی	.ser.kew.ti.nî
سەرکەوتنێکی	.ser.kew.ti.nê.kî
سەرکەوتوو	.ser.kew.tû
سەرکەوتووەکانی	.ser.kew.tu.we.ka.nî
سەرگری	.ser.gi.rî
سەرگیرا	.ser.gî.ra
سەرۆک	.se.rok
سەرۆکایەتی	.se.ro.ka.ye.tî
سەرۆکایەتیی	.se.ro.ka.ye.tîy
سەرۆکوەزیرانی	.se.rok.we.zî.ra.nî
سەرۆکی	.se.ro.kî
سەری	.se.rî
سەریان	.ser.yan
سەریاندا	.ser.yan.da
سەرینی	.se.rî.nî
سەرێ	.se.rê
سەرێکانیم	.se.rê.ka.nîm
سەرە	.se.re
سەرەتا	.se.re.ta
سەرەتادا	.se.re.ta.da
سەرەتاوە	.se.re.ta.we
سەرەتاکانی	.se.re.ta.ka.nî
سەرەتای	.se.re.tay
سەرەتایی	.se.re.ta.yî
سەرەخۆ	.se.re.xo
سەرەخۆشی	.se.re.xo.şî
سەرەرای	.se.re.ray
سەرەنجام	.se.ren.cam
سەرەنجی	.se.ren.cî
سەرەنجێکی	.se.ren.cê.kî
سەرەوە	.se.re.we
سەرەوەی	.se.re.wey
سەرەڕای	.se.re.řay
سەرەکی	.se.re.kî
سەرەکیترین	.se.re.kî.ti.rîn
سەرەکیترینیان	.se.re.kî.ti.rîn.yan
سەرەکیمان	.se.re.kî.man
سەرەکیی	.se.re.kîy
سەرەکییەتی	.se.re.kî.ye.tî
سەرەکییەکان	.se.re.kî.ye.kan
سەرەکییەکانی	.se.re.kî.ye.ka.nî
سەرەکییەکەشی	.se.re.kî.ye.ke.şî
سەعات	.se.ƹat
سەعدی	.seƹ.dî
سەعید	.se.ƹîd
سەفەر	.se.fer
سەفەری	.se.fe.rî
سەقامگیری	.se.qam.gî.rî
سەقز	.se.qiz
سەلاح	.se.laḧ
سەلاحەددین	.se.la.ḧed.dîn
سەلام	.se.lam
سەلامەتی	.se.la.me.tî
سەلماندبایان	.sel.man.di.ba.yan
سەلماندنی	.sel.man.di.nî
سەلیم	.se.lîm
سەنتەری	.sen.te.rî
سەندیکای	.sen.dî.kay
سەنگ	.seng
سەوز	.sewz
سەپاندنی	.se.pan.di.nî
سەڤنچ	.se.vinç
سەڵەف	.se.łef
سەید	.seyd
سەیدایێ	.sey.da.yê
سەیر	.seyr
سەیری	.sey.rî
سەیرە	.sey.re
ش	.şi
شا	.şa
شاخ	.şax
شاد	.şad
شادی	.şa.dî
شار	.şar
شاران	.şa.ran
شارانی	.şa.ra.nî
شارانە	.şa.ra.ne
شارانەدا	.şa.ra.ne.da
شاراوە	.şa.ra.we
شاردان	.şar.dan
شارستانی	.şa.ris.ta.nî
شارۆچکەکان	.şa.roç.ke.kan
شارۆچکەکاندا	.şa.roç.ke.kan.da
شارۆچکەی	.şa.roç.key
شاری	.şa.rî
شارێکی	.şa.rê.kî
شارە	.şa.re
شارەداری	.şa.re.da.rî
شارەداریی	.şa.re.da.rîy
شارەدارییەکان	.şa.re.da.rî.ye.kan
شارەدێی	.şa.re.dêy
شارەزا	.şa.re.za
شارەزان	.şa.re.zan
شارەزاوە	.şa.re.za.we
شارەزای	.şa.re.zay
شارەزایی	.şa.re.za.yî
شارەزایییان	.şa.re.za.yî.yan
شارەزایییەکی	.şa.re.za.yî.ye.kî
شارەوانی	.şa.re.wa.nî
شارەکان	.şa.re.kan
شارەکانی	.şa.re.ka.nî
شارەکانیش	.şa.re.ka.nîş
شارەکە	.şa.re.ke
شاعیر	.şa.ƹîr
شاعیران	.şa.ƹî.ran
شاعیری	.şa.ƹî.rî
شاعیرێک	.şa.ƹî.rêk
شاعیرە	.şa.ƹî.re
شام	.şam
شان	.şan
شانازی	.şa.na.zî
شانازییە	.şa.na.zî.ye
شاندی	.şan.dî
شاندێکی	.şan.dê.kî
شانۆ	.şa.no
شانۆکە	.şa.no.ke
شانۆگەری	.şa.no.ge.rî
شانۆی	.şa.noy
شانۆیی	.şa.no.yî
شانۆیە	.şa.no.ye
شانۆیەک	.şa.no.yek
شانی	.şa.nî
شاهانە	.şa.ha.ne
شای	.şay
شایانی	.şa.ya.nî
شایستەی	.şays.tey
شایەنی	.şa.ye.nî
شت	.şit
شتانە	.şi.ta.ne
شتانەی	.şi.ta.ney
شتی	.şi.tî
شتێک	.şi.têk
شتێکی	.şi.tê.kî
شتێکیان	.şi.têk.yan
شتە	.şi.te
شتەکان	.şi.te.kan
شتەی	.şi.tey
شدا	.şi.da
شریتەکانی	.şi.rî.te.ka.nî
شلوێ	.şil.wê
شنگال	.şin.gal
شوان	.şwan
شوانی	.şwa.nî
شوبات	.şu.bat
شوباتی	.şu.ba.tî
شوناسی	.şu.na.sî
شوێن	.şwên
شوێنانی	.şwê.na.nî
شوێنکەوتنی	.şwên.kew.ti.nî
شوێنی	.şwê.nî
شوێنێک	.şwê.nêk
شوێنێکی	.şwê.nê.kî
شوێنە	.şwê.ne
شوێنەواری	.şwê.ne.wa.rî
شوێنەکان	.şwê.ne.kan
شوێنەکانی	.şwê.ne.ka.nî
شوێنەی	.şwê.ney
شک	.şik
شکا	.şi.ka
شکان	.şi.kan
شکاندنی	.şi.kan.di.nî
شکاو	.şi.kaw
شکست	.şi.kist
شکستی	.şi.kis.tî
شکێکیش	.şi.kê.kîş
شڵوێ	.şił.wê
شۆرش	.şo.riş
شۆرشی	.şo.ri.şî
شۆڕش	.şo.řiş
شۆڕشگێڕی	.şo.řiş.gê.řî
شۆڕشی	.şo.ři.şî
شۆڕشە	.şo.ři.şe
شی	.şî
شیان	.şyan
شیاو	.şyaw
شیاوی	.şya.wî
شیری	.şî.rî
شیرین	.şî.rîn
شیرینی	.şî.rî.nî
شیعری	.şîƹ.rî
شیعە	.şî.ƹe
شیعەکان	.şî.ƹe.kan
شین	.şîn
شیووعی	.şyû.ƹî
شیکردنەوەی	.şî.kir.di.ne.wey
شیکەری	.şî.ke.rî
شێت	.şêt
شێخ	.şêx
شێران	.şê.ran
شێرزاد	.şêr.zad
شێرپەنجە	.şêr.pen.ce
شێرکۆ	.şêr.ko
شێعر	.şê.ƹir
شێعری	.şêƹ.rî
شێعرە	.şêƹ.re
شێعرەکانی	.şêƹ.re.ka.nî
شێواز	.şê.waz
شێوازانی	.şê.wa.za.nî
شێوازی	.şê.wa.zî
شێوازێک	.şê.wa.zêk
شێوازێکی	.şê.wa.zê.kî
شێوازێکە	.şê.wa.zê.ke
شێوازە	.şê.wa.ze
شێوە	.şê.we
شێوەردی	.şê.wer.dî
شێوەزارانی	.şê.we.za.ra.nî
شێوەزاری	.şê.we.za.rî
شێوەکاری	.şê.we.ka.rî
شێوەی	.şê.wey
شێوەیە	.şê.we.ye
شێوەیەک	.şê.we.yek
شێوەیەکی	.şê.we.ye.kî
شێوەیەی	.şê.we.yey
شەخسی	.şex.sî
شەر	.şer
شەرعی	.şer.ƹî
شەرم	.şe.rim
شەرمەزار	.şer.me.zar
شەری	.şe.rî
شەریف	.şe.rîf
شەست	.şest
شەش	.şeş
شەشیان	.şeş.yan
شەشەم	.şe.şem
شەقام	.şe.qam
شەقامی	.şe.qa.mî
شەقامەکان	.şe.qa.me.kan
شەقاوێکی	.şe.qa.wê.kî
شەممە	.şem.me
شەممەی	.şem.mey
شەنگال	.şen.gal
شەهید	.şe.hîd
شەهیدان	.şe.hî.dan
شەهیدانی	.şe.hî.da.nî
شەهیدی	.şe.hî.dî
شەو	.şew
شەوان	.şe.wan
شەوی	.şe.wî
شەوێک	.şe.wêk
شەوە	.şe.we
شەپۆلی	.şe.po.lî
شەڕ	.şeř
شەڕی	.şe.řî
شەڕێکی	.şe.řê.kî
شەڕە	.şe.ře
شەڕەکەدا	.şe.ře.ke.da
شەڵاڵی	.şe.ła.łî
شەیتان	.şey.tan
عادل	.ƹa.dil
عارف	.ƹa.rif
عارفی	.ƹa.ri.fî
عاشقی	.ƹa.şi.qî
عاموودە	.ƹa.mû.de
علیە	.ƹil.ye
عوسمان	.ƹus.man
عوسمانی	.ƹus.ma.nî
عوسمانیدا	.ƹus.ma.nî.da
عوسمانیڕا	.ƹus.ma.nî.řa
عوسمانییەکان	.ƹus.ma.nî.ye.kan
عوسمانییەکاندا	.ƹus.ma.nî.ye.kan.da
عوسمانییەکانیش	.ƹus.ma.nî.ye.ka.nîş
عومەر	.ƹu.mer
عِلمیَة	.ƹîlm.yeة
عیسا	.ƹî.sa
عیماد	.ƹî.mad
عێراق	.ƹê.raq
عێراقدا	.ƹê.raq.da
عێراقی	.ƹê.ra.qî
عێراقیان	.ƹê.raq.yan
عێراقیش	.ƹê.ra.qîş
عێراقییە	.ƹê.ra.qî.ye
عێراقییەکان	.ƹê.ra.qî.ye.kan
عێراقە	.ƹê.ra.qe
عێراقەوە	.ƹê.ra.qe.we
عێڕاق	.ƹê.řaq
عەبادی	.ƹe.ba.dî
عەباس	.ƹe.bas
عەبدولڕەحمان	.ƹeb.dul.řeḧ.man
عەبدولکەریم	.ƹeb.dul.ke.rîm
عەبدولڵا	.ƹeb.dul.ła
عەبدوڕەحمان	.ƹeb.du.řeḧ.man
عەبدوڵا	.ƹeb.du.ła
عەبدوڵڵا	.ƹeb.duł.ła
عەتا	.ƹe.ta
عەدنان	.ƹed.nan
عەرز	.ƹerz
عەرزێ	.ƹer.zê
عەرەب	.ƹe.reb
عەرەبستان	.ƹe.re.bis.tan
عەرەبی	.ƹe.re.bî
عەرەبیدا	.ƹe.re.bî.da
عەرەبیش	.ƹe.re.bîş
عەرەبیی	.ƹe.re.bîy
عەرەبییە	.ƹe.re.bî.ye
عەرەبییەوە	.ƹe.re.bî.ye.we
عەرەبە	.ƹe.re.be
عەرەبەکان	.ƹe.re.be.kan
عەرەبەکاندا	.ƹe.re.be.kan.da
عەرەبەکانی	.ƹe.re.be.ka.nî
عەرەب‌کردنە	.ƹe.reb.kir.di.ne
عەزرەتی	.ƹez.re.tî
عەزیز	.ƹe.zîz
عەزیزی	.ƹe.zî.zî
عەسکەری	.ƹes.ke.rî
عەشق	.ƹeşq
عەشقیان	.ƹeşq.yan
عەفرین	.ƹef.rîn
عەفریندا	.ƹef.rîn.da
عەفرینێ	.ƹef.rî.nê
عەقڵ	.ƹe.qił
عەقڵی	.ƹeq.łî
عەللاوی	.ƹel.la.wî
عەلی	.ƹe.lî
عەلیرزا	.ƹe.lî.ri.za
عەمید	.ƹe.mîd
عەین	.ƹeyn
غازی	.ẍa.zî
غەریب	.ẍe.rîb
فارس	.fars
فارسی	.far.sî
فارسییەوە	.far.sî.ye.we
فاکتۆرەکانی	.fak.to.re.ka.nî
فاکتەری	.fak.te.rî
فاکس	.faks
فایەق	.fa.yeq
فرات	.fi.rat
فراوان	.fi.ra.wan
فراوانتر	.fi.ra.wan.tir
فراوانی	.fi.ra.wa.nî
فراکسیۆنی	[.fi.rak.syo.nî]
فرمێسک	.fir.mêsk
فرۆش	.fi.roş
فرۆشتبوون	.fi.roş.ti.bûn
فرۆشتن	.fi.roş.tin
فرۆشتنی	.fi.roş.ti.nî
فرۆشتنەوە	.fi.roş.ti.ne.we
فرۆشتووین	.fi.roş.tûyn
فرۆشدا	.fi.roş.da
فرۆشرابان	.fi.roş.ra.ban
فرۆشران	.fi.roş.ran
فرۆشراون	.fi.roş.ra.win
فرۆشراوە	.fi.roş.ra.we
فرۆشراوەکان	.fi.roş.ra.we.kan
فرۆشی	.fi.ro.şî
فرۆشیان	.fi.roş.yan
فرۆشیش	.fi.ro.şîş
فرۆشییەکاندا	.fi.ro.şî.ye.kan.da
فرۆشێکی	.fi.ro.şê.kî
فرۆشەکە	.fi.ro.şe.ke
فرۆشەکەی	.fi.ro.şe.key
فرێد	.fi.rêd
فرە	.fi.re
فرەتر	.fi.re.tir
فرەتری	.fi.re.ti.rî
فرەیک	.fi.reyk
فستیڤاڵی	.fis.tî.va.łî
فشار	.fi.şar
فشاری	.fi.şa.rî
فلسێکم	.fil.sê.kim
فلووچانە	.fi.lû.ça.ne
فوئاد	.fu.ʔad
فولکلۆر	.ful.ki.lor
فڕۆکە	.fi.řo.ke
فڕۆکەخانەی	.fi.řo.ke.xa.ney
فڕۆکەوانی	.fi.řo.ke.wa.nî
فڕۆکەی	.fi.řo.key
فڕێ	.fi.řê
فڕێدراو	.fi.řê.di.raw
فکری	.fik.rî
فۆتۆ	.fo.to
فۆتۆکۆپی	.fo.to.ko.pî
فۆتۆکۆپییەوە	.fo.to.ko.pî.ye.we
فۆرم	.form
فۆرمی	.for.mî
فۆلکلۆر	.fol.ki.lor
فۆلکلۆرن	.fol.ki.lo.rin
فۆلکلۆرەکان	.fol.ki.lo.re.kan
فۆلکلۆرەکانەوە	.fol.ki.lo.re.ka.ne.we
فی	.fî
فیدراسیۆنی	.fîd.ras.yo.nî
فیدراڵ	.fîd.rał
فیدراڵی	.fîd.ra.łî
فیستیڤاڵی	.fîs.tî.va.łî
فیستیڤاڵە	.fîs.tî.va.łe
فیلم	.fîlm
فیلمی	.fîl.mî
فیلمێکی	.fîl.mê.kî
فیلمە	.fîl.me
فیلمەکانی	.fîl.me.ka.nî
فیلمەکە	.fîl.me.ke
فیکری	.fîk.rî
فێدراسیۆنی	.fêd.ras.yo.nî
فێر	.fêr
فێرکاری	.fêr.ka.rî
فێرکاریدا	.fêr.ka.rî.da
فێرکاریی	.fêr.ka.rîy
فێرکارییەوە	.fêr.ka.rî.ye.we
فێرکردنی	.fêr.kir.di.nî
فێرگە	.fêr.ge
فێرگەکاندا	.fêr.ge.kan.da
فێری	.fê.rî
فێستیڤاڵ	.fês.tî.vał
فێستیڤاڵانێکی	.fês.tî.va.ła.nê.kî
فێستیڤاڵی	.fês.tî.va.łî
فێستیڤاڵەکانی	.fês.tî.va.łe.ka.nî
فێستیڤاڵەکە	.fês.tî.va.łe.ke
فێڵ	.fêł
فەتاح	.fe.taḧ
فەتح	.fe.tiḧ
فەتەر	.fe.ter
فەتەرێکیش	.fe.te.rê.kîş
فەرامۆش	.fe.ra.moş
فەرانسە	.fe.ran.se
فەرمان	.fer.man
فەرمانبەر	.fer.man.ber
فەرمانبەران	.fer.man.be.ran
فەرمانبەرانی	.fer.man.be.ra.nî
فەرمانبەرە	.fer.man.be.re
فەرمانبەرەکانیانەوە	.fer.man.be.re.kan.ya.ne.we
فەرماندەی	.fer.man.dey
فەرماندەیی	.fer.man.de.yî
فەرمانگەی	.fer.man.gey
فەرمانی	.fer.ma.nî
فەرمووی	.fer.mûy
فەرمی	.fer.mî
فەرمیی	.fer.mîy
فەرمییان	.fer.mî.yan
فەرمییە	.fer.mî.ye
فەرمییەکانی	.fer.mî.ye.ka.nî
فەرهاد	.fer.had
فەرهەنگ	.fer.heng
فەرهەنگکوژییەوە	.fer.heng.ku.jî.ye.we
فەرهەنگی	.fer.hen.gî
فەرهەنگیمان	.fer.hen.gî.man
فەرهەنگیی	.fer.hen.gîy
فەرهەنگییەدا	.fer.hen.gî.ye.da
فەرهەنگییەکان	.fer.hen.gî.ye.kan
فەرهەنگییەکاندا	.fer.hen.gî.ye.kan.da
فەرهەنگییەکانن	.fer.hen.gî.ye.ka.nin
فەرهەنگییەکانی	.fer.hen.gî.ye.ka.nî
فەرهەنگییەکانیان	.fer.hen.gî.ye.kan.yan
فەرهەنگێک	.fer.hen.gêk
فەرهەنگێکی	.fer.hen.gê.kî
فەرهەنگەکان	.fer.hen.ge.kan
فەرهەنگەکانی	.fer.hen.ge.ka.nî
فەرەج	.fe.rec
فەرەجۆڵڵا	.fe.re.coł.ła
فەرەنسا	.fe.ren.sa
فەرەنسی	.fe.ren.sî
فەزای	.fe.zay
فەقی	.fe.qî
فەلسەفی	.fel.se.fî
فەلسەفە	.fel.se.fe
فەلسەفەی	.fel.se.fey
فەلەستین	.fe.les.tîn
فەوجی	.few.cî
فەڕانسە	.fe.řan.se
فەڕەنسا	.fe.řen.sa
فەڕەنسییەکان	.fe.řen.sî.ye.kan
فەڕەنسییەکاندا	.fe.řen.sî.ye.kan.da
فەڕەنسییەکانیش	.fe.řen.sî.ye.ka.nîş
قاتی	.qa.tî
قادر	.qa.dir
قادری	.qa.di.rî
قازانج	.qa.zanc
قازانجی	.qa.zan.cî
قازانجێک	.qa.zan.cêk
قازانجەکە	.qa.zan.ce.ke
قازی	.qa.zî
قاسم	.qa.sim
قاسملوو	.qa.sim.lû
قاعیدە	.qa.ƹî.de
قامشلۆ	.qa.miş.lo
قامشلۆدان	.qa.miş.lo.dan
قامشلۆوە	.qa.miş.lo.we
قامشلۆڕا	.qa.miş.lo.řa
قاهر	.qa.hir
قاهیرە	.qa.hî.re
قاهیرەدا	.qa.hî.re.da
قایشی	.qay.şî
قایمقامی	.qaym.qa.mî
قبووڵ	.qi.bûł
قبوڵ	.qi.buł
قسانە	.qi.sa.ne
قسانەی	.qi.sa.ney
قسە	.qi.se
قسەم	.qi.sem
قسەوباس	.qi.sew.bas
قسەوباسی	.qi.sew.ba.sî
قسەکانی	.qi.se.ka.nî
قسەکانیدا	.qi.se.ka.nî.da
قسەکردن	.qi.se.kir.din
قسەکەر	.qi.se.ker
قسەکەرە	.qi.se.ke.re
قسەی	.qi.sey
قسەیان	.qi.se.yan
قسەیە	.qi.se.ye
قوبادی	.qu.ba.dî
قوتابخانە	.qu.tab.xa.ne
قوتابخانەکان	.qu.tab.xa.ne.kan
قوتابخانەی	.qu.tab.xa.ney
قوتابی	.qu.ta.bî
قوتابیان	.qu.tab.yan
قوتابیانی	.qu.tab.ya.nî
قورئان	.qur.ʔan
قورئانی	.qur.ʔa.nî
قوربان	.qur.ban
قوربانی	.qur.ba.nî
قوربانیانی	.qur.ban.ya.nî
قورس	.qurs
قورسایی	.qur.sa.yî
قورسی	.qur.sî
قورسە	.qur.se
قوونیە	.qûn.ye
قووڵ	.qûł
قووڵی	.qû.łî
قۆشنی	.qoş.nî
قۆناخی	.qo.na.xî
قۆناغ	.qo.naẍ
قۆناغی	.qo.na.ẍî
قۆناغێکی	.qo.na.ẍê.kî
قۆناغە	.qo.na.ẍe
قۆناغەدا	.qo.na.ẍe.da
قۆناغەکانی	.qo.na.ẍe.ka.nî
قۆڵبەست	.qoł.best
قۆڵبەستکرانیان	.qoł.best.ki.ran.yan
قۆڵبەستی	.qoł.bes.tî
قۆڵبەستیان	.qoł.best.yan
قۆڵی	.qo.łî
قیژەی	.qî.jey
قەبارە	.qe.ba.re
قەبارەی	.qe.ba.rey
قەبووڵ	.qe.bûł
قەت	.qet
قەتی	.qe.tî
قەتیان	.qet.yan
قەتەر	.qe.ter
قەدیس	.qe.dîs
قەدەغە	.qe.de.ẍe
قەدەغەکردنی	.qe.de.ẍe.kir.di.nî
قەراغی	.qe.ra.ẍî
قەرزدار	.qerz.dar
قەرس	.qers
قەرەبوو	.qe.re.bû
قەرەوی	.qe.re.wî
قەزای	.qe.zay
قەززافی	.qez.za.fî
قەندیل	.qen.dîl
قەوارە	.qe.wa.re
قەومی	.qew.mî
قەڵای	.qe.łay
قەڵس	.qełs
قەڵەم	.qe.łem
قەیران	.qey.ran
قەیرانی	.qey.ra.nî
قەیرانە	.qey.ra.ne
لا	.la
لابردران	.la.bir.di.ran
لابردنی	.la.bir.di.nî
لاتین	.la.tîn
لاتینن	.la.tî.nin
لاتینیش	.la.tî.nîş
لاتینەوە	.la.tî.ne.we
لازەکان	.la.ze.kan
لاساری	.la.sa.rî
لام	.lam
لانی	.la.nî
لانیکەم	.la.nî.kem
لاو	.law
لاواز	.la.waz
لاوازی	.la.wa.zî
لاوان	.la.wan
لاوانی	.la.wa.nî
لاوی	.la.wî
لاویش	.la.wîş
لاوە	.la.we
لاوەکان	.la.we.kan
لاپەڕە	.la.pe.ře
لاپەڕەی	.la.pe.řey
لاپەڕەیی	.la.pe.ře.yî
لای	.lay
لایان	.la.yan
لایە	.la.ye
لایەن	.la.yen
لایەنانە	.la.ye.na.ne
لایەنگرانی	.la.yen.gi.ra.nî
لایەنگری	.la.yen.gi.rî
لایەنگرییەوە	.la.yen.gi.rî.ye.we
لایەنی	.la.ye.nî
لایەنێک	.la.ye.nêk
لایەنێکی	.la.ye.nê.kî
لایەنە	.la.ye.ne
لایەنەکان	.la.ye.ne.kan
لایەنەکانی	.la.ye.ne.ka.nî
لایەنەی	.la.ye.ney
لایەک	.la.yek
لایەکی	.la.ye.kî
لایەکەوە	.la.ye.ke.we
لجەلی	.li.ce.lî
لقی	.li.qî
لوبنان	.lub.nan
لوبناندا	.lub.nan.da
لوبنانی	.lub.na.nî
لوبنانەوە	.lub.na.ne.we
لوتکەی	.lut.key
لویس	.lwîs
لکێنراوە	.li.kên.ra.we
لکێنەرانە	.li.kê.ne.ra.ne
لکێنەری	.li.kê.ne.rî
لکەکانی	.li.ke.ka.nî
لۆ	.lo
لۆزان	.lo.zan
لۆزاندا	.lo.zan.da
لۆژیکی	.lo.jî.kî
لی	.lî
لیبیا	.lîb.ya
لیرە	.lî.re
لیرەی	.lî.rey
لیرەیی	.lî.re.yî
لیس	.lîs
لیست	.lîst
لیستانەش	.lîs.ta.neş
لیستی	.lîs.tî
لیستێکی	.lîs.tê.kî
لیستە	.lîs.te
لیستەکانی	.lîs.te.ka.nî
لینکەی	.lîn.key
لیوا	.lî.wa
لیوای	.lî.way
لیژنە	.lîj.ne
لیژنەی	.lîj.ney
لیژنەیەکی	.lîj.ne.ye.kî
لیکۆڵینەوەیەک	.lî.ko.łî.ne.we.yek
لیۆنێل	.lyo.nêl
لێ	.lê
لێبوردن	.lê.bur.din
لێبوردنی	.lê.bur.di.nî
لێبکرێ	.lê.bi.ki.rê
لێدان	.lê.dan
لێدانی	.lê.da.nî
لێدوان	.lê.dwan
لێدوانی	.lêd.wa.nî
لێدوانێکدا	.lê.dwa.nêk.da
لێدوانێکی	.lê.dwa.nê.kî
لێدوانێکیدا	.lê.dwa.nê.kî.da
لێدوانەکەیدا	.lêd.wa.ne.key.da
لێدەفرۆشرێ	.lê.def.roş.rê
لێدەکات	.lê.de.kat
لێدەکرا	.lê.de.ki.ra
لێدەکرێت	.lê.de.ki.rêt
لێدەکەن	.lê.de.ken
لێدەکەوێتەوە	.lê.de.ke.wê.te.we
لێرە	.lê.re
لێرەدا	.lê.re.da
لێرەوە	.lê.re.we
لێزانی	.lê.za.nî
لێزانێکی	.lê.za.nê.kî
لێزانەکانەوە	.lê.za.ne.ka.ne.we
لێم	.lêm
لێمان	.lê.man
لێوە	.lê.we
لێوەردەگیردرێ	.lê.wer.de.gîr.di.rê
لێپرسراوانی	.lê.pirs.ra.wa.nî
لێپرسراوی	.lê.pirs.ra.wî
لێپرسینەوە	.lê.pir.sî.ne.we
لێپرسینەوەکەمدا	.lê.pir.sî.ne.we.kem.da
لێپرسینەوەیەک	.lê.pir.sî.ne.we.yek
لێپرسینەکەم	.lê.pir.sî.ne.kem
لێڕوانینەکانم	.lê.řwa.nî.ne.ka.nim
لێژنەی	.lêj.ney
لێژنەیە	.lêj.ne.ye
لێک	.lêk
لێکبوونەوەی	.lêk.bû.ne.wey
لێکبڕابێتن	.lêk.bi.řa.bê.tin
لێکدانەوەکانی	.lêk.da.ne.we.ka.nî
لێکدانەوەی	.lêk.da.ne.wey
لێکرا	.lê.ki.ra
لێکراون	.lê.ki.ra.win
لێکراوە	.lê.ki.ra.we
لێکرد	.lê.kird
لێکۆڵینەوە	.lê.ko.łî.ne.we
لێکۆڵینەوەکان	.lê.ko.łî.ne.we.kan
لێکۆڵینەوەی	.lê.ko.łî.ne.wey
لێکۆڵینەوەیەدا	.lê.ko.łî.ne.we.ye.da
لێکۆڵینەوەیەک	.lê.ko.łî.ne.we.yek
لێکۆڵینەوەیەکم	.lê.ko.łî.ne.we.ye.kim
لێکۆڵینەوەیەکی	.lê.ko.łî.ne.we.ye.kî
لێکۆڵەرەکان	.lê.ko.łe.re.kan
لێکەوتەوە	.lê.kew.te.we
لێی	.lêy
لێیان	.lê.yan
لێیانتێکدەچوو	.lê.yan.têk.de.çû
لێیانپرسی	.lê.yan.pir.sî
لێیە	.lê.ye
لە	.le
لەئاست	.le.ʔast
لەئاستی	.le.ʔas.tî
لەئاکامدا	.le.ʔa.kam.da
لەئەنجامدا	.le.ʔen.cam.da
لەباتی	.le.ba.tî
لەبار	.le.bar
لەباری	.le.ba.rî
لەبارەی	.le.ba.rey
لەبری	.le.bi.rî
لەبەر	.le.ber
لەبەرئەوەی	.le.ber.ʔe.wey
لەبەرامبەر	.le.be.ram.ber
لەبەرامبەردا	.le.be.ram.ber.da
لەبەرانبەر	.le.be.ran.ber
لەبەردەم	.le.ber.dem
لەبەرچاو	.le.ber.çaw
لەبەندیخاناندا	.le.ben.dî.xa.nan.da
لەتم	.le.tim
لەتیف	.le.tîf
لەتەک	.le.tek
لەجیاتی	.le.cya.tî
لەخوارەوە	.le.xwa.re.we
لەخۆ	.le.xo
لەخۆی	.le.xoy
لەدایک	.le.dayk
لەدوای	.le.dway
لەدوو	.le.dû
لەدەرەوەی	.le.de.re.wey
لەدەستدا	.le.dest.da
لەدەستدانی	.le.des.ti.da.nî
لەدەستداوە	.le.dest.da.we
لەدەستی	.le.des.tî
لەرووی	.le.rûy
لەرێگای	.le.rê.gay
لەرێگەی	.le.rê.gey
لەزگین	.lez.gîn
لەساڵی	.le.sa.łî
لەسایەی	.le.sa.yey
لەسێدارەدانی	.le.sê.da.re.da.nî
لەسەر	.le.ser
لەسەرتاسەری	.le.ser.ta.se.rî
لەسەرجەم	.le.ser.cem
لەسەردەمی	.le.ser.de.mî
لەسەری	.le.se.rî
لەسەرە	.le.se.re
لەسەرەتاوە	.le.se.re.ta.we
لەش	.leş
لەشکری	.leş.ki.rî
لەشی	.le.şî
لەلای	.le.lay
لەلایەن	.le.la.yen
لەلایەنی	.le.la.ye.nî
لەلایەک	.le.la.yek
لەلایەکی	.le.la.ye.kî
لەم	.lem
لەمانە	.le.ma.ne
لەماوەی	.le.ma.wey
لەمبارەیەوە	.lem.ba.re.ye.we
لەمپەر	.lem.per
لەمپەرانێکیان	.lem.pe.ra.nêk.yan
لەمپەری	.lem.pe.rî
لەمپەرێکیان	.lem.pe.rêk.yan
لەمپەرەکان	.lem.pe.re.kan
لەمیانی	.lem.ya.nî
لەمە	.le.me
لەمەو	.le.mew
لەمەوبەر	.le.mew.ber
لەمەودوا	.le.mew.dwa
لەمەڕ	.le.meř
لەناو	.le.naw
لەناوبردنی	.le.naw.bir.di.nî
لەناوچەکەدا	.le.naw.çe.ke.da
لەناوچەی	.le.naw.çey
لەندەن	.len.den
لەنێو	.le.nêw
لەنێوان	.le.nê.wan
لەنێوبردنیان	.le.nêw.bir.din.yan
لەنێوبەری	.le.nêw.be.rî
لەهیچ	.le.hîç
لەهەر	.le.her
لەهەرێمی	.le.he.rê.mî
لەهەمان	.le.he.man
لەهەمانکاتدا	.le.he.man.kat.da
لەهەمبەر	.le.hem.ber
لەهەموو	.le.he.mû
لەهەوڵی	.le.hew.łî
لەو	.lew
لەوان	.le.wan
لەوانە	.le.wa.ne
لەوانەش	.le.wa.neş
لەوانەن	.le.wa.nen
لەوانەی	.le.wa.ney
لەوانەیە	.le.wa.ne.ye
لەوبارەیەوە	.lew.ba.re.ye.we
لەوێ	.le.wê
لەوێدا	.le.wê.da
لەوێوە	.le.wê.we
لەوە	.le.we
لەوەتا	.le.we.ta
لەوەدا	.le.we.da
لەوەدایە	.le.we.da.ye
لەوەش	.le.weş
لەوەی	.le.wey
لەوەیدا	.le.wey.da
لەپاش	.le.paş
لەپاڵ	.le.pał
لەپشت	.le.pişt
لەپێش	.le.pêş
لەپێناو	.le.pê.naw
لەپێناوی	.le.pê.na.wî
لەپەیوەندیدا	.le.pey.wen.dî.da
لەچاو	.le.çaw
لەچاپ	.le.çap
لەچاپدان	.le.çap.dan
لەچاپدانی	.le.çap.da.nî
لەچاپدانیان	.le.çap.dan.yan
لەچاپدانە	.le.çap.da.ne
لەچاپدانەکەشیان	.le.çap.da.ne.keş.yan
لەچاپداون	.le.çap.da.win
لەچاپداوە	.le.çap.da.we
لەچاپدرا	.le.çap.di.ra
لەچاپدرابوون	.le.çap.di.ra.bûn
لەچاپدرابێ	.le.çap.di.ra.bê
لەچاپدران	.le.çap.di.ran
لەچاپدرانی	.le.çap.di.ra.nî
لەچاپدراون	.le.çap.di.ra.win
لەچاپدراوی	.le.çap.di.ra.wî
لەچاپدراوە	.le.çap.di.ra.we
لەچاپدراوەکان	.le.çap.di.ra.we.kan
لەچاپدراوەکانی	.le.çap.di.ra.we.ka.nî
لەچاپدەدا	.le.çap.de.da
لەچاپدەدران	.le.çap.ded.ran
لەچاپدەدرێ	.le.çap.ded.rê
لەچاپدەدرێن	.le.çap.ded.rên
لەچاپدەدەن	.le.çap.de.den
لەچاپدەر	.le.çap.der
لەچاپدەران	.le.çap.de.ran
لەچاپدەرانێک	.le.çap.de.ra.nêk
لەچاپدەرانێکی	.le.çap.de.ra.nê.kî
لەچاپدەرانێکیش	.le.çap.de.ra.nê.kîş
لەچاپدەرانە	.le.çap.de.ra.ne
لەچاپدەرانەن	.le.çap.de.ra.nen
لەچاپدەری	.le.çap.de.rî
لەچاپدەریان	.le.çap.der.yan
لەچاپدەرێک	.le.çap.de.rêk
لەچاپدەرێکی	.le.çap.de.rê.kî
لەچاپدەرە	.le.çap.de.re
لەچاپدەرەکان	.le.çap.de.re.kan
لەچاپدەرەکاندا	.le.çap.de.re.kan.da
لەچاپدەرەکانی	.le.çap.de.re.ka.nî
لەچاپدەرەکانەوە	.le.çap.de.re.ka.ne.we
لەچاپدەرەکە	.le.çap.de.re.ke
لەچاپدەن	.le.çap.den
لەچاپنەدرا	.le.çap.ne.di.ra
لەچاپیان	.le.çap.yan
لەچەند	.le.çend
لەڕاستیدا	.le.řas.tî.da
لەڕووی	.le.řûy
لەڕێگای	.le.řê.gay
لەڕێگەی	.le.řê.gey
لەڕێی	.le.řêy
لەژێر	.le.jêr
لەڤین	.le.vîn
لەکاتی	.le.ka.tî
لەکاتێکدایە	.le.ka.têk.da.ye
لەکار	.le.kar
لەکۆتایی	.le.ko.ta.yî
لەکۆڵ	.le.koł
لەکۆڵی	.le.ko.łî
لەکۆی	.le.koy
لەگشتیدا	.le.giş.tî.da
لەگۆڕاندایە	.le.go.řan.da.ye
لەگەل	.le.gel
لەگەڕدان	.le.geř.dan
لەگەڵ	.le.geł
لەگەڵدا	.le.geł.da
لەگەڵی	.le.ge.łî
لەگەڵیان	.le.geł.yan
لەگەڵیاندا	.le.geł.yan.da
لەگەڵیدا	.le.ge.łî.da
لەگەڵە	.le.ge.łe
لەیلا	.ley.la
لەیەک	.le.yek
لەیەکەم	.le.ye.kem
ما	.ma
مابوونەوە	.ma.bû.ne.we
ماتباعی	.mat.ba.ƹî
ماتۆڕ	.ma.toř
مادام	.ma.dam
ماددی	.mad.dî
ماددە	.mad.de
ماددەی	.mad.dey
مادی	.ma.dî
مادەی	.ma.dey
مارس	.mars
مارسی	.mar.sî
مارچە	.mar.çe
مارکس	.marks
مارکەکانی	.mar.ke.ka.nî
مارەبڕین	.ma.re.bi.řîn
مارەبڕینەکەی	.ma.re.bi.řî.ne.key
ماسی	.ma.sî
ماشینەکانی	.ma.şî.ne.ka.nî
ماشێنی	.ma.şê.nî
ماشێنێکی	.ma.şê.nê.kî
ماف	.maf
مافخوازی	.maf.xwa.zî
مافی	.ma.fî
مافێکی	.ma.fê.kî
مافە	.ma.fe
مافەکانی	.ma.fe.ka.nî
مافەکانیان	.ma.fe.kan.yan
مالکی	.ma.li.kî
مالیکی	.ma.lî.kî
مام	.mam
مامناوەندی	.mam.na.wen.dî
مامۆستا	.ma.mos.ta
مامۆستاکانی	.ma.mos.ta.ka.nî
مامۆستاکانیانەوە	.ma.mos.ta.kan.ya.ne.we
مامۆستای	.ma.mos.tay
مامۆستایان	.ma.mos.ta.yan
مامۆستایانی	.ma.mos.ta.ya.nî
مامە	.ma.me
مامەوە	.ma.me.we
مامەڵە	.ma.me.łe
مامەڵەی	.ma.me.łey
مان	.man
مانا	.ma.na
مانای	.ma.nay
مانایە	.ma.na.ye
مانایەکی	.ma.na.ye.kî
ماندوو	.man.dû
ماندووبوونی	.man.dû.bû.nî
مانچستەر	.man.çis.ter
مانگ	.mang
مانگان	.man.gan
مانگانێک	.man.ga.nêk
مانگانە	.man.ga.ne
مانگرتن	.man.gir.tin
مانگرتنی	.man.gir.ti.nî
مانگی	.man.gî
مانگێک	.man.gêk
مانگە	.man.ge
مانگەدا	.man.ge.da
مانەوە	.ma.ne.we
مانەوەم	.ma.ne.wem
مانەوەی	.ma.ne.wey
مانەوەیان	.ma.ne.we.yan
ماون	.ma.win
ماونەتەوە	.maw.ne.te.we
ماوە	.ma.we
ماوەتەوە	.ma.we.te.we
ماوەی	.ma.wey
ماوەیەدا	.ma.we.ye.da
ماوەیەک	.ma.we.yek
ماوەیەکی	.ma.we.ye.kî
ماوەیەکە	.ma.we.ye.ke
ماچ	.maç
ماکی	.ma.kî
ماڵ	.mał
ماڵئاوایی	.mał.ʔa.wa.yî
ماڵان	.ma.łan
ماڵپەری	.mał.pe.rî
ماڵپەڕ	.mał.peř
ماڵپەڕان	.mał.pe.řan
ماڵپەڕانە	.mał.pe.řa.ne
ماڵپەڕانەدا	.mał.pe.řa.ne.da
ماڵپەڕانەم	.mał.pe.řa.nem
ماڵپەڕی	.mał.pe.řî
ماڵپەڕیان	.mał.peř.yan
ماڵپەڕێک	.mał.pe.řêk
ماڵپەڕە	.mał.pe.ře
ماڵپەڕەکان	.mał.pe.ře.kan
ماڵپەڕەکانیاندا	.mał.pe.ře.kan.yan.da
ماڵپەڕەکانیش	.mał.pe.ře.ka.nîş
ماڵی	.ma.łî
ماڵیاندا	.mał.yan.da
ماڵێ	.ma.łê
ماڵێدا	.ma.łê.da
ماڵێکی	.ma.łê.kî
ماڵە	.ma.łe
ماڵەوە	.ma.łe.we
ماڵەکاندا	.ma.łe.kan.da
ماڵەکانیشدا	.ma.łe.ka.nîş.da
ماڵەکەم	.ma.łe.kem
ماڵەکەی	.ma.łe.key
ماڵەکەیان	.ma.łe.ke.yan
مایەوە	.ma.ye.we
مایەی	.ma.yey
متمانە	.mit.ma.ne
متمانەی	.mit.ma.ney
محەمەد	.mi.ḧe.med
محەمەدی	.mi.ḧe.me.dî
مرد	.mird
مردن	.mir.din
مردنی	.mir.di.nî
مرۆڤ	.mi.rov
مرۆڤان	.mi.ro.van
مرۆڤایەتی	.mi.ro.va.ye.tî
مرۆڤدا	.mi.rov.da
مرۆڤناسی	.mi.rov.na.sî
مرۆڤی	.mi.ro.vî
مرۆڤێک	.mi.ro.vêk
مرۆڤێکی	.mi.ro.vê.kî
مرۆڤێکە	.mi.ro.vê.ke
مرۆڤە	.mi.ro.ve
مرۆڤەکان	.mi.ro.ve.kan
مرۆیی	.mi.ro.yî
مزگەوت	.miz.gewt
مزگەوتی	.miz.gew.tî
مستەفا	.mis.te.fa
مسوەگەر	.mis.we.ger
مشت	.mişt
مل	.mil
ملم	.mi.lim
ململانێ	.mil.mi.la.nê
ململانێی	.mil.mi.la.nêy
ملکەچی	.mil.ke.çî
ملی	.mi.lî
ملیار	.mil.yar
ملیان	.mil.yan
ملیۆن	.mil.yon
من	.min
مندا	.min.da
منداڵ	.min.dał
منداڵان	.min.da.łan
منداڵانی	.min.da.ła.nî
منداڵی	.min.da.łî
منداڵێک	.min.da.łêk
منداڵێکی	.min.da.łê.kî
منداڵە	.min.da.łe
منداڵەکان	.min.da.łe.kan
منداڵەکانی	.min.da.łe.ka.nî
منداڵەکانیان	.min.da.łe.kan.yan
منداڵەکە	.min.da.łe.ke
منی	.mi.nî
منیش	.mi.nîş
منە	.mi.ne
منەوە	.mi.ne.we
موبارەک	.mu.ba.rek
موحسین	.muḧ.sîn
موحەممەد	.mu.ḧem.med
موحەممەدی	.mu.ḧem.me.dî
موحەمەد	.mu.ḧe.med
موختار	.mux.tar
موراد	.mu.rad
موزیک	.mu.zîk
موزیکی	.mu.zî.kî
موستەفا	.mus.te.fa
موسلیم	.mus.lîm
موسڵ	.mu.sił
موسڵمان	.mu.sił.man]
موسڵمانان	.mu.sił.ma.nan]
موو	.mû
مووسا	.mû.sa
مووسیقاییی	.mû.sî.qa.yîy
مووش	.mûş
مووچە	.mû.çe
مووچەی	.mû.çey
مووچەیان	.mû.çe.yan
مووچەیەکیشم	.mû.çe.ye.kî.şim
موچەی	.mu.çey
موکری	.mu.ki.rî
موکریانی	.mu.ki.rya.nî
موکریانییە	.mu.ki.rya.nî.ye
موڵکی	.muł.kî
مَطبَع	.me.beƹ
مَکتومین	.mek.tu.mîn
مڕداین	.miř.dayn
مڵهوڕی	.mił.hu.řî
مۆبایل	.mo.bayl
مۆتکلی	.mot.ki.lî
مۆدێرن	.mo.dêrn
مۆدێلی	.mo.dê.lî
مۆر	.mor
مۆسکۆ	.mos.ko
مۆسیقا	.mo.sî.qa
مۆسیقای	.mo.sî.qay
مۆلیەر	.mol.yer
مۆڵەت	.mo.łet
مۆڵەتی	.mo.łe.tî
مۆڵەتەوە	.mo.łe.te.we
می	.mî
میانەی	.mya.ney
میدیا	.mîd.ya
میدیاکان	.mîd.ya.kan
میدیاکانی	.mîd.ya.ka.nî
میدیای	.mîd.yay
میر	.mîr
میرات	.mî.rat
میراتە	.mî.ra.te
میراودەلی	.mî.raw.de.lî
میری	.mî.rî
میسر	.mî.sir
میسری	.mîs.rî
میسی	.mî.sî
میلان	.mî.lan
میللی	.mîl.lî
میللەت	.mîl.let
میللەتی	.mîl.le.tî
میلیارد	.mîl.yard
میلیۆن	.mîl.yon
مین	.mîn
میوان	.mî.wan
میوانداری	.mî.wan.da.rî
میوانی	.mî.wa.nî
میوە	.mî.we
میکانیزمی	.mî.ka.nîz.mî
مێ	.mê
مێردین	.mêr.dîn
مێردەکەی	.mêr.de.key
مێشک	.mêşk
مێشکدا	.mêş.ki.da
مێشکی	.mêş.kî
مێژدا	.mêj.da
مێژوو	.mê.jû
مێژوودا	.mê.jû.da
مێژووی	.mê.jûy
مێژوویانەی	.mê.jû.ya.ney
مێژوویی	.mê.jû.yî
مێژوویییەکان	.mê.jû.yî.ye.kan
مێژوویەکی	.mê.jû.ye.kî
مێژووە	.mê.ju.we
مە	.me
مەبەست	.me.best
مەبەستم	.me.bes.tim
مەبەستی	.me.bes.tî
مەبەستێک	.me.bes.têk
مەبەستە	.me.bes.te
مەبەستەش	.me.bes.teş
مەتر	.me.tir
مەترسی	.me.tir.sî
مەترسیدار	.me.tir.sî.dar,[.met.ri.sî.dar]
مەترسیداربوون	.me.tir.sî.dar.bûn
مەترسیی	.me.tir.sîy
مەترسییە	.me.tir.sî.ye
مەترسییەوە	.me.tir.sî.ye.we
مەجلیسی	.mec.lî.sî
مەجید	.me.cîd
مەحاڵە	.me.ḧa.łe
مەحمود	.meḧ.mud
مەحموود	.meḧ.mûd
مەحمەت	.meḧ.met
مەحکوم	.meḧ.kum
مەحکووم	.meḧ.kûm
مەدرید	.med.rîd
مەدریدی	.med.rî.dî
مەدرەسە	.med.re.se
مەدیا	.med.ya
مەدەنی	.me.de.nî
مەراسیمی	.me.ra.sî.mî
مەرال	.me.ral
مەرج	.merc
مەرجی	.mer.cî
مەرجە	.mer.ce
مەرجەکانی	.mer.ce.ka.nî
مەرسین	.mer.sîn
مەرگ	.merg
مەرگی	.mer.gî
مەریوان	.me.rî.wan
مەزلووم	.mez.lûm
مەزن	.me.zin
مەزنی	.me.zi.nî
مەزهەب	.mez.heb
مەزهەبی	.mez.he.bî
مەسعود	.mes.ƹud
مەسعوود	.mes.ƹûd
مەسیح	.me.sîḧ
مەسیحی	.me.sî.ḧî
مەسەلە	.me.se.le
مەسەلەکە	.me.se.le.ke
مەسەلەی	.me.se.ley
مەسەلەیە	.me.se.le.ye
مەسەلەیەکی	.me.se.le.ye.kî
مەشق	.meşq
مەلا	.me.la
مەلای	.me.lay
مەلایان	.me.la.yan
مەلی	.me.lî
مەلەدی	.me.le.dî
مەم	.mem
مەناف	.me.naf
مەنسوور	.men.sûr
مەهاباد	.me.ha.bad
مەهدی	.meh.dî
مەودای	.mew.day
مەولانا	.mew.la.na
مەڕ	.meř
مەکتەبی	.mek.te.bî
مەکە	.me.ke
مەکەن	.me.ken
مەگەر	.me.ger
مەڵبەند	.meł.bend
مەڵبەندی	.meł.ben.dî
مەڵبەندە	.meł.ben.de
مەڵبەندەکانی	.meł.ben.de.ka.nî
مەڵبەندەکانیان	.meł.ben.de.kan.yan
مەی	.mey
مەیدان	.mey.dan
مەیدانی	.mey.da.nî
مەیلی	.mey.lî
ن	.ni
نا	.na
نائاسایی	.na.ʔa.sa.yî
نابرێن	.na.bi.rên
نابن	.na.bin
نابوو	.na.bû
نابوون	.na.bûn
نابێ	.na.bê
نابێت	.na.bêt
نابێتە	.na.bê.te
نابێتەوە	.na.bê.te.we
نابەجێ	.na.be.cê
ناتواندرێ	.na.twan.di.rê
ناتوانرێت	.nat.wan.rêt
ناتوانم	.na.twa.nim
ناتوانن	.na.twa.nin
ناتوانیت	.na.twa.nît
ناتوانین	.na.twa.nîn
ناتوانێ	.nat.wa.nê,.na.twa.nê
ناتوانێت	.nat.wa.nêt
ناتۆ	.na.to
ناحیەی	.naḧ.yey
ناحەزتر	.na.ḧez.tir
ناخۆش	.na.xoş
ناخۆشی	.na.xo.şî
ناخۆشییە	.na.xo.şî.ye
ناخی	.na.xî
نادات	.na.dat
ناداتێ	.na.da.tê
ناداتەوە	.na.da.te.we
نادرکێنن	.na.dir.kê.nin
نادرێ	.na.di.rê
نادرێت	.nad.rêt
نادرێن	.na.di.rên
نادۆزرێتەوە	.na.doz.rê.te.we
نادۆزرێنەوە	.na.doz.rê.ne.we
نادیار	.na.dyar
نادەن	.na.den
نادەنێ	.na.de.nê
نارد	.nard
ناردبوو	.nar.di.bû
ناردرا	.nar.di.ra
ناردرابان	.nar.di.ra.ban
ناردرابوو	.nar.di.ra.bû
ناردران	.nar.di.ran
ناردراون	.nar.di.ra.win
ناردراوەکان	.nar.di.ra.we.kan
ناردن	.nar.din
ناردنی	.nar.di.nî
ناردنیان	.nar.din.yan
ناردووە	.nar.du.we
نارەزایەتی	.na.re.za.ye.tî
ناز	.naz
نازانم	.na.za.nim
نازانن	.na.za.nin
نازانین	.na.za.nîn
نازانێت	.na.za.nêt
نازناو	.naz.naw
نازناوانە	.naz.na.wa.ne
نازناوی	.naz.na.wî
نازناویان	.naz.naw.yan
نازناوەوە	.naz.na.we.we
ناساند	.na.sand
ناساندبوو	.na.san.di.bû
ناساندنی	.na.san.di.nî
ناسر	.na.sir
ناسرا	.nas.ra
ناسرانیان	.nas.ran.yan
ناسراو	.nas.raw
ناسراون	.nas.ra.win
ناسراوی	.nas.ra.wî
ناسراوە	.nas.ra.we
ناسراوەوە	.nas.ra.we.we
ناسراوەکانی	.nas.ra.we.ka.nî
ناسنامە	.nas.na.me
ناسنامەی	.nas.na.mey
ناسنامەیەک	.nas.na.me.yek
ناسک	.nask
ناسینی	.na.sî.nî
ناسێندرا	.na.sên.di.ra
ناسێندرابوو	.na.sên.di.ra.bû
ناسێندرابوون	.na.sên.di.ra.bûn
ناشارەزا	.na.şa.re.za
ناشتوانن	.naş.twa.nin
ناشرین	.na.şi.rîn
ناشێ	.na.şê
نافرۆشن	.na.fi.ro.şin
نالەبار	.na.le.bar
نالەبارانەدا	.na.le.ba.ra.ne.da
نالەباریی	.na.le.ba.rîy
نامناسێ	.nam.na.sê
ناموسڵمانەکان	.na.mu.sił.ma.ne.kan
نامۆ	.na.mo
نامێنێت	.na.mê.nêt
نامە	.na.me
نامەوە	.na.me.we
نامەی	.na.mey
نامەیەک	.na.me.yek
نامەیەکی	.na.me.ye.kî
نان	.nan
نانووسرێ	.na.nûs.rê
نانی	.na.nî
نانێردرێن	.na.nêr.di.rên
نانێرن	.na.nê.rin
نانەشوێن	.na.ne.şwên
ناهاوبەش	.na.haw.beş
ناهێننەوە	.na.hê.ni.ne.we
ناو	.naw
ناوازە	.na.wa.ze
ناوبانگی	.naw.ban.gî
ناوبراو	.naw.bi.raw
ناوبژیوانی	.naw.bi.jî.wa.nî
ناوخۆ	.naw.xo
ناوخۆی	.naw.xoy
ناوخۆیی	.naw.xo.yî
ناوخۆیییەکان	.naw.xo.yî.ye.kan
ناوخۆیییەکانی	.naw.xo.yî.ye.ka.nî
ناوداری	.naw.da.rî
ناونیشانی	.naw.nî.şa.nî
ناوچانە	.naw.ça.ne
ناوچانەی	.naw.ça.ney
ناوچە	.naw.çe
ناوچەکان	.naw.çe.kan
ناوچەکاندا	.naw.çe.kan.da
ناوچەکانی	.naw.çe.ka.nî
ناوچەکانە	.naw.çe.ka.ne
ناوچەکە	.naw.çe.ke
ناوچەکەدا	.naw.çe.ke.da
ناوچەگەلە	.naw.çe.ge.le
ناوچەی	.naw.çey
ناوچەیانە	.naw.çe.ya.ne
ناوچەیی	.naw.çe.yî
ناوچەییی	.naw.çe.yîy
ناوچەیییەکان	.naw.çe.yî.ye.kan
ناوچەیە	.naw.çe.ye
ناوچەیەدا	.naw.çe.ye.da
ناوچەیەک	.naw.çe.yek
ناوچەیەکی	.naw.çe.ye.kî
ناوکی	.naw.kî
ناوی	.na.wî
ناویان	.naw.yan
ناویسان	.na.wî.san
ناوێت	.na.wêt
ناوە	.na.we
ناوەراست	.na.we.rast
ناوەرۆکی	.na.we.ro.kî
ناوەنجی	.na.wen.cî
ناوەند	.na.wend
ناوەندی	.na.wen.dî
ناوەندیان	.na.wend.yan
ناوەندیی	.na.wen.dîy
ناوەندییان	.na.wen.dî.yan
ناوەندییەکانی	.na.wen.dî.ye.ka.nî
ناوەندێک	.na.wen.dêk
ناوەندێکی	.na.wen.dê.kî
ناوەندە	.na.wen.de
ناوەندەکانی	.na.wen.de.ka.nî
ناوەندەکانیان	.na.wen.de.kan.yan
ناوەندەکەی	.na.wen.de.key
ناوەوە	.na.we.we
ناوەوەی	.na.we.wey
ناوەڕاست	.na.we.řast
ناوەڕاستدا	.na.we.řast.da
ناوەڕاستی	.na.we.řas.tî
ناوەڕاستە	.na.we.řas.te
ناوەڕۆکی	.na.we.řo.kî
ناوەکانی	.na.we.ka.nî
ناوەکانە	.na.we.ka.ne
ناوەکی	.na.we.kî
ناچار	.na.çar
ناچاردەکرد	.na.çar.de.kird
ناچاری	.na.ça.rî
ناچیرۆکەکاندا	.na.çî.ro.ke.kan.da
ناچێت	.na.çêt
ناڕاست	.na.řast
ناڕاستەوخۆیانە	.na.řas.tew.xo.ya.ne
ناڕێکەوە	.na.řê.ke.we
ناڕەزایی	.na.ře.za.yî
ناڕەزایەتی	.na.ře.za.ye.tî
ناڕەوا	.na.ře.wa
ناڕەوای	.na.ře.way
ناڤەندا	.na.ven.da
ناکا	.na.ka
ناکات	.na.kat
ناکاتەوە	.na.ka.te.we
ناکامی	.na.ka.mî
ناکاو	.na.kaw
ناکرێ	.na.ki.rê
ناکرێت	.na.ki.rêt
ناکرێنەوە	.na.ki.rê.ne.we
ناکوردی	.na.kur.dî
ناکوردییە	.na.kur.dî.ye
ناکۆکی	.na.ko.kî
ناکۆکیگەلی	.na.ko.kî.ge.lî
ناکەم	.na.kem
ناکەن	.na.ken
ناکەوێ	.na.ke.wê
ناکەین	.na.keyn
ناگرێت	.na.gi.rêt
ناگونجێن	.na.gun.cên
ناگەنێ	.na.ge.nê
ناگەنە	.na.ge.ne
نایابی	.na.ya.bî
نایات	.na.yat
نایاسایانە	.na.ya.sa.ya.ne
نایاسایی	.na.ya.sa.yî
نایاساییی	.na.ya.sa.yîy
نایاسایییانە	.na.ya.sa.yî.ya.ne
نایاسایییانەمان	.na.ya.sa.yî.ya.ne.man
نایاسایییەوە	.na.ya.sa.yî.ye.we
نایاسایییەکان	.na.ya.sa.yî.ye.kan
نایاسایییەکانەوە	.na.ya.sa.yî.ye.ka.ne.we
نایانگەنێ	.na.yan.ge.nê
نایدەن	.nay.den
نایە	.na.ye
نایەوێت	.na.ye.wêt
نرابوو	.ni.ra.bû
نرابێ	.ni.ra.bê
نرخ	.nirx
نرخی	.nir.xî
نرخیان	.nirx.yan
نرخێکی	.nir.xê.kî
نرخە	.nir.xe
نرخەکان	.nir.xe.kan
نرخەکانی	.nir.xe.ka.nî
نرخەکە	.nir.xe.ke
نزم	.ni.zim
نزیک	.ni.zîk
نزیکدا	.ni.zîk.da
نزیکی	.ni.zî.kî
نزیکە	.ni.zî.ke
نزیکەوە	.ni.zî.ke.we
نزیکەی	.ni.zî.key
نمایش	.ni.ma.yiş
نمایشی	.ni.ma.yi.şî
نمرجن	.ni.mir.cin
نموونە	.ni.mû.ne
نموونەگەلێک	.ni.mû.ne.ge.lêk
نموونەی	.ni.mû.ney
نموونەیە	.ni.mû.ne.ye
نموونەیەک	.ni.mû.ne.yek
نموونەیەکی	.ni.mû.ne.ye.kî
نهێنی	.ni.hê.nî
نهێنیانە	.ni.hên.ya.ne
نهێنین	.ni.hê.nîn
نهێنیی	.ni.hê.nîy
نهێنییانەی	.ni.hê.nî.ya.ney
نهێنییانەیە	.ni.hê.nî.ya.ne.ye
نهێنییەکانی	.ni.hê.nî.ye.ka.nî
نوری	.nu.rî
نوسراوە	.nus.ra.we
نوسینگەی	.nu.sîn.gey
نوسینی	.nu.sî.nî
نوو	.nû
نووبهار	.nû.bi.har
نوودەم	.nû.dem
نووری	.nû.rî
نوورەدین	.nû.re.dîn
نووسرابوو	.nûs.ra.bû
نووسرابوون	.nûs.ra.bûn
نووسراو	.nûs.raw
نووسراون	.nûs.ra.win
نووسراونەتەوە	.nûs.raw.ne.te.we
نووسراوی	.nûs.ra.wî
نووسراوە	.nûs.ra.we
نووسراوەکان	.nûs.ra.we.kan
نووسراوەکاندا	.nûs.ra.we.kan.da
نووسراوەکانی	.nûs.ra.we.ka.nî
نووسراوەکانیان	.nûs.ra.we.kan.yan
نووسراوەکانیانەوە	.nûs.ra.we.kan.ya.ne.we
نووسراوەگەلی	.nûs.ra.we.ge.lî
نووسراوەگەلێک	.nûs.ra.we.ge.lêk
نووسراوەی	.nûs.ra.wey
نووسراوەیان	.nûs.ra.we.yan
نووسی	.nû.sî
نووسیبوو	.nû.sî.bû
نووسین	.nû.sîn
نووسیندا	.nû.sîn.da
نووسینگە	.nû.sîn.ge
نووسینگەکانی	.nû.sîn.ge.ka.nî
نووسینگەکە	.nû.sîn.ge.ke
نووسینگەکەشیدا	.nû.sîn.ge.ke.şî.da
نووسینگەکەمان	.nû.sîn.ge.ke.man
نووسینگەکەیانەوە	.nû.sîn.ge.ke.ya.ne.we
نووسینگەی	.nû.sîn.gey
نووسینی	.nû.sî.nî
نووسینیان	.nû.sîn.yan
نووسینەوە	.nû.sî.ne.we
نووسینەوەی	.nû.sî.ne.wey
نووسیویانە	.nû.sîw.ya.ne
نووسیویە	.nû.sîw.ye
نووسیویەتی	.nû.sîw.ye.tî
نووسیوە	.nû.sî.we
نووسەر	.nû.ser
نووسەران	.nû.se.ran
نووسەرانی	.nû.se.ra.nî
نووسەرانیش	.nû.se.ra.nîş
نووسەرانیشی	.nû.se.ra.nî.şî
نووسەرانێک	.nû.se.ra.nêk
نووسەرانێکی	.nû.se.ra.nê.kî
نووسەرانە	.nû.se.ra.ne
نووسەرانەدا	.nû.se.ra.ne.da
نووسەرانەوە	.nû.se.ra.ne.we
نووسەرانەی	.nû.se.ra.ney
نووسەرکی	.nû.ser.kî
نووسەری	.nû.se.rî
نووسەریش	.nû.se.rîş
نووسەریشن	.nû.se.rî.şin
نووسەرێک	.nû.se.rêk
نووسەرێکی	.nû.se.rê.kî
نووسەرە	.nû.se.re
نووسەرەوە	.nû.se.re.we
نووسەرەکان	.nû.se.re.kan
نووسەرەکاندا	.nû.se.re.kan.da
نووسەرەکانی	.nû.se.re.ka.nî
نووسەرەکانیان	.nû.se.re.kan.yan
نووسەرەکانیدا	.nû.se.re.ka.nî.da
نووسەرەکانیش	.nû.se.re.ka.nîş
نووسەرەکە	.nû.se.re.ke
نوێ	.nwê
نوێبنیانەکەی	.nwê.bin.ya.ne.key
نوێترین	.nwê.ti.rîn
نوێدا	.nwê.da
نوێش	.nwêş
نوێنەران	.nwê.ne.ran
نوێنەرانی	.nwê.ne.ra.nî
نوێنەرایەتی	.nwê.ne.ra.ye.tî
نوێنەرایەتیی	.nwê.ne.ra.ye.tîy
نوێنەری	.nwê.ne.rî
نوێنەرەکانی	.nwê.ne.re.ka.nî
نوێژ	.nwêj
نوێژی	.nwê.jî
نوێی	.nwêy
نوێیان	.nwê.yan
نوێیە	.nwê.ye
نوێیەکان	.nwê.ye.kan
نوێیەکانی	.nwê.ye.ka.nî
نوێیەکەیان	.nwê.ye.ke.yan
نژاد	.ni.jad
نڤیسکی	.ni.vîs.kî
نڤیسکیی	.ni.vîs.kîy
نڤیسیاران	.ni.vîs.ya.ran
نڤیسیاری	.ni.vîs.ya.rî
نڤیسیاریی	.ni.vîs.ya.rîy
نڤیسیارەکان	.ni.vîs.ya.re.kan
نکۆڵی	.ni.ko.łî
نکۆڵییانە	.ni.ko.łî.ya.ne
نکۆڵێ	.ni.ko.łê
نۆ	.no
نی	.nî
نیازی	.nya.zî
نیزامی	.nî.za.mî
نیسان	.nî.san
نیسانی	.nî.sa.nî
نیشان	.nî.şan
نیشاندا	.nî.şan.da
نیشاندانی	.nî.şan.da.nî
نیشانی	.nî.şa.nî
نیشانیان	.nî.şan.yan
نیشانەکانی	.nî.şa.ne.ka.nî
نیشانەی	.nî.şa.ney
نیشتمان	.nîş.ti.man
نیشتمانپەروەرییە	.nîş.ti.man.per.we.rî.ye
نیشتمانی	.nîş.ti.ma.nî
نیشتمانیی	.nîş.ti.ma.nîy
نیشتیمان	.nîş.tî.man
نیشتیمانی	.nîş.tî.ma.nî
نیشتەجێ	.nîş.te.cê
نیشتەجێبوون	.nîş.te.cê.bûn
نیشتەجێن	.nîş.te.cên
نیشتەجێیە	.nîş.te.cê.ye
نیم	.nîm
نیمچە	.nîm.çe
نین	.nîn
نیو	.nîw
نیووز	.nyûz
نیوە	.nî.we
نیوەڕۆ	.nî.we.řo
نیوەڕۆی	.nî.we.řoy
نیوەی	.nî.wey
نیوەیان	.nî.we.yan
نیگەران	.nî.ge.ran
نیگەرانی	.nî.ge.ra.nî
نیۆیۆرک	.nyo.york
نییە	.nî.ye
نییەکە	.nî.ye.ke
نێت	.nêt
نێر	.nêr
نێزیک	.nê.zîk
نێزیکترین	.nê.zîk.ti.rîn
نێزیکی	.nê.zî.kî
نێزیکەکانیان	.nê.zî.ke.kan.yan
نێزیکەی	.nê.zî.key
نێشتەجێیەکانی	.nêş.te.cê.ye.ka.nî
نێن	.nên
نێو	.nêw
نێوان	.nê.wan
نێوانی	.nê.wa.nî
نێوانیان	.nê.wan.yan
نێوانەم	.nê.wa.nem
نێوبراوە	.nêw.bi.ra.we
نێوبراوەکان	.nêw.bi.ra.we.kan
نێوبراوەکاندا	.nêw.bi.ra.we.kan.da
نێوبراوەکە	.nêw.bi.ra.we.ke
نێوبڕێکی	.nêw.bi.řê.kî
نێوخۆیان	.nêw.xo.yan
نێوخۆیی	.nêw.xo.yî
نێوخۆیییەکان	.nêw.xo.yî.ye.kan
نێوخۆیییەکانەوە	.nêw.xo.yî.ye.ka.ne.we
نێودەوڵەتی	.nêw.dew.łe.tî
نێودەوڵەتیی	.nêw.dew.łe.tîy
نێودەوڵەتییەکان	.nêw.dew.łe.tî.ye.kan
نێومان	.nêw.man
نێونراوە	.nêw.ni.ra.we
نێونیشانی	.nêw.nî.şa.nî
نێونیشانێکم	.nêw.nî.şa.nê.kim
نێونەتەوەیی	.nêw.ne.te.we.yî
نێونەتەوەییشە	.nêw.ne.te.we.yî.şe
نێونەتەوەییی	.nêw.ne.te.we.yîy
نێوکۆڵانەکاندا	.nêw.ko.ła.ne.kan.da
نێوگۆڕینەیە	.nêw.go.řî.ne.ye
نێوی	.nê.wî
نێویان	.nêw.yan
نێوێکی	.nê.wê.kî
نێوە	.nê.we
نێوەوە	.nê.we.we
نێوەکانیان	.nê.we.kan.yan
نێوەکانیشیان	.nê.we.ka.nîş.yan
نێوەکوردییەکان	.nê.we.kur.dî.ye.kan
نێوەیان	.nê.we.yan
نێچیرڤان	.nê.çîr.van
نە	.ne
نەبن	.ne.bin
نەبونی	.ne.bu.nî
نەبوو	.ne.bû
نەبووایە	.ne.bu.wa.ye
نەبوون	.ne.bûn
نەبوونی	.ne.bû.nî
نەبوونە	.ne.bû.ne
نەبووە	.ne.bu.we
نەبوە	.neb.we
نەبی	.ne.bî
نەبیسرانی	.ne.bîs.ra.nî
نەبینیوەتەوە	.ne.bî.nî.we.te.we
نەبێ	.ne.bê
نەبێت	.ne.bêt
نەتوانن	.ne.twa.nin
نەتوانێت	.ne.twa.nêt
نەتەوایەتی	.ne.te.wa.ye.tî
نەتەوە	.ne.te.we
نەتەوەخوازانەی	.ne.te.we.xwa.za.ney
نەتەوەخوازانەیە	.ne.te.we.xwa.za.ne.ye
نەتەوەخوازیی	.ne.te.we.xwa.zîy
نەتەوەخوازییە	.ne.te.we.xwa.zî.ye
نەتەوەخوازەکانی	.ne.te.we.xwa.ze.ka.nî
نەتەوەپەرستی	.ne.te.we.pe.ris.tî
نەتەوەکان	.ne.te.we.kan
نەتەوەکاندا	.ne.te.we.kan.da
نەتەوەکانی	.ne.te.we.ka.nî
نەتەوەکەمان	.ne.te.we.ke.man
نەتەوەگەلێکی	.ne.te.we.ge.lê.kî
نەتەوەی	.ne.te.wey
نەتەوەیی	.ne.te.we.yî
نەتەوەییدا	.ne.te.we.yî.da
نەتەوەییی	.ne.te.we.yîy
نەتەوەیییەکان	.ne.te.we.yî.ye.kan
نەتەوەیییەکانی	.ne.te.we.yî.ye.ka.nî
نەتەوەیەک	.ne.te.we.yek
نەتەوەیەکگرتووەکان	.ne.te.we.yek.gir.tu.we.kan
نەتەوەیەکی	.ne.te.we.ye.kî
نەجمەددین	.nec.med.dîn
نەخایاند	.ne.xa.yand
نەختێک	.nex.têk
نەخشە	.nex.şe
نەخشەی	.nex.şey
نەخوێندەوار	.ne.xwên.de.war
نەخوێندەواریی	.ne.xwên.de.wa.rîy
نەخۆش	.ne.xoş
نەخۆشخانە	.ne.xoş.xa.ne
نەخۆشخانەی	.ne.xoş.xa.ney
نەخۆشی	.ne.xo.şî
نەخۆشیی	.ne.xo.şîy
نەخۆشییە	.ne.xo.şî.ye
نەخێر	.ne.xêr
نەخێندەواری	.ne.xên.de.wa.rî
نەدا	.ne.da
نەدابوو	.ne.da.bû
نەدات	.ne.dat
نەدان	.ne.dan
نەداوە	.ne.da.we
نەداوەتەوە	.ne.da.we.te.we
نەدراوە	.ne.di.ra.we
نەدۆزیوەتەوە	.ne.do.zî.we.te.we
نەدیوە	.ne.dî.we
نەدیوەتەوە	.ne.dî.we.te.we
نەدەبوو	.ne.de.bû
نەدەجووڵایەوە	.ne.de.cû.ła.ye.we
نەدەدا	.ne.de.da
نەدەدرا	.ne.de.di.ra
نەدەن	.ne.den
نەدەهات	.ne.de.hat
نەدەهاتن	.ne.de.ha.tin
نەدەکرا	.ne.de.ki.ra
نەدەکرد	.ne.de.kird
نەدەکردەوە	.ne.de.kir.de.we
نەدەکەوت	.ne.de.kewt
نەدەگرتن	.ne.de.gir.tin
نەدەگیرا	.ne.de.gî.ra
نەرم	.nerm
نەرمونیانانەوە	.ner.mu.nya.na.ne.we
نەرویج	.ner.wîc
نەریت	.ne.rît
نەریتی	.ne.rî.tî
نەزاندراوە	.ne.zan.di.ra.we
نەزانیبوو	.ne.za.nî.bû
نەسڕاوەتەوە	.nes.řa.we.te.we
نەسەلمێندراوە	.ne.sel.mên.di.ra.we
نەشتەرگەری	.neş.ter.ge.rî
نەشیانتوانیوە	.neş.yan.twa.nî.we
نەشیتوانیوە	.ne.şî.twa.nî.we
نەفت	.neft
نەفەران	.ne.fe.ran
نەقشبەندی	.neqş.ben.dî
نەما	.ne.ma
نەمان	.ne.man
نەمانی	.ne.ma.nî
نەماون	.ne.ma.win
نەماوە	.ne.ma.we
نەماوەتەوە	.ne.ma.we.te.we
نەمتوانی	.nem.twa.nî
نەمر	.ne.mir
نەمێنێت	.ne.mê.nêt
نەناردنی	.ne.nar.di.nî
نەناسراو	.ne.nas.raw
نەناسێندراوە	.ne.na.sên.di.ra.we
نەنووسرابوو	.ne.nûs.ra.bû
نەهات	.ne.hat
نەهاتووە	.ne.ha.tu.we
نەهاتووەتە	.ne.ha.tu.we.te
نەهێشتنی	.ne.hêş.ti.nî
نەهێنرا	.ne.hên.ra
نەهێنراوە	.ne.hên.ra.we
نەوت	.newt
نەوتی	.new.tî
نەورۆز	.new.roz
نەوزاد	.new.zad
نەوشیروان	.new.şîr.wan
نەویتر	.ne.wî.tir
نەویترین	.ne.wî.ti.rîn
نەوەک	.ne.wek
نەوەکا	.ne.we.ka
نەوەکانی	.ne.we.ka.nî
نەوەکانیشت	.ne.we.ka.nî.şit
نەوەی	.ne.wey
نەچمەوە	.neç.me.we
نەچووە	.ne.çu.we
نەچێت	.ne.çêt
نەڕۆمەوە	.ne.řo.me.we
نەژاد	.ne.jad
نەک	.nek
نەکات	.ne.kat
نەکرا	.ne.ki.ra
نەکرابوو	.ne.ki.ra.bû
نەکرام	.ne.ki.ram
نەکراونەتەوە	.ne.ki.raw.ne.te.we
نەکراوە	.ne.ki.ra.we
نەکراوەتەوە	.ne.ki.ra.we.te.we
نەکربوو	.ne.kir.bû
نەکرد	.ne.kird
نەکردرێ	.ne.kir.di.rê
نەکردنی	.ne.kir.di.nî
نەکردوون	.ne.kir.dûn
نەکردووە	.ne.kir.du.we
نەکرێت	.ne.ki.rêt
نەکەن	.ne.ken
نەکەوتبوو	.ne.kew.ti.bû
نەکەین	.ne.keyn
نەگرین	.ne.gi.rîn
نەگونجاو	.ne.gun.caw
نەگونجراو	.ne.gunc.raw
نەگۆڕێندراون	.ne.go.řên.di.ra.win
نەگەیوە	.ne.gey.we
نەیارانی	.ne.ya.ra.nî
نەیانتوانی	.ne.yan.twa.nî
نەیانتوانیبوو	.ne.yan.twa.nî.bû
نەیانتوانیوە	.ne.yan.twa.nî.we
نەیاندەتوانی	.ne.yan.det.wa.nî
نەیاندەهێشت	.ne.yan.de.hêşt
نەیانوێرا	.ne.yan.wê.ra
نەیتوانی	.ney.twa.nî
نەیتوانیوە	.ney.twa.nî.we
نەیدەتوانی	.ney.det.wa.nî,.ney.de.twa.nî
نەینەوا	.ney.ne.wa
نەیوێراوە	.ney.wê.ra.we
نەیکا	.ney.ka
ها	.ha
هات	.hat
هاتبوو	.ha.ti.bû
هاتبوون	.ha.ti.bûn
هاتبوونە	.ha.ti.bû.ne
هاتن	.ha.tin
هاتنی	.ha.ti.nî
هاتنە	.ha.ti.ne
هاتنەوە	.ha.ti.ne.we
هاتوو	.ha.tû
هاتوون	.ha.tûn
هاتوونەتە	.ha.tû.ne.te
هاتووە	.ha.tu.we
هاتووەتە	.ha.tu.we.te
هاتوچووی	.ha.tu.çûy
هاتوچۆ	.ha.tu.ço
هاتوچۆی	.ha.tu.çoy
هاتۆتە	.ha.to.te
هاتە	.ha.te
هاتەوە	.ha.te.we
هادی	.ha.dî
هارڤارد	.har.vard
هاریدەدەری	.ha.rî.de.de.rî
هاریدەدەریان	.ha.rî.de.der.yan
هاریکاری	.ha.rî.ka.rî
هاشم	.ha.şim
هاشمی	.ha.şi.mî
هان	.han
هاندانی	.han.da.nî
هاندەرانی	.han.de.ra.nî
هاندەرەکان	.han.de.re.kan
هانی	.ha.nî
هاو	.haw
هاوار	.ha.war
هاواری	.ha.wa.rî
هاوارێ	.ha.wa.rê
هاوبڕیارەکانیاندا	.haw.biř.ya.re.kan.yan.da
هاوبەش	.haw.beş
هاوبەشن	.haw.be.şin
هاوبەشی	.haw.be.şî
هاودەنگیی	.haw.den.gîy
هاوسەرگیری	.haw.ser.gî.rî
هاوسەرۆکی	.haw.se.ro.kî
هاوسەری	.haw.se.rî
هاوسەرەکەی	.haw.se.re.key
هاوسەنگی	.haw.sen.gî
هاوشێوەی	.haw.şê.wey
هاوولاتیان	.haw.wi.lat.yan
هاووڵاتی	.haw.wi.ła.tî
هاووڵاتیان	.haw.wi.łat.yan
هاووڵاتیانی	.haw.wi.łat.ya.nî
هاووڵاتیی	.haw.wi.ła.tîy
هاووڵاتییانی	.haw.wi.ła.tî.ya.nî
هاووڵاتییە	.haw.wi.ła.tî.ye
هاووڵاتییەک	.haw.wi.ła.tî.yek
هاووڵاتییەکی	.haw.wi.ła.tî.ye.kî
هاوپەیمانی	.haw.pey.ma.nî
هاوپەیمانیی	.haw.pey.ma.nîy
هاوچەرخ	.haw.çerx
هاوچەرخدا	.haw.çerx.da
هاوچەرخەوە	.haw.çer.xe.we
هاوڕا	.haw.řa
هاوڕیش	.haw.řîş
هاوڕێ	.haw.řê
هاوڕێن	.haw.řên
هاوڕێژەیە	.haw.řê.je.ye
هاوڕێکانی	.haw.řê.ka.nî
هاوڕێی	.haw.řêy
هاوڕێیان	.haw.řê.yan
هاوڕێیانی	.haw.řê.ya.nî
هاوڕێیانە	.haw.řê.ya.ne
هاوڕێیە	.haw.řê.ye
هاوڕێیەک	.haw.řê.yek
هاوڕێیەکان	.haw.řê.ye.kan
هاوڕێیەکانم	.haw.řê.ye.ka.nim
هاوڕێیەکانی	.haw.řê.ye.ka.nî
هاوڕێیەکانیان	.haw.řê.ye.kan.yan
هاوڕێیەکەشم	.haw.řê.ye.ke.şim
هاوکات	.haw.kat
هاوکار	.haw.kar
هاوکاری	.haw.ka.rî
هاوکاریی	.haw.ka.rîy
هاوکارییان	.haw.ka.rî.yan
هاوڵاتیانی	.haw.łat.ya.nî
هاویاریی	.haw.ya.rîy
هاوینی	.ha.wî.nî
هاڕۆڵد	.ha.řołd
هتد	.hi.tid
هزر	.hi.zir
هزری	.hiz.rî
هشیار	.hiş.yar
هوسێس	.hu.sês
هونەر	.hu.ner
هونەرمەند	.hu.ner.mend
هونەرمەندان	.hu.ner.men.dan
هونەرمەندانی	.hu.ner.men.da.nî
هونەرمەندی	.hu.ner.men.dî
هونەرمەندە	.hu.ner.men.de
هونەری	.hu.ne.rî
هونەریی	.hu.ne.rîy
هونەرە	.hu.ne.re
هوونەرا	.hû.ne.ra
هوگۆ	.hu.go
هۆ	.ho
هۆرتە	.hor.te
هۆرتەوبەرە	.hor.tew.be.re
هۆرتەوبەرەکان	.hor.tew.be.re.kan
هۆرتەوبەرەکانی	.hor.tew.be.re.ka.nî
هۆرتەوبەرەی	.hor.tew.be.rey
هۆرتەوبەرەیە	.hor.tew.be.re.ye
هۆرتەوبەرەیەکی	.hor.tew.be.re.ye.kî
هۆزی	.ho.zî
هۆزەکان	.ho.ze.kan
هۆشیار	.hoş.yar
هۆشیاری	.hoş.ya.rî
هۆنراوە	.hon.ra.we
هۆنراوەکان	.hon.ra.we.kan
هۆنراوەکانی	.hon.ra.we.ka.nî
هۆنراوەگەلە	.hon.ra.we.ge.le
هۆنراوەی	.hon.ra.wey
هۆکار	.ho.kar
هۆکارانی	.ho.ka.ra.nî
هۆکارانە	.ho.ka.ra.ne
هۆکاری	.ho.ka.rî
هۆکارێک	.ho.ka.rêk
هۆکارێکی	.ho.ka.rê.kî
هۆکارە	.ho.ka.re
هۆکارەکانی	.ho.ka.re.ka.nî
هۆکارەکەش	.ho.ka.re.keş
هۆکی	.ho.kî
هۆگر	.ho.gir
هۆگریان	.ho.gir.yan
هۆگریانن	.ho.gir.ya.nin
هۆگرەکان	.ho.gi.re.kan
هۆگرەکانی	.ho.gi.re.ka.nî
هۆڵی	.ho.łî
هۆڵەندا	.ho.łen.da
هۆی	.hoy
هۆییەک	.hoy.yek
هۆیە	.ho.ye
هۆیەوە	.ho.ye.we
هۆیەکانیان	.ho.ye.kan.yan
هۆیەکی	.ho.ye.kî
هی	.hî
هیلال	.hî.lal
هیند	.hînd
هیندستان	.hîn.dis.tan
هیندوو	.hîn.dû
هیوا	.hî.wa
هیوادارم	.hî.wa.da.rim
هیوادارین	.hî.wa.da.rîn
هیوامان	.hî.wa.man
هیوای	.hî.way
هیچ	.hîç
هیچت	.hî.çit
هیچی	.hî.çî
هیچیان	.hîç.yan
هێدی	.hê.dî
هێرش	.hê.riş
هێرشانە	.hê.ri.şa.ne
هێرشبەری	.hê.riş.be.rî
هێرشی	.hê.ri.şî
هێرشیان	.hê.riş.yan
هێرشێکی	.hê.ri.şê.kî
هێرشە	.hê.ri.şe
هێرشەکانی	.hê.ri.şe.ka.nî
هێز	.hêz
هێزانە	.hê.za.ne
هێزکردنەوەی	.hêz.kir.di.ne.wey
هێزی	.hê.zî
هێزیی	.hê.zîy
هێزێک	.hê.zêk
هێزێکی	.hê.zê.kî
هێزە	.hê.ze
هێزەکانی	.hê.ze.ka.nî
هێستا	.hês.ta
هێستاش	.hês.taş
هێشت	.hêşt
هێشتا	.hêş.ta
هێشتبوو	.hêş.ti.bû
هێمای	.hê.may
هێمن	.hê.min
هێمنی	.hê.mi.nî
هێمینگوەی	.hê.mîng.wey
هێنا	.hê.na
هێنابا	.hê.na.ba
هێنابوو	.hê.na.bû
هێنابوویان	.hê.na.bû.yan
هێنان	.hê.nan
هێنانی	.hê.na.nî
هێنانیان	.hê.nan.yan
هێنانە	.hê.na.ne
هێنانەوەی	.hê.na.ne.wey
هێنانەکەم	.hê.na.ne.kem
هێناونەتەوە	.hê.naw.ne.te.we
هێناوە	.hê.na.we
هێناوەتە	.hê.na.we.te
هێنایە	.hê.na.ye
هێنایەوە	.hê.na.ye.we
هێند	.hênd
هێندراونەتە	.hên.di.raw.ne.te
هێندە	.hên.de
هێندەی	.hên.dey
هێنرا	.hên.ra
هێنرابوون	.hên.ra.bûn
هێنراون	.hên.ra.win
هێنراوەتە	.hên.ra.we.te
هێچ	.hêç
هێڤی	.hê.vî
هێڵی	.hê.łî
هە	.he
هەبن	.he.bin
هەبوو	.he.bû
هەبووبێ	.he.bû.bê
هەبوون	.he.bûn
هەبوونی	.he.bû.nî
هەبووە	.he.bu.we
هەبوە	.heb.we
هەبێ	.he.bê
هەبێت	.he.bêt
هەتا	.he.ta
هەتانە	.he.ta.ne
هەتاو	.he.taw
هەتاوی	.he.ta.wî
هەتاکوو	.he.ta.kû
هەر	.her
هەربۆیە	.her.bo.ye
هەرتک	.her.tik
هەرتکیان	.her.tik.yan
هەردوو	.her.dû
هەردوولا	.her.dû.la
هەردووک	.her.dûk
هەردووکشیان	.her.dû.kiş.yan
هەردووکیان	.her.dûk.yan
هەردی	.her.dî
هەردەم	.her.dem
هەرزانتر	.her.zan.tir
هەرزانترن	.her.zan.ti.rin
هەرسێک	.her.sêk
هەروا	.her.wa
هەروەها	.her.we.ha
هەروەک	.her.wek
هەرچۆنێک	.her.ço.nêk
هەرچی	.her.çî
هەرچەند	.her.çend
هەرچەندە	.her.çen.de
هەرکام	.her.kam
هەرکەس	.her.kes
هەرکەسێک	.her.ke.sêk
هەرگیز	.her.gîz
هەریەک	.her.yek
هەریەکە	.her.ye.ke
هەریەکەیان	.her.ye.ke.yan
هەرێم	.he.rêm
هەرێمدا	.he.rêm.da
هەرێمی	.he.rê.mî
هەرێمە	.he.rê.me
هەرێمەوە	.he.rê.me.we
هەرێمەکە	.he.rê.me.ke
هەرە	.he.re
هەزار	.he.zar
هەزاران	.he.za.ran
هەزاریش	.he.za.rîş
هەزیر	.he.zîr
هەزیرکردنی	.he.zîr.kir.di.nî
هەست	.hest
هەستا	.hes.ta
هەستان	.hes.tan
هەستم	.hes.tim
هەستکردن	.hest.kir.din
هەستی	.hes.tî
هەستیان	.hest.yan
هەستێکی	.hes.tê.kî
هەستە	.hes.te
هەستەکان	.hes.te.kan
هەشبوون	.heş.bûn
هەشت	.heşt
هەشتەم	.heş.tem
هەشتەمین	.heş.te.mîn
هەشن	.he.şin
هەفتە	.hef.te
هەفتەی	.hef.tey
هەفتەیە	.hef.te.ye
هەفتەیەک	.hef.te.yek
هەل	.hel
هەلانە	.he.la.ne
هەلبژاردەی	.hel.bi.jar.dey
هەلومەرجانێک	.he.lu.mer.ca.nêk
هەلومەرجی	.he.lu.mer.cî
هەلومەرجێکی	.he.lu.mer.cê.kî
هەلومەرجە	.he.lu.mer.ce
هەلومەرجەکە	.he.lu.mer.ce.ke
هەلۆمەرجەکە	.he.lo.mer.ce.ke
هەلی	.he.lî
هەلێکی	.he.lê.kî
هەلێکە	.he.lê.ke
هەم	.hem
هەمان	.he.man
هەماهەنگی	.he.ma.hen.gî
هەمبەر	.hem.ber
هەمو	.he.mu
هەموان	.hem.wan
هەموو	.he.mû
هەمووان	.he.mu.wan
هەموومان	.he.mû.man
هەمووی	.he.mûy
هەموویان	.he.mû.yan
هەمیش	.he.mîş
هەمیشە	.he.mî.şe
هەمیشەیی	.he.mî.şe.yî
هەن	.hen
هەناردە	.he.nar.de
هەناردەکردنی	.he.nar.de.kir.di.nî
هەناردەی	.he.nar.dey
هەناسە	.he.na.se
هەناسەی	.he.na.sey
هەندێک	.hen.dêk
هەندێکشیان	.hen.dê.kiş.yan
هەندێکی	.hen.dê.kî
هەندێکیان	.hen.dêk.yan
هەندێکیش	.hen.dê.kîş
هەندێکیشیان	.hen.dê.kîş.yan
هەندەران	.hen.de.ran
هەندەرانیشدا	.hen.de.ra.nîş.da
هەندەرانێ	.hen.de.ra.nê
هەندەک	.hen.dek
هەنووکە	.he.nû.ke
هەنگاو	.hen.gaw
هەنگاوی	.hen.ga.wî
هەنگاوێک	.hen.ga.wêk
هەنگاوێکی	.hen.ga.wê.kî
هەنگاوە	.hen.ga.we
هەنگاوەکانی	.hen.ga.we.ka.nî
هەوا	.he.wa
هەواڵ	.he.wał
هەواڵدەری	.he.wał.de.rî
هەواڵدەریی	.he.wał.de.rîy
هەواڵنێری	.he.wał.nê.rî
هەواڵگری	.he.wał.gi.rî
هەواڵی	.he.wa.łî
هەواڵێکی	.he.wa.łê.kî
هەواڵە	.he.wa.łe
هەواڵەکان	.he.wa.łe.kan
هەواڵەکانی	.he.wa.łe.ka.nî
هەوای	.he.way
هەورامان	.hew.ra.man
هەورامی	.hew.ra.mî
هەولێر	.hew.lêr
هەولێری	.hew.lê.rî
هەوڵ	.hewł
هەوڵدان	.hewł.dan
هەوڵی	.hew.łî
هەوڵیان	.hewł.yan
هەوڵێک	.hew.łêk
هەوڵێکی	.hew.łê.kî
هەوڵە	.hew.łe
هەوڵەکانی	.hew.łe.ka.nî
هەویستبووی	.he.wîs.ti.bûy
هەڕۆڵد	.he.řołd
هەڕەتی	.he.ře.tî
هەڕەتێک	.he.ře.têk
هەڕەتە	.he.ře.te
هەڕەتەشدا	.he.ře.teş.da
هەڕەشە	.he.ře.şe
هەڕەشەوگوڕەشەیە	.he.ře.şew.gu.ře.şe.ye
هەڕەشەی	.he.ře.şey
هەژار	.he.jar
هەژاری	.he.ja.rî
هەژاند	.he.jand
هەژمار	.hej.mar
هەڤالەکانی	.he.va.le.ka.nî
هەڤاڵ	.he.vał
هەڤاڵەکانیان	.he.va.łe.kan.yan
هەڤگرتنا	.hev.gir.ti.na
هەڤیارییەکان	.hev.ya.rî.ye.kan
هەڤیازییەکیان	.hev.ya.zî.yek.yan
هەڵ	.heł
هەڵاتم	.he.ła.tim
هەڵاتن	.he.ła.tin
هەڵاواردن	.he.ła.war.din
هەڵاوێر	.he.ła.wêr
هەڵبژارد	.heł.bi.jard
هەڵبژاردن	.heł.bi.jar.din
هەڵبژاردندا	.heł.bi.jar.din.da
هەڵبژاردنی	.heł.bi.jar.di.nî
هەڵبژاردنە	.heł.bi.jar.di.ne
هەڵبژاردنەکان	.heł.bi.jar.di.ne.kan
هەڵبژاردنەکانی	.heł.bi.jar.di.ne.ka.nî
هەڵبژاردە	.heł.bi.jar.de
هەڵبژاردەی	.heł.bi.jar.dey
هەڵبژێردراوانی	.heł.bi.jêr.di.ra.wa.nî
هەڵبژێردرێن	.heł.bi.jêr.di.rên
هەڵبگوێزدرێن	.heł.big.wêz.di.rên
هەڵبەت	.heł.bet
هەڵبەتە	.heł.be.te
هەڵبەست	.heł.best
هەڵبەستن	.heł.bes.tin
هەڵبەستی	.heł.bes.tî
هەڵبەستیش	.heł.bes.tîş
هەڵبەستێکی	.heł.bes.tê.kî
هەڵبەستەوە	.heł.bes.te.we
هەڵبەستەکان	.heł.bes.te.kan
هەڵبەستەکانم	.heł.bes.te.ka.nim
هەڵبەستەکانی	.heł.bes.te.ka.nî
هەڵبەستەکانیان	.heł.bes.te.kan.yan
هەڵدا	.heł.da
هەڵدەبژێردرێن	.heł.de.bi.jêr.di.rên
هەڵدەسەنگاند	.heł.de.sen.gand
هەڵدەکەوت	.heł.de.kewt
هەڵدەکەوێ	.heł.de.ke.wê
هەڵدەگرن	.heł.de.gi.rin
هەڵدەگوێزرانەوە	.heł.de.gwêz.ra.ne.we
هەڵدەگەڕێنەوە	.heł.de.ge.řê.ne.we
هەڵدەین	.heł.deyn
هەڵسوکەوت	.heł.su.kewt
هەڵسوکەوتی	.heł.su.kew.tî
هەڵسەنگاندن	.heł.sen.gan.din
هەڵسەنگاندنانە	.heł.sen.gan.di.na.ne
هەڵسەنگاندندا	.heł.sen.gan.din.da
هەڵسەنگاندنی	.heł.sen.gan.di.nî
هەڵسەنگێنین	.heł.sen.gê.nîn
هەڵسەنگێنێ	.heł.sen.gê.nê
هەڵمژینی	.heł.mi.jî.nî
هەڵمەت	.heł.met
هەڵمەتی	.heł.me.tî
هەڵمەتێکی	.heł.me.tê.kî
هەڵهرووژاندنی	.heł.hi.rû.jan.di.nî
هەڵویستیان	.heł.wîst.yan
هەڵوێست	.heł.wêst
هەڵوێستی	.heł.wês.tî
هەڵوێستێکی	.heł.wês.tê.kî
هەڵوێستە	.heł.wês.te
هەڵوەشاند	.heł.we.şand
هەڵوەشاندنەوەی	.heł.we.şan.di.ne.wey
هەڵوەشاندەوە	.heł.we.şan.de.we
هەڵوەشێندبایەوە	.heł.we.şên.di.ba.ye.we
هەڵوەشێندرا	.heł.we.şên.di.ra
هەڵوەشێنرا	.heł.we.şên.ra
هەڵپەڕکێیە	.heł.peř.kê.ye
هەڵکردووە	.heł.kir.du.we
هەڵکێشەوداکێشەیە	.heł.kê.şew.da.kê.şe.ye
هەڵکەوێ	.heł.ke.wê
هەڵگرت	.heł.girt
هەڵگرتنی	.heł.gir.ti.nî
هەڵگری	.heł.gi.rî
هەڵگواستوونەتەوە	.heł.gwas.tû.ne.te.we
هەڵگوێزانی	.heł.gwê.za.nî
هەڵگوێزراون	.heł.gwêz.ra.win
هەڵگوێسدراون	.heł.gwês.di.ra.win
هەڵگوێسرابوونەوە	.heł.gwês.ra.bû.ne.we
هەڵگەڕێنەوە	.heł.ge.řê.ne.we
هەڵۆ	.he.ło
هەڵیگواستە	.he.łî.gwas.te
هەڵە	.he.łe
هەڵەبجە	.he.łeb.ce
هەڵەبجەی	.he.łeb.cey
هەڵەی	.he.łey
هەڵەیە	.he.łe.ye
هەڵەیەکی	.he.łe.ye.kî
هەیانە	.he.ya.ne
هەینی	.hey.nî
هەیە	.he.ye
هەیەتی	.he.ye.tî
و	.we
وا	.wa
وابوو	.wa.bû
وابووە	.wa.bu.we
وابێ	.wa.bê
واتا	.wa.ta
واتای	.wa.tay
واتایەکی	.wa.ta.ye.kî
واتە	.wa.te
وادەکات	.wa.de.kat
وادەی	.wa.dey
واز	.waz
وازهێنانی	.waz.hê.na.nî
وازی	.wa.zî
وازیان	.waz.yan
واش	.waş
واشبکەن	.waş.bi.ken
واشنتن	.wa.şin.tin]
واشە	.wa.şe
واقیع	.wa.qîƹ
واقیعی	.wa.qî.ƹî
والت	.walt
والی	.wa.lî
وام	.wam
وامان	.wa.man
وان	.wan
وانە	.wa.ne
وانەی	.wa.ney
واژۆ	.wa.jo
واژۆکەرەکانی	.wa.jo.ke.re.ka.nî
وای	.way
وایان	.wa.yan
وایکرد	.way.kird
وایکردووە	.way.kir.du.we
وایە	.wa.ye
وتار	.wi.tar
وتارانە	.wi.ta.ra.ne
وتاری	.wi.ta.rî
وتارێکی	.wi.ta.rê.kî
وتارەکەیدا	.wi.ta.re.key.da
وتووێژ	.wi.tu.wêj
وتووێژم	.wi.tu.wê.jim
وتووێژی	.wi.tu.wê.jî
وتووێژەکانیان	.wi.tu.wê.je.kan.yan
وتویەتی	.wi.tu.ye.tî
وتیشیان	.wi.tîş.yan
وتەکانی	.wi.te.ka.nî
وتەی	.wi.tey
وتەیەکی	.wi.te.ye.kî
ورد	.wird
وردی	.wir.dî
وردە	.wir.de
ورمێ	.wir.mê
وریا	.wir.ya
وزە	.wi.ze
وزەی	.wi.zey
وشک	.wişk
وشیار	.wiş.yar
وشە	.wi.şe
وشەی	.wi.şey
ولاتی	.wi.la.tî
ولاتە	.wi.la.te
ولە	.wi.le
ون	.win
وڵات	.wi.łat
وڵاتان	.wi.ła.tan
وڵاتانی	.wi.ła.ta.nî
وڵاتانە	.wi.ła.ta.ne
وڵاتانەی	.wi.ła.ta.ney
وڵاتدا	.wi.łat.da
وڵاتی	.wi.ła.tî
وڵاتیش	.wi.ła.tîş
وڵاتێک	.wi.ła.têk
وڵاتێکی	.wi.ła.tê.kî
وڵاتە	.wi.ła.te
وڵاتەدا	.wi.ła.te.da
وڵاتەکان	.wi.ła.te.kan
وڵاتەکانی	.wi.ła.te.ka.nî
وڵاتەکەمان	.wi.ła.te.ke.man
وڵاتەکەی	.wi.ła.te.key
وڵاتەکەیان	.wi.ła.te.ke.yan
وڵاتەی	.wi.ła.tey
وڵام	.wi.łam
وڵامی	.wi.ła.mî
وڵامیان	.wi.łam.yan
وڵامێک	.wi.ła.mêk
وڵامەکانیان	.wi.ła.me.kan.yan
وڵامەکانیانە	.wi.ła.me.kan.ya.ne
وڵامەکەیدا	.wi.ła.me.key.da
وڵایەتە	.wi.ła.ye.te
وی	.wî
ویتمن	.wît.min
ویدا	.wî.da
ویست	.wîst
ویستت	.wîs.tit
ویستی	.wîs.tî
ویلایەتی	.wî.la.ye.tî
ویلایەتە	.wî.la.ye.te
ویلیام	.wîl.yam
ویژدانی	.wîj.da.nî
وێ	.wê
وێران	.wê.ran
وێرای	.wê.ray
وێستگەی	.wês.ti.gey
وێنە	.wê.ne
وێنەکان	.wê.ne.kan
وێنەکانی	.wê.ne.ka.nî
وێنەکە	.wê.ne.ke
وێنەگری	.wê.ne.gi.rî
وێنەی	.wê.ney
وێنەیە	.wê.ne.ye
وێنەیەکی	.wê.ne.ye.kî
وێنەیەکیان	.wê.ne.yek.yan
وێڕای	.wê.řay
وێژە	.wê.je
وێژەدا	.wê.je.da
وێژەی	.wê.jey
وێژەیەکی	.wê.je.ye.kî
وێکڕا	.wêk.řa
وە	.we
وەباڵی	.we.ba.łî
وەبیر	.we.bîr
وەبەرهێنان	.we.ber.hê.nan
وەبەرهێنانی	.we.ber.hê.na.nî
وەخوێننەوە	.we.xwê.ni.ne.we
وەدووی	.we.dûy
وەدەست	.we.dest
وەربگرن	.wer.big.rin
وەربگرین	.wer.big.rîn
وەربگرێت	.wer.bi.gi.rêt
وەربگیردرێ	.wer.bi.gîr.di.rê
وەربگیردرێت	.wer.bi.gîr.di.rêt
وەرد	.werd
وەردیانەکانی	.werd.ya.ne.ka.nî
وەردەگرت	.wer.de.girt
وەردەگرن	.wer.de.gi.rin
وەردەگرێ	.wer.de.gi.rê
وەردەگرێت	.wer.de.gi.rêt
وەردەگیرا	.wer.de.gî.ra
وەردەگیردرێ	.wer.de.gîr.di.rê
وەردەگێڕدرێنەوە	.wer.de.gêř.di.rê.ne.we
وەرزش	.wer.ziş
وەرزشی	.wer.zi.şî
وەرزی	.wer.zî
وەرناگرن	.wer.na.gi.rin
وەرناگیردرێ	.wer.na.gîr.di.rê
وەرنەگرتووە	.wer.ne.gir.tu.we
وەرگرت	.wer.girt
وەرگرتن	.wer.gir.tin
وەرگرتنی	.wer.gir.ti.nî
وەرگرتووە	.wer.gir.tu.we
وەرگرن	.wer.gi.rin
وەرگرێ	.wer.gi.rê
وەرگرەکانی	.wer.gi.re.ka.nî
وەرگیراوە	.wer.gî.ra.we
وەرگێر	.wer.gêr
وەرگێڕ	.wer.gêř
وەرگێڕان	.wer.gê.řan
وەرگێڕانی	.wer.gê.řa.nî
وەرگێڕانە	.wer.gê.řa.ne
وەرگێڕانەوە	.wer.gê.řa.ne.we
وەرگێڕاو	.wer.gê.řaw
وەرگێڕاوانێک	.wer.gê.řa.wa.nêk
وەرگێڕاوانە	.wer.gê.řa.wa.ne
وەرگێڕاوم	.wer.gê.řa.wim
وەرگێڕاونەتەوە	.wer.gê.řaw.ne.te.we
وەرگێڕاوی	.wer.gê.řa.wî
وەرگێڕاوێکی	.wer.gê.řa.wê.kî
وەرگێڕاوە	.wer.gê.řa.we
وەرگێڕاوەن	.wer.gê.řa.wen
وەرگێڕاوەکان	.wer.gê.řa.we.kan
وەرگێڕاوەکانیش	.wer.gê.řa.we.ka.nîş
وەرگێڕدرابوونەوە	.wer.gêř.di.ra.bû.ne.we
وەرگێڕدراونەتەوە	.wer.gêř.di.raw.ne.te.we
وەرگێڕی	.wer.gê.řî
وەرگێڕێتەوە	.wer.gê.řê.te.we
وەرگێڕێک	.wer.gê.řêk
وەرگێڕەکان	.wer.gê.ře.kan
وەرگێڕەکانی	.wer.gê.ře.ka.nî
وەرگێڕەکانیش	.wer.gê.ře.ka.nîş
وەرگێڕەکە	.wer.gê.ře.ke
وەرگێڕەکەی	.wer.gê.ře.key
وەرە	.we.re
وەزارەت	.we.za.ret
وەزارەتی	.we.za.re.tî
وەزارەتیش	.we.za.re.tîş
وەزارەتەوە	.we.za.re.te.we
وەزیر	.we.zîr
وەزیران	.we.zî.ran
وەزیرانی	.we.zî.ra.nî
وەزیری	.we.zî.rî
وەستا	.wes.ta
وەستان	.wes.tan
وەسف	.we.sif
وەسفی	.wes.fî
وەفدی	.wef.dî
وەفدێکی	.wef.dê.kî
وەلات	.we.lat
وەلی	.we.lî
وەنووسن	.we.nû.sin
وەها	.we.ha
وەک	.wek
وەکو	.we.ku
وەکوو	.we.kû
وەڵام	.we.łam
وەڵامی	.we.ła.mî
وەڵامێک	.we.ła.mêk
پ	.pi
پابەند	.pa.bend
پابەندی	.pa.ben.dî
پار	.par
پاراستن	.pa.ras.tin
پاراستنی	.pa.ras.ti.nî
پارت	.pa.rit
پارتی	.par.tî
پارتیا	.part.ya
پارتییە	.par.tî.ye
پارتە	.par.te
پارلەمانی	.par.le.ma.nî
پارچە	.par.çe
پارچەکانی	.par.çe.ka.nî
پارچەی	.par.çey
پارکی	.par.kî
پاریس	.pa.rîs
پارێزراو	.pa.rêz.raw
پارێزگا	.pa.rêz.ga
پارێزگادا	.pa.rêz.ga.da
پارێزگاری	.pa.rêz.ga.rî
پارێزگاکان	.pa.rêz.ga.kan
پارێزگاکانی	.pa.rêz.ga.ka.nî
پارێزگاکانیش	.pa.rêz.ga.ka.nîş
پارێزگای	.pa.rêz.gay
پارێزگایە	.pa.rêz.ga.ye
پارێزگایەدا	.pa.rêz.ga.ye.da
پارێزگایەدان	.pa.rêz.ga.ye.dan
پارێزەر	.pa.rê.zer
پارێزەری	.pa.rê.ze.rî
پارە	.pa.re
پارەداندا	.pa.re.dan.da
پارەش	.pa.reş
پارەشی	.pa.re.şî
پارەوە	.pa.re.we
پارەکە	.pa.re.ke
پارەکەی	.pa.re.key
پارەکەیان	.pa.re.ke.yan
پارەی	.pa.rey
پارەیان	.pa.re.yan
پارەیە	.pa.re.ye
پارەیەک	.pa.re.yek
پارەیەکی	.pa.re.ye.kî
پارەیەی	.pa.re.yey
پازدە	.paz.de
پاسا	.pa.sa
پاسداران	.pas.da.ran
پاسپۆرتیشیان	.pas.por.tîş.yan
پاسەوانی	.pa.se.wa.nî
پاش	.paş
پاشا	.pa.şa
پاشان	.pa.şan
پاشای	.pa.şay
پاشایەتی	.pa.şa.ye.tî
پاشتر	.paş.tir
پاشدا	.paş.da
پاشماوەکە	.paş.ma.we.ke
پاشماوەی	.paş.ma.wey
پاشەکشە	.pa.şek.şe
پاشەکشەی	.pa.şe.ki.şey
پالۆ	.pa.lo
پان	.pan
پانتایی	.pan.ta.yî
پاک	.pak
پاکستان	.pa.kis.tan
پاکی	.pa.kî
پاکەتی	.pa.ke.tî
پاڵ	.pał
پاڵپشتی	.pał.piş.tî
پاڵەوانی	.pa.łe.wa.nî
پاڵەوانێتی	.pa.łe.wa.nê.tî
پاڵەوانەکانی	.pa.łe.wa.ne.ka.nî
پایتەخت	.pay.text
پایتەختی	.pay.tex.tî
پایە	.pa.ye
پتر	.pi.tir
پتەو	.pi.tew
پتەوکردنی	.pi.tew.kir.di.nî
پر	.pir
پردی	.pir.dî
پرزەیان	.pir.ze.yan
پرس	.pirs
پرسی	.pir.sî
پرسیار	.pirs.yar
پرسیارانە	.pirs.ya.ra.ne
پرسیارکردن	.pirs.yar.kir.din
پرسیاری	.pirs.ya.rî
پرسیارێک	.pirs.ya.rêk
پرسیارێکی	.pirs.ya.rê.kî
پرسیارێکیان	.pirs.ya.rêk.yan
پرسیارە	.pirs.ya.re
پرسیارەتان	.pirs.ya.re.tan
پرسیارەکانی	.pirs.ya.re.ka.nî
پرسیبووم	.pir.sî.bûm
پرسیم	.pir.sîm
پرسێکی	.pir.sê.kî
پرسە	.pir.se
پرۆتۆکۆل	.pi.ro.to.kol
پرۆسە	.pi.ro.se
پرۆسەکە	.pi.ro.se.ke
پرۆسەی	.pi.ro.sey
پرۆسەیە	.pi.ro.se.ye
پرۆسەیەکی	.pi.ro.se.ye.kî
پرۆفیسۆر	.pi.ro.fî.sor
پرۆژەیەکی	.pi.ro.je.ye.kî
پرۆگرامانی	.pi.rog.ra.ma.nî
پرۆگرامی	.pi.rog.ra.mî
پرۆگرامە	.pi.rog.ra.me
پرۆگرامەکانیان	.pi.rog.ra.me.kan.yan
پرێس	.pi.rês
پزیشک	.pi.zîşk
پزیشکی	.pi.zîş.kî
پسپۆڕانە	.pis.po.řa.ne
پسپۆڕی	.pis.po.řî
پشت	.pişt
پشتسووریی	.pişt.sû.rîy
پشتگری	.pişt.gi.rî
پشتگریان	.pişt.gir.yan
پشتگرەکانیشیان	.pişt.gi.re.ka.nîş.yan
پشتگیری	.pişt.gî.rî
پشتگیریی	.piş.ti.gî.rîy
پشتی	.piş.tî
پشتیوانی	.piş.tî.wa.nî
پشتیوانیی	.piş.tî.wa.nîy
پشتیوانییان	.piş.tî.wa.nî.yan
پشتیوانییەک	.piş.tî.wa.nî.yek
پشکنیمی	.piş.ki.nî.mî
پشکنین	.piş.ki.nîn
پشکنینی	.piş.ki.nî.nî
پشکی	.piş.kî
پلان	.pi.lan
پلانی	.pi.la.nî
پلانێکی	.pi.la.nê.kî
پلکەتی	.pil.ke.tî
پلە	.pi.le
پلەوپایەی	.pi.lew.pa.yey
پلەوپایەیەکی	.pi.lew.pa.ye.ye.kî
پلەوپایەیەکیان	.pi.lew.pa.ye.yek.yan
پلەی	.pi.ley
پوور	.pûr
پوول	.pûl
پڕ	.piř
پڕبایەخترین	.piř.ba.yex.ti.rîn
پڕبکەنەوە	.piř.bi.ke.ne.we
پڕچاودێری	.piř.çaw.dê.rî
پڕۆسەی	.pi.řo.sey
پڕۆژە	.pi.řo.je
پڕۆژەکان	.pi.řo.je.kan
پڕۆژەکە	.pi.řo.je.ke
پڕۆژەی	.pi.řo.jey
پڕۆژەیە	.pi.řo.je.ye
پڕۆژەیەکی	.pi.řo.je.ye.kî
پڕە	.pi.ře
پژاک	.pi.jak
پۆست	.post
پۆستکراوەگەلێک	.post.ki.ra.we.ge.lêk
پۆستی	.pos.tî
پۆستیی	.pos.tîy
پۆستە	.pos.te
پۆستەری	.pos.te.rî
پۆستەوە	.pos.te.we
پۆستەکەدا	.pos.te.ke.da
پۆل	.pol
پۆلانە	.po.la.ne
پۆلی	.po.lî
پۆلیس	.po.lîs
پۆلیسان	.po.lî.san
پۆلیسدا	.po.lîs.da
پۆلیسی	.po.lî.sî
پۆلیسەوە	.po.lî.se.we
پۆلیسەکان	.po.lî.se.kan
پۆلەکانی	.po.le.ka.nî
پی	.pî
پیادە	.pya.de
پیاو	.pyaw
پیاوان	.pya.wan
پیاوانی	.pya.wa.nî
پیاوچاکییەوە	.pyaw.ça.kî.ye.we
پیاوی	.pya.wî
پیاوێک	.pya.wêk
پیاوێکی	.pya.wê.kî
پیاوە	.pya.we
پیر	.pîr
پیرۆز	.pî.roz
پیرۆزبایی	.pî.roz.ba.yî
پیرۆزی	.pî.ro.zî
پیرۆزە	.pî.ro.ze
پیری	.pî.rî
پیرە	.pî.re
پیرەمێرد	.pî.re.mêrd
پیس	.pîs
پیشان	.pî.şan
پیشکەوتنی	.pîş.kew.ti.nî
پیشە	.pî.şe
پیشەسازی	.pî.şe.sa.zî
پیشەی	.pî.şey
پیشەیی	.pî.şe.yî
پیشەیە	.pî.şe.ye
پیشەیەک	.pî.şe.yek
پیشەیەکی	.pî.şe.ye.kî
پیلان	.pî.lan
پیلانی	.pî.la.nî
پیلانێکی	.pî.la.nê.kî
پیلانەکان	.pî.la.ne.kan
پینتر	.pîn.tir
پینتێر	.pîn.têr
پێ	.pê
پێئەسپێردرا	.pê.ʔes.pêr.di.ra
پێبدرێ	.pê.bi.di.rê
پێت	.pêt
پێدا	.pê.da
پێدانی	.pê.da.nî
پێداهەڵگوتنەوەی	.pê.da.heł.gu.ti.ne.wey
پێداویستی	.pê.da.wîs.tî
پێداویستیگەلە	.pê.da.wîs.tî.ge.le
پێداویستیی	.pê.da.wîs.tîy
پێداویستییەکان	.pê.da.wîs.tî.ye.kan
پێداویستییەکانی	.pê.da.wîs.tî.ye.ka.nî
پێداچوونەوە	.pê.da.çû.ne.we
پێداچوونەوەکان	.pê.da.çû.ne.we.kan
پێداچوونەوەکانی	.pê.da.çû.ne.we.ka.nî
پێداچوونەوەی	.pê.da.çû.ne.wey
پێداچوونەوەیەکی	.pê.da.çû.ne.we.ye.kî
پێداگری	.pê.da.gi.rî
پێدراوە	.pê.di.ra.we
پێدەچێت	.pê.de.çêt
پێدەکات	.pê.de.kat
پێدەکرێت	.pê.de.ki.rêt
پێری	.pê.rî
پێزانین	.pê.za.nîn
پێست	.pêst
پێستی	.pês.tî
پێش	.pêş
پێشان	.pê.şan
پێشانگا	.pê.şan.ga
پێشانگاکان	.pê.şan.ga.kan
پێشانگاکانی	.pê.şan.ga.ka.nî
پێشانگاکە	.pê.şan.ga.ke
پێشانگاکەدا	.pê.şan.ga.ke.da
پێشانگاکەیان	.pê.şan.ga.ke.yan
پێشانگاگەلی	.pê.şan.ga.ge.lî
پێشانگای	.pê.şan.gay
پێشانگایەدا	.pê.şan.ga.ye.da
پێشانگایەک	.pê.şan.ga.yek
پێشانگایەکی	.pê.şan.ga.ye.kî
پێشانگەکاندا	.pê.şan.ge.kan.da
پێشبرد	.pêş.bird
پێشبڕکێی	.pêş.biř.kêy
پێشبینی	.pêş.bî.nî
پێشتر	.pêş.tir
پێشتریش	.pêş.ti.rîş
پێشخستن	.pêş.xis.tin
پێشخستنی	.pêş.xis.ti.nî
پێشقوتابی	.pêş.qu.ta.bî
پێشمەرگە	.pêş.mer.ge
پێشمەرگەکانی	.pêş.mer.ge.ka.nî
پێشمەرگەی	.pêş.mer.gey
پێشنیار	.pêş.nyar
پێشنیاری	.pêş.nya.rî,[.pêş.nya.rî]
پێشنیاریان	.pêş.nyar.yan
پێشنیارە	.pêş.nya.re
پێشنیازی	[.pêş.nya.zî]
پێشوازی	.pêş.wa.zî
پێشوازیی	.pêş.wa.zîy
پێشوو	.pê.şû
پێشووی	.pê.şûy
پێشووەکان	.pê.şu.we.kan
پێشووەکاندا	.pê.şu.we.kan.da
پێشوی	.pêş.wî
پێشکەش	.pêş.keş
پێشکەشکردنی	.pêş.keş.kir.di.nî
پێشکەشی	.pêş.ke.şî
پێشکەفتن	.pêş.kef.tin
پێشکەوتن	.pêş.kew.tin
پێشکەوتنی	.pêş.kew.ti.nî
پێشکەوتنێکی	.pêş.kew.ti.nê.kî
پێشکەوتوو	.pêş.kew.tû
پێشکەوتووییی	.pêş.kew.tû.yîy
پێشگری	.pêş.gi.rî
پێشگرییان	.pêş.gi.rî.yan
پێشگرییە	.pêş.gi.rî.ye
پێشگرییەکان	.pêş.gi.rî.ye.kan
پێشگرییەکانیش	.pêş.gi.rî.ye.ka.nîş
پێشگیراو	.pêş.gî.raw
پێشی	.pê.şî
پێشینەی	.pê.şî.ney
پێشێ	.pê.şê
پێشێل	.pê.şêl
پێشێلکردنی	.pê.şêl.kir.di.nî
پێشەنگی	.pê.şen.gî
پێشەوا	.pê.şe.wa
پێشەوە	.pê.şe.we
پێشەوەی	.pê.şe.wey
پێشەکی	.pê.şe.kî
پێغەمبەر	.pê.ẍem.ber
پێغەمبەری	.pê.ẍem.be.rî
پێم	.pêm
پێمان	.pê.man
پێموایە	.pêm.wa.ye
پێناس	.pê.nas
پێناسە	.pê.na.se
پێناسەکانی	.pê.na.se.ka.nî
پێناسەی	.pê.na.sey
پێناو	.pê.naw
پێناوی	.pê.na.wî
پێنج	.pênc
پێنجشەممە	.pênc.şem.me
پێنجەم	.pên.cem
پێنووس	.pê.nûs
پێنووسان	.pê.nû.san
پێنەدەدرا	.pê.ne.de.di.ra
پێهات	.pê.hat
پێویست	.pê.wîst
پێویستمان	.pê.wîst.man
پێویستن	.pê.wîs.tin
پێویستی	.pê.wîs.tî
پێویستیان	.pê.wîst.yan
پێویستیی	.pê.wîs.tîy
پێویستە	.pê.wîs.te
پێوە	.pê.we
پێوەری	.pê.we.rî
پێوەندیی	.pê.wen.dîy
پێوەندییە	.pê.wen.dî.ye
پێچ	.pêç
پێچەوانە	.pê.çe.wa.ne
پێچەوانەوە	.pê.çe.wa.ne.we
پێچەوانەی	.pê.çe.wa.ney
پێڕست	.pê.řist
پێک	.pêk
پێکدادان	.pêk.da.dan
پێکدادانی	.pêk.da.da.nî
پێکدێن	.pêk.dên
پێکراوەکان	.pê.ki.ra.we.kan
پێکرد	.pê.kird
پێکردنی	.pê.kir.di.nî
پێکردووە	.pê.kir.du.we
پێکهاتنامەکان	.pêk.hat.na.me.kan
پێکهاتنی	.pêk.ha.ti.nî
پێکهاتوو	.pêk.ha.tû
پێکهاتووە	.pêk.ha.tu.we
پێکهاتە	.pêk.ha.te
پێکهاتەکانی	.pêk.ha.te.ka.nî
پێکهاتەی	.pêk.ha.tey
پێکهاتەیەکی	.pêk.ha.te.ye.kî
پێکهێنا	.pêk.hê.na
پێکهێنانی	.pêk.hê.na.nî
پێکەنین	.pê.ke.nîn
پێکەوە	.pê.ke.we
پێکەوەییگەلی	.pê.ke.we.yî.ge.lî
پێگرتن	.pê.gir.tin
پێگە	.pê.ge
پێگەی	.pê.gey
پێگەیەکی	.pê.ge.ye.kî
پێی	.pêy
پێیان	.pê.yan
پێیدابڕۆنەوە	.pêy.da.bi.řo.ne.we
پێیوایە	.pêy.wa.ye
پێیە	.pê.ye
پێیەی	.pê.yey
پە	.pe
پەخش	.pe.xiş
پەخشانی	.pex.şa.nî
پەخشی	.pex.şî
پەراوێز	.pe.ra.wêz
پەرتووکان	.per.tû.kan
پەرتووکەکانیشی	.per.tû.ke.ka.nî.şî
پەردە	.per.de
پەردەژییان	.per.de.jî.yan
پەردەی	.per.dey
پەرلەمان	.per.le.man
پەرلەمانتار	.per.le.man.tar
پەرلەمانتاران	.per.le.man.ta.ran
پەرلەمانتارانی	.per.le.man.ta.ra.nî
پەرلەمانتاری	.per.le.man.ta.rî
پەرلەماندا	.per.le.man.da
پەرلەمانی	.per.le.ma.nî
پەروەردە	.per.wer.de
پەروەردەی	.per.wer.dey
پەروەردەیی	.per.wer.de.yî
پەرۆشیی	.pe.ro.şîy
پەرە	.pe.re
پەرەئەستێنی	.pe.re.ʔes.tê.nî
پەرەبستێنێ	.pe.re.bis.tê.nê
پەرەستاندنی	.pe.res.tan.di.nî
پەرەسەندنی	.pe.re.sen.di.nî
پەرەپێدانی	.pe.re.pê.da.nî
پەرەی	.pe.rey
پەستابەپەستا	.pes.ta.be.pes.ta
پەسەند	.pe.send
پەسەندکردنی	.pe.send.kir.di.nî,.pe.send.kird.nî
پەشیمان	.pe.şî.man
پەشێو	.pe.şêw
پەلاماری	.pe.la.ma.rî
پەلە	.pe.le
پەلەی	.pe.ley
پەنا	.pe.na
پەنابەران	.pe.na.be.ran
پەنابەرانی	.pe.na.be.ra.nî
پەنای	.pe.nay
پەنجا	.pen.ca
پەنجەرە	.pen.ce.re
پەنجەی	.pen.cey
پەو	.pew
پەوند	.pewnd
پەڕ	.peř
پەڕانپەڕی	.pe.řan.pe.řî
پەڕتووکنامەگەلی	.peř.tûk.na.me.ge.lî
پەڕتووکنامەی	.peř.tûk.na.mey
پەڕتووکنامەیەک	.peř.tûk.na.me.yek
پەڕتووکی	.peř.tû.kî
پەڕتووکە	.peř.tû.ke
پەڕتووکەکانی	.peř.tû.ke.ka.nî
پەڕتووکەکەیان	.peř.tû.ke.ke.yan
پەڕی	.pe.řî
پەکیان	.pek.yan
پەکەکە	.pe.ke.ke
پەڵپێکە	.peł.pê.ke
پەیام	.pe.yam
پەیامنێر	.pe.yam.nêr
پەیامنێری	.pe.yam.nê.rî
پەیامی	.pe.ya.mî
پەیامێکی	.pe.ya.mê.kî
پەیدا	.pey.da
پەیمانشکێنی	.pey.man.şi.kê.nî
پەیماننامەی	.pey.man.na.mey
پەیمانگای	.pey.man.gay
پەیمانی	.pey.ma.nî
پەیوەست	.pey.west
پەیوەستە	.pey.wes.te
پەیوەندی	.pey.wen.dî
پەیوەندیان	.pey.wend.yan
پەیوەندیدا	.pey.wen.dî.da
پەیوەندیدار	.pey.wen.dî.dar
پەیوەندیدارەکان	.pey.wen.dî.da.re.kan
پەیوەندیی	.pey.wen.dîy
پەیوەندییان	.pey.wen.dî.yan
پەیوەندییە	.pey.wen.dî.ye
پەیوەندییەدا	.pey.wen.dî.ye.da
پەیوەندییەکان	.pey.wen.dî.ye.kan
پەیوەندییەکانی	.pey.wen.dî.ye.ka.nî
پەیوەندییەکی	.pey.wen.dî.ye.kî
پەیوەندییەکیان	.pey.wen.dî.yek.yan
پەیوەندیەکانی	.pey.wend.ye.ka.nî
پەیڕەو	.pey.řew
پەیڕەوی	.pey.ře.wî
پەیڤین	.pey.vîn
پەیکەری	.pey.ke.rî
پەیەدە	.pe.ye.de
چ	.çi
چاتر	.ça.tir
چارسانجاک	.çar.san.cak
چارە	.ça.re
چارەدیتنەوەیەکی	.ça.re.dî.ti.ne.we.ye.kî
چارەسەر	.ça.re.ser
چارەسەرکران	.ça.re.ser.ki.ran
چارەسەرکردنی	.ça.re.ser.kir.di.nî
چارەسەری	.ça.re.se.rî
چارەنوسی	.ça.re.nu.sî
چارەنووس	.ça.re.nûs
چارەنووسی	.ça.re.nû.sî
چارەی	.ça.rey
چالاک	.ça.lak
چالاکانی	.ça.la.ka.nî
چالاکوانی	.ça.lak.wa.nî
چالاکی	.ça.la.kî
چالاکیگەلێک	.ça.la.kî.ge.lêk
چالاکیی	.ça.la.kîy
چالاکییان	.ça.la.kî.yan
چالاکییە	.ça.la.kî.ye
چالاکییەک	.ça.la.kî.yek
چالاکییەکانی	.ça.la.kî.ye.ka.nî
چالاکییەکانیان	.ça.la.kî.ye.kan.yan
چاند	.çand
چاو	.çaw
چاودێرانی	.çaw.dê.ra.nî
چاودێری	.çaw.dê.rî
چاودێریی	.çaw.dê.rîy
چاودێرییەک	.çaw.dê.rî.yek
چاودێرییەکان	.çaw.dê.rî.ye.kan
چاودێرەکانی	.çaw.dê.re.ka.nî
چاوم	.ça.wim
چاوپێکەوتن	.çaw.pê.kew.tin
چاوپێکەوتنێکم	.çaw.pê.kew.ti.nê.kim
چاوپێکەوتنەکان	.çaw.pê.kew.ti.ne.kan
چاوپێکەوتنەکانی	.çaw.pê.kew.ti.ne.ka.nî
چاوی	.ça.wî
چاویان	.çaw.yan
چاوێکی	.ça.wê.kî
چاوە	.ça.we
چاوەنواڕین	.ça.wen.wa.řîn
چاوەڕوان	.ça.we.řwan
چاوەڕوانی	.ça.weř.wa.nî,.ça.we.řwa.nî
چاوەڕوانیی	.ça.weř.wa.nîy
چاوەڕێ	.ça.we.řê
چاوەڕێی	.ça.we.řêy
چاوەکانی	.ça.we.ka.nî
چاپ	.çap
چاپخانە	.çap.xa.ne
چاپخانەوە	.çap.xa.ne.we
چاپخانەکان	.çap.xa.ne.kan
چاپخانەکاندا	.çap.xa.ne.kan.da
چاپخانەکانی	.çap.xa.ne.ka.nî
چاپخانەکە	.çap.xa.ne.ke
چاپخانەکەشیاندا	.çap.xa.ne.keş.yan.da
چاپخانەکەی	.çap.xa.ne.key
چاپخانەکەیان	.çap.xa.ne.ke.yan
چاپخانەگەلی	.çap.xa.ne.ge.lî
چاپخانەگەلێک	.çap.xa.ne.ge.lêk
چاپخانەگەلێکی	.çap.xa.ne.ge.lê.kî
چاپخانەگەلێکیان	.çap.xa.ne.ge.lêk.yan
چاپخانەگەلە	.çap.xa.ne.ge.le
چاپخانەگەلەم	.çap.xa.ne.ge.lem
چاپخانەی	.çap.xa.ney
چاپخانەیانە	.çap.xa.ne.ya.ne
چاپخانەیە	.çap.xa.ne.ye
چاپخانەیەدا	.çap.xa.ne.ye.da
چاپخانەیەک	.çap.xa.ne.yek
چاپخانەیەکی	.çap.xa.ne.ye.kî
چاپخانەیەکیان	.çap.xa.ne.yek.yan
چاپخەگەلە	.çap.xe.ge.le
چاپدا	.çap.da
چاپدان	.çap.dan
چاپدانی	.çap.da.nî
چاپدانیان	.çap.dan.yan
چاپدران	.çap.di.ran
چاپدەدران	.çap.de.di.ran
چاپدەرەکان	.çap.de.re.kan
چاپدەکرێ	.çap.de.ki.rê
چاپکران	.çap.ki.ran
چاپکراو	.çap.ki.raw
چاپکراویان	.çap.ki.raw.yan
چاپکراوە	.çap.ki.ra.we
چاپکراوەکان	.çap.ki.ra.we.kan
چاپکراوەکانی	.çap.ki.ra.we.ka.nî
چاپکراوەکانیان	.çap.ki.ra.we.kan.yan
چاپکراوەکانیش	.çap.ki.ra.we.ka.nîş
چاپکراوەگەلەدا	.çap.ki.ra.we.ge.le.da
چاپکراوەیان	.çap.ki.ra.we.yan
چاپکراوەیەکی	.çap.ki.ra.we.ye.kî
چاپکردن	.çap.kir.din
چاپکردنیدا	.çap.kir.di.nî.da
چاپکەرە	.çap.ke.re
چاپی	.ça.pî
چاپیش	.ça.pîş
چاپەمەنی	.ça.pe.me.nî
چاپەمەنیش	.ça.pe.me.nîş
چاپەمەنیگەلێک	.ça.pe.me.nî.ge.lêk
چاپەمەنیگەلە	.ça.pe.me.nî.ge.le
چاپەمەنیی	.ça.pe.me.nîy
چاپەمەنییە	.ça.pe.me.nî.ye
چاپەمەنییەوە	.ça.pe.me.nî.ye.we
چاپەمەنییەکان	.ça.pe.me.nî.ye.kan
چاپەمەنییەکاندا	.ça.pe.me.nî.ye.kan.da
چاپەمەنییەکانی	.ça.pe.me.nî.ye.ka.nî
چاپەکە	.ça.pe.ke
چاک	.çak
چاکردنەوەی	.ça.kir.di.ne.wey
چاکسازی	.çak.sa.zî
چاکسازیی	.çak.sa.zîy
چاکی	.ça.kî
چاکیشیان	.ça.kîş.yan
چاکە	.ça.ke
چل	.çil
چم	.çim
چمک	.çimk
چوار	.çwar
چوارشەممە	.çwar.şem.me
چوارچێوەی	.çwar.çê.wey
چوارچێوەیەدا	.çwar.çê.we.ye.da
چواری	.çwa.rî
چوارەم	.çwa.rem
چوارەمی	.çwa.re.mî
چوارەمین	.çwa.re.mîn
چوارەمییەکەش	.çwa.re.mî.ye.keş
چون	.çun
چونکە	.çun.ke
چوو	.çû
چوون	.çûn
چوونکینێ	.çûn.kî.nê
چوونکە	.çûn.ke
چوونی	.çû.nî
چوونە	.çû.ne
چوونەوەیە	.çû.ne.we.ye
چووکی	.çû.kî
چووە	.çu.we
چووەتە	.çu.we.te
چڕ	.çiř
چڕەکەیان	.çi.ře.ke.yan
چکۆلە	.çi.ko.le
چۆتە	.ço.te
چۆمان	.ço.man
چۆن	.çon
چۆناوچۆن	.ço.naw.çon
چۆنایەتیی	.ço.na.ye.tîy
چۆنیەتی	.çon.ye.tî
چۆنە	.ço.ne
چۆڵ	.çoł
چۆڵەپێچەی	.ço.łe.pê.çey
چی	.çî
چیا	.çya
چیای	.çyay
چیایێ	.çya.yê
چیتر	.çî.tir
چیخۆف	.çî.xof
چیدی	.çî.dî
چیدیکە	.çî.dî.ke
چیرۆک	.çî.rok
چیرۆکان	.çî.ro.kan
چیرۆکدا	.çî.rok.da
چیرۆکی	.çî.ro.kî
چیرۆکە	.çî.ro.ke
چیرۆکەکان	.çî.ro.ke.kan
چین	.çîn
چینایەتی	.çî.na.ye.tî
چینی	.çî.nî
چینە	.çî.ne
چینەکانی	.çî.ne.ka.nî
چییان	.çî.yan
چییە	.çî.ye
چێ	.çê
چێرمک	.çê.rimk
چێچێنەکان	.çê.çê.ne.kan
چێژ	.çêj
چێژی	.çê.jî
چێڵسی	.çêł.sî
چەتوونە	.çe.tû.ne
چەتەکان	.çe.te.kan
چەتەکانی	.çe.te.ka.nî
چەسپاندنی	.çes.pan.di.nî
چەشنانی	.çeş.na.nî
چەشنگەلێکی	.çe.şin.ge.lê.kî
چەشنی	.çeş.nî
چەشنێک	.çeş.nêk
چەشنێکی	.çeş.nê.kî
چەشنە	.çeş.ne
چەقڵ	.çe.qił
چەلەبی	.çe.le.bî
چەمچەماڵ	.çem.çe.mał
چەمکی	.çem.kî
چەمکە	.çem.ke
چەمیشگەزەک	.çe.mîş.ge.zek
چەن	.çen
چەند	.çend
چەندان	.çen.dan
چەندین	.çen.dîn
چەندە	.çen.de
چەندەها	.çen.de.ha
چەنێتییە	.çe.nê.tî.ye
چەوساندنەوە	.çew.san.di.ne.we
چەوساندنەوەیە	.çew.san.di.ne.we.ye
چەوسانەوە	.çew.sa.ne.we
چەوسانەوەی	.çew.sa.ne.wey
چەپ	.çep
چەپڕەوە	.çep.ře.we
چەپڕەوەکانیش	.çep.ře.we.ka.nîş
چەپۆکی	.çe.po.kî
چەپی	.çe.pî
چەڤلیک	.çev.lîk
چەڤلیکیش	.çev.lî.kîş
چەک	.çek
چەکدار	.çek.dar
چەکدارانی	.çek.da.ra.nî
چەکداری	.çek.da.rî
چەکدارە	.çek.da.re
چەکدارەکان	.çek.da.re.kan
چەکدارەکانی	.çek.da.re.ka.nî
چەکم	.çe.kim
چەکی	.çe.kî
چەکێک	.çe.kêk
چەکە	.çe.ke
چەڵەمە	.çe.łe.me
چەڵەمەدا	.çe.łe.me.da
چەڵەمەکان	.çe.łe.me.kan
چەڵەمەکانیان	.çe.łe.me.kan.yan
چەڵەمەگەلە	.çe.łe.me.ge.le
چەڵەمەیەشدا	.çe.łe.me.yeş.da
چەڵەمەیەوە	.çe.łe.me.ye.we
چەڵەمەیەکی	.çe.łe.me.ye.kî
ڕا	.řa
ڕابردوو	.řa.bir.dû
ڕابردوودا	.řa.bir.dû.da
ڕابردووی	.řa.bir.dûy
ڕابگرێت	.řa.big.rêt
ڕابێرت	.řa.bêrt
ڕادیۆ	.řad.yo
ڕادیۆی	.řad.yoy
ڕادەربڕین	.řa.der.bi.řîn
ڕادەستی	.řa.des.tî
ڕادەی	.řa.dey
ڕادەیەک	.řa.de.yek
ڕادەیەکی	.řa.de.ye.kî
ڕازی	.řa.zî
ڕاست	.řast
ڕاستی	.řas.tî
ڕاستیدا	.řas.tî.da
ڕاستییە	.řas.tî.ye
ڕاستییەکان	.řas.tî.ye.kan
ڕاستیە	.řast.ye
ڕاستە	.řas.te
ڕاستەقینە	.řas.te.qî.ne
ڕاستەقینەی	.řas.te.qî.ney
ڕاستەوخۆ	.řas.tew.xo
ڕاستەوخۆی	.řas.tew.xoy
ڕاشکاوانە	.řa.şi.ka.wa.ne
ڕاشیگەیاند	.řa.şî.ge.yand
ڕانیە	.řan.ye
ڕانەگەیشتنەکان	.řa.ne.geyş.ti.ne.kan
ڕانەگەیەندراوی	.řa.ne.ge.yen.di.ra.wî
ڕاهێنان	.řa.hê.nan
ڕاهێنانی	.řa.hê.na.nî
ڕاهێنەر	.řa.hê.ner
ڕاهێنەری	.řa.hê.ne.rî
ڕاو	.řaw
ڕاوێژکاری	.řa.wêj.ka.rî
ڕاپرسی	.řa.pir.sî
ڕاپۆرت	.řa.port
ڕاپۆرتی	.řa.por.tî
ڕاپۆرتێکی	.řa.por.tê.kî
ڕاپۆرتە	.řa.por.te
ڕاپۆرتەکە	.řa.por.te.ke
ڕاپەڕین	.řa.pe.řîn
ڕاپەڕینی	.řa.pe.řî.nî
ڕاکێشانی	.řa.kê.şa.nî
ڕاگرتنی	.řa.gir.ti.nî
ڕاگەیاند	.řa.ge.yand
ڕاگەیاندن	.řa.ge.yan.din
ڕاگەیاندنی	.řa.ge.yan.di.nî
ڕاگەیاندووە	.řa.ge.yan.du.we
ڕاگەیەندرا	.řa.ge.yen.di.ra
ڕاگەیەنرا	.řa.ge.yen.ra
ڕای	.řay
ڕایانگەیاند	.řa.yan.ge.yand
ڕایانگەیاندووە	.řa.yan.ge.yan.du.we
ڕایدەگەیەنێت	.řay.de.ge.ye.nêt
ڕایگەیاند	.řay.ge.yand
ڕایگەیاندبوو	.řay.ge.yan.di.bû
ڕایگەیاندووە	.řay.ge.yan.du.we
ڕزگار	.řiz.gar
ڕزگارکردنی	.řiz.gar.kir.di.nî
ڕزگاری	.řiz.ga.rî
ڕفیق	.ři.fîq
ڕق	.řiq
ڕوانگەی	.řwan.gey
ڕوخانی	.řu.xa.nî
ڕوخساری	.řux.sa.rî
ڕوسیا	.řus.ya
ڕوو	.řû
ڕووباری	.řû.ba.rî
ڕووبەرووی	.řû.be.rûy
ڕووبەری	.řû.be.rî
ڕووبەڕوو	.řû.be.řû
ڕووبەڕووبوونەوەی	.řû.be.řû.bû.ne.wey
ڕووبەڕووی	.řû.be.řûy
ڕووت	.řût
ڕووخانی	.řû.xa.nî
ڕوودانی	.řû.da.nî
ڕووداو	.řû.daw
ڕووداوانە	.řû.da.wa.ne
ڕووداوی	.řû.da.wî
ڕووداوێکی	.řû.da.wê.kî
ڕووداوە	.řû.da.we
ڕووداوەکان	.řû.da.we.kan
ڕووداوەکانی	.řû.da.we.ka.nî
ڕووداوەکە	.řû.da.we.ke
ڕوودەدات	.řû.de.dat
ڕووسی	.řû.sî
ڕووسیا	.řûs.ya
ڕوون	.řûn
ڕووناک	.řû.nak
ڕووناکی	.řû.na.kî
ڕوونکردنەوەی	.řûn.kir.di.ne.wey
ڕوونکردەوە	.řûn.kir.de.we
ڕوونی	.řû.nî
ڕوونیشیکردەوە	.řû.nî.şî.kir.de.we
ڕوونیکردەوە	.řû.nî.kir.de.we
ڕوونە	.řû.ne
ڕووی	.řûy
ڕوویان	.řû.yan
ڕوویدا	.řûy.da
ڕوویداوە	.řûy.da.we
ڕووەوە	.řu.we.we
ڕژێم	.ři.jêm
ڕژێمی	.ři.jê.mî
ڕژێمە	.ři.jê.me
ڕکابەری	.ři.ka.be.rî
ڕۆح	.řoḧ
ڕۆحانی	.řo.ḧa.nî
ڕۆحی	.řo.ḧî
ڕۆشنایی	.řoş.na.yî
ڕۆشنبیر	.řo.şin.bîr
ڕۆشنبیران	.řo.şin.bî.ran
ڕۆشنبیری	.řo.şin.bî.rî
ڕۆشنبیریی	.řo.şin.bî.rîy
ڕۆم	.řom
ڕۆما	.řo.ma
ڕۆمان	.řo.man
ڕۆمانی	.řo.ma.nî
ڕۆمانە	.řo.ma.ne
ڕۆناڵدۆ	.řo.nał.do
ڕۆژ	.řoj
ڕۆژئاوا	.řoj.ʔa.wa
ڕۆژئاوادا	.řoj.ʔa.wa.da
ڕۆژئاواش	.řoj.ʔa.waş
ڕۆژئاوای	.řoj.ʔa.way
ڕۆژئاوایی	.řoj.ʔa.wa.yî
ڕۆژان	.řo.jan
ڕۆژانی	.řo.ja.nî
ڕۆژانە	.řo.ja.ne
ڕۆژانەی	.řo.ja.ney
ڕۆژدا	.řoj.da
ڕۆژنامە	.řoj.na.me
ڕۆژنامەنوس	.řoj.na.me.nus
ڕۆژنامەنوسان	.řoj.na.me.nu.san
ڕۆژنامەنووس	.řoj.na.me.nûs
ڕۆژنامەنووسان	.řoj.na.me.nû.san
ڕۆژنامەنووسانی	.řoj.na.me.nû.sa.nî
ڕۆژنامەنووسی	.řoj.na.me.nû.sî
ڕۆژنامەوانی	.řoj.na.me.wa.nî
ڕۆژنامەوانیدا	.řoj.na.me.wa.nî.da
ڕۆژنامەکە	.řoj.na.me.ke
ڕۆژنامەگەری	.řoj.na.me.ge.rî
ڕۆژنامەی	.řoj.na.mey
ڕۆژهەلاتی	.řoj.he.la.tî
ڕۆژهەڵات	.řoj.he.łat
ڕۆژهەڵاتی	.řoj.he.ła.tî
ڕۆژی	.řo.jî
ڕۆژێ	.řo.jê
ڕۆژێک	.řo.jêk
ڕۆژێکی	.řo.jê.kî
ڕۆژە	.řo.je
ڕۆژەدا	.řo.je.da
ڕۆژەی	.řo.jey
ڕۆڵ	.řoł
ڕۆڵی	.řo.łî
ڕۆڵێکی	.řo.łê.kî
ڕۆڵە	.řo.łe
ڕۆڵەکانی	.řo.łe.ka.nî
ڕۆڵەی	.řo.łey
ڕۆیتەرز	.řoy.terz
ڕۆیشت	.řo.yişt
ڕۆیشتن	.řoyş.tin
ڕی	.řî
ڕیاڵ	.řyał
ڕیز	.řîz
ڕیزبەندی	.řîz.ben.dî
ڕیزی	.řî.zî
ڕیزەکانی	.řî.ze.ka.nî
ڕێ	.řê
ڕێبازی	.řê.ba.zî
ڕێبوار	.řê.bwar
ڕێبین	.řê.bîn
ڕێبەر	.řê.ber
ڕێبەرانی	.řê.be.ra.nî
ڕێبەرایەتی	.řê.be.ra.ye.tî
ڕێبەری	.řê.be.rî
ڕێز	.řêz
ڕێزلێنان	.řêz.lê.nan
ڕێزگرتن	.řêz.gir.tin
ڕێزی	.řê.zî
ڕێنمایی	.řê.ni.ma.yî
ڕێوشوێنی	.řêw.şwê.nî
ڕێوڕەسمی	.řêw.řes.mî
ڕێپێدران	.řê.pê.di.ran
ڕێژوان	.řêj.wan
ڕێژیم	.řê.jîm
ڕێژیمی	.řê.jî.mî
ڕێژەی	.řê.jey
ڕێژەیە	.řê.je.ye
ڕێژەیەکی	.řê.je.ye.kî
ڕێک	.řêk
ڕێکخراو	.řêk.xi.raw
ڕێکخراوی	.řêk.xi.ra.wî
ڕێکخراوێکی	.řêk.xi.ra.wê.kî
ڕێکخراوە	.řêk.xi.ra.we
ڕێکخراوەکان	.řêk.xi.ra.we.kan
ڕێکخراوەکانی	.řêk.xi.ra.we.ka.nî
ڕێکخراوەیی	.řêk.xi.ra.we.yî
ڕێکخستن	.řêk.xis.tin
ڕێکخستنی	.řêk.xis.ti.nî
ڕێکخەری	.řêk.xe.rî
ڕێککەوتن	.řêk.kew.tin
ڕێککەوتننامەی	.řêk.kew.tin.na.mey
ڕێککەوتنی	.řêk.kew.ti.nî
ڕێکەوت	.řê.kewt
ڕێکەوتن	.řê.kew.tin
ڕێکەوتنی	.řê.kew.ti.nî
ڕێکەوتی	.řê.kew.tî
ڕێگا	.řê.ga
ڕێگای	.řê.gay
ڕێگایەکمان	.řê.ga.yek.man
ڕێگایەکی	.řê.ga.ye.kî
ڕێگر	.řê.gir
ڕێگرتن	.řê.gir.tin
ڕێگری	.řê.gi.rî
ڕێگە	.řê.ge
ڕێگەی	.řê.gey
ڕێگەیان	.řê.ge.yan
ڕێی	.řêy
ڕە	.ře
ڕەئوف	.ře.ʔuf
ڕەت	.řet
ڕەتکردنەوەی	.řet.kir.di.ne.wey
ڕەتکردەوە	.řet.kir.de.we
ڕەجەب	.ře.ceb
ڕەحمان	.řeḧ.man
ڕەحیم	.ře.ḧîm
ڕەخنە	.řex.ne
ڕەخنەی	.řex.ney
ڕەزا	.ře.za
ڕەزامەندی	.ře.za.men.dî
ڕەسمی	.řes.mî
ڕەسوڵ	.ře.suł
ڕەسەن	.ře.sen
ڕەسەنی	.ře.se.nî
ڕەش	.řeş
ڕەشی	.ře.şî
ڕەشید	.ře.şîd
ڕەفتار	.řef.tar
ڕەفتاری	.řef.ta.rî
ڕەمزی	.řem.zî
ڕەمەزان	.ře.me.zan
ڕەنج	.řenc
ڕەنگ	.řeng
ڕەنگدانەوەی	.řeng.da.ne.wey
ڕەنگی	.řen.gî
ڕەنگە	.řen.ge
ڕەها	.ře.ha
ڕەهەندی	.ře.hen.dî
ڕەوا	.ře.wa
ڕەوانە	.ře.wa.ne
ڕەوانەی	.ře.wa.ney
ڕەواکانی	.ře.wa.ka.nî
ڕەوای	.ře.way
ڕەوتی	.řew.tî
ڕەوتە	.řew.te
ڕەوشتی	.ře.wiş.tî
ڕەوشی	.řew.şî
ڕەچاو	.ře.çaw
ڕەچاوی	.ře.ça.wî
ڕەگەز	.ře.gez
ڕەگەزی	.ře.ge.zî
ژان	.jan
ژاپۆن	.ja.pon
ژماری	.ji.ma.rî
ژمارێک	.ji.ma.rêk
ژمارێکی	.ji.ma.rê.kî
ژمارێکیان	.ji.ma.rêk.yan
ژمارە	.ji.ma.re
ژمارەکانی	.ji.ma.re.ka.nî
ژمارەی	.ji.ma.rey
ژمارەیان	.ji.ma.re.yan
ژمارەیەک	.ji.ma.re.yek
ژمارەیەکی	.ji.ma.re.ye.kî
ژن	.jin
ژنان	.ji.nan
ژنانی	.ji.na.nî
ژنانە	.ji.na.ne
ژنی	.ji.nî
ژنێک	.ji.nêk
ژنێکی	.ji.nê.kî
ژنە	.ji.ne
ژنەکەم	.ji.ne.kem
ژنەکەی	.ji.ne.key
ژووری	.jû.rî
ژوورەدا	.jû.re.da
ژی	.jî
ژیابوون	.jya.bûn
ژیاری	.jya.rî
ژیارییەکان	.jya.rî.ye.kan
ژیان	.jyan
ژیانا	.jya.na
ژیاندا	.jyan.da
ژیاننامە	.jyan.na.me
ژیاننامەکەی	.jyan.na.me.key
ژیانی	.jya.nî
ژیانیان	.jyan.yan
ژیانیدا	.jya.nî.da
ژیانیش	.jya.nîş
ژیانێکی	.jya.nê.kî
ژیانە	.jya.ne
ژیانەوەی	.jya.ne.wey
ژیانەکەمان	.jya.ne.ke.man
ژیاون	.jya.win
ژیاوە	.jya.we
ژیر	.jîr
ژین	.jîn
ژینگە	.jîn.ge
ژینگەی	.jîn.gey
ژێر	.jêr
ژێرخانی	.jêr.xa.nî
ژێرزەمینێکی	.jêr.ze.mî.nê.kî
ژێرنووسی	.jêr.nû.sî
ژێرچاودێریی	.jêr.çaw.dê.rîy
ژێرچاپەکانیان	.jêr.ça.pe.kan.yan
ژێرچەپۆکەکانیش	.jêr.çe.po.ke.ka.nîş
ژێرچەپۆکەیەکیش	.jêr.çe.po.ke.ye.kîş
ڤاتە	.va.te
ڤان	.van
ڤرۆنسکی	.vi.ro.nis.kî
ڤورال	.vu.ral
ڤیدیۆ	.vî.dyo
ڤیدیۆیی	.vîd.yo.yî
ڤیکتۆر	.vîk.tor
ڤیکتۆریا	.vîk.tor.ya
ڤە	.ve
ڤەستا	.ves.ta
ڤەکۆلی	.ve.ko.lî
ڤەکۆلیی	.ve.ko.lîy
ک	.ki
کا	.ka
کابرا	.kab.ra
کابرای	.kab.ray
کابینەی	.ka.bî.ney
کات	.kat
کاتدا	.kat.da
کاتژمێر	.kat.ji.mêr
کاتژمێری	.kat.ji.mê.rî
کاتی	.ka.tî
کاتیشدا	.ka.tîş.da
کاتێ	.ka.tê
کاتێک	.ka.têk
کاتێکدا	.ka.têk.da
کاتێکدایە	.ka.têk.da.ye
کاتێکی	.ka.tê.kî
کاتێکیش	.ka.tê.kîş
کاتە	.ka.te
کاتەدا	.ka.te.da
کاتەوە	.ka.te.we
کاتەی	.ka.tey
کاتەیدا	.ka.tey.da
کار	.kar
کارا	.ka.ra
کارادەمر	.ka.ra.de.mir
کارانێک	.ka.ra.nêk
کارانە	.ka.ra.ne
کاربەدەستان	.kar.be.des.tan
کاربەدەستانی	.kar.be.des.ta.nî
کاربەدەستێک	.kar.be.des.têk
کاربەدەستێکی	.kar.be.des.tê.kî
کاربەدەستەکانیش	.kar.be.des.te.ka.nîş
کارتی	.kar.tî
کارتێک	.kar.têk
کارتێکەر	.kar.tê.ker
کاردانەوەی	.kar.da.ne.wey
کاردەکات	.kar.de.kat
کاردەکەن	.kar.de.ken
کارزان	.kar.zan
کارلێکەرییان	.kar.lê.ke.rî.yan
کارمەندانی	.kar.men.da.nî
کارمەندی	.kar.men.dî
کارن	.ka.rin
کارهێنانی	.kar.hê.na.nî
کارهێنراون	.kar.hên.ra.win
کاروان	.kar.wan
کاروانی	.kar.wa.nî
کاروباری	.ka.ru.ba.rî
کارکردن	.kar.kir.din
کارکردنی	.kar.kir.di.nî
کارگێری	.kar.gê.rî
کارگێرییەکی	.kar.gê.rî.ye.kî
کارگێڕی	.kar.gê.řî
کارگێڕیی	.kar.gê.řîy
کارگێڕییان	.kar.gê.řî.yan
کارگێڕییەکی	.kar.gê.řî.ye.kî
کارگێڕییەکیان	.kar.gê.řî.yek.yan
کارگەی	.kar.gey
کاری	.ka.rî
کاریان	.kar.yan
کاریگەر	.ka.rî.ger
کاریگەری	.ka.rî.ge.rî
کاریگەریی	.ka.rî.ge.rîy
کاریگەرییەکی	.ka.rî.ge.rî.ye.kî
کاریگەرە	.ka.rî.ge.re
کارێک	.ka.rêk
کارێکی	.ka.rê.kî
کارە	.ka.re
کارەبا	.ka.re.ba
کارەبای	.ka.re.bay
کارەسات	.ka.re.sat
کارەساتی	.ka.re.sa.tî
کارەساتە	.ka.re.sa.te
کارەشیان	.ka.reş.yan
کارەکان	.ka.re.kan
کارەکانی	.ka.re.ka.nî
کارەکانیان	.ka.re.kan.yan
کارەکە	.ka.re.ke
کارەکەدا	.ka.re.ke.da
کارەکەشیان	.ka.re.keş.yan
کارەکەی	.ka.re.key
کارەکەیان	.ka.re.ke.yan
کارەی	.ka.rey
کاغەز	.ka.ẍez
کاغەزی	.ka.ẍe.zî
کام	.kam
کامیان	.kam.yan
کامیل	.ka.mîl
کامەران	.ka.me.ran
کان	.kan
کاندا	.kan.da
کاندید	.kan.dîd
کاندیدی	.kan.dî.dî
کانن	.ka.nin
کانونی	.ka.nu.nî
کانوونی	.ka.nû.nî
کانگای	.kan.gay
کانی	.ka.nî
کاوا	.ka.wa
کاولی	.kaw.lî
کاوە	.ka.we
کاک	.kak
کاکە	.ka.ke
کاییدا	.ka.yî.da
کایەوە	.ka.ye.we
کایەی	.ka.yey
کتومتی	.ki.tum.tî
کتوپڕ	.ki.tu.piř
کتێب	.ki.têb
کتێبان	.ki.tê.ban
کتێبانم	.ki.tê.ba.nim
کتێبانی	.ki.tê.ba.nî
کتێبانیان	.ki.tê.ban.yan
کتێبانیش	.ki.tê.ba.nîş
کتێبانێک	.ki.tê.ba.nêk
کتێبانێکی	.ki.tê.ba.nê.kî
کتێبانە	.ki.tê.ba.ne
کتێبانەش	.ki.tê.ba.neş
کتێبانەن	.ki.tê.ba.nen
کتێبانەیان	.ki.tê.ba.ne.yan
کتێبخانا	.ki.têb.xa.na
کتێبخانانەدا	.ki.têb.xa.na.ne.da
کتێبخانانەی	.ki.têb.xa.na.ney
کتێبخانە	.ki.têb.xa.ne
کتێبخانەکان	.ki.têb.xa.ne.kan
کتێبخانەکاندا	.ki.têb.xa.ne.kan.da
کتێبخانەکانم	.ki.têb.xa.ne.ka.nim
کتێبخانەکانی	.ki.têb.xa.ne.ka.nî
کتێبخانەکانیشدا	.ki.têb.xa.ne.ka.nîş.da
کتێبخانەکە	.ki.têb.xa.ne.ke
کتێبخانەکەی	.ki.têb.xa.ne.key
کتێبخانەگەلی	.ki.têb.xa.ne.ge.lî
کتێبخانەگەلێک	.ki.têb.xa.ne.ge.lêk
کتێبخانەگەلە	.ki.têb.xa.ne.ge.le
کتێبخانەی	.ki.têb.xa.ney
کتێبخانەیە	.ki.têb.xa.ne.ye
کتێبخانەیەک	.ki.têb.xa.ne.yek
کتێبخانەیەکی	.ki.têb.xa.ne.ye.kî
کتێبدا	.ki.têb.da
کتێبفرۆشی	.ki.têb.fi.ro.şî
کتێبفرۆشیگەلێکی	.ki.têb.fi.ro.şî.ge.lê.kî
کتێبفرۆشیی	.ki.têb.fi.ro.şîy
کتێبفرۆشییانێک	.ki.têb.fi.ro.şî.ya.nêk
کتێبفرۆشییانە	.ki.têb.fi.ro.şî.ya.ne
کتێبفرۆشییانەش	.ki.têb.fi.ro.şî.ya.neş
کتێبفرۆشییەک	.ki.têb.fi.ro.şî.yek
کتێبفرۆشییەکان	.ki.têb.fi.ro.şî.ye.kan
کتێبفرۆشییەکاندا	.ki.têb.fi.ro.şî.ye.kan.da
کتێبفرۆشییەکانی	.ki.têb.fi.ro.şî.ye.ka.nî
کتێبفرۆشییەکانیان	.ki.têb.fi.ro.şî.ye.kan.yan
کتێبفرۆشییەکدا	.ki.têb.fi.ro.şî.yek.da
کتێبفرۆشییەکە	.ki.têb.fi.ro.şî.ye.ke
کتێبفرۆشییەکەم	.ki.têb.fi.ro.şî.ye.kem
کتێبفرۆشییەکەی	.ki.têb.fi.ro.şî.ye.key
کتێبفرۆشێکی	.ki.têb.fi.ro.şê.kî
کتێبفرۆشەکان	.ki.têb.fi.ro.şe.kan
کتێبفرۆشەکە	.ki.têb.fi.ro.şe.ke
کتێبپەرەستانەی	.ki.têb.pe.res.ta.ney
کتێبی	.ki.tê.bî
کتێبیان	.ki.têb.yan
کتێبیش	.ki.tê.bîş
کتێبێک	.ki.tê.bêk
کتێبێکی	.ki.tê.bê.kî
کتێبێکیان	.ki.tê.bêk.yan
کتێبێکیش	.ki.tê.bê.kîş
کتێبە	.ki.tê.be
کتێبەش	.ki.tê.beş
کتێبەوە	.ki.tê.be.we
کتێبەکان	.ki.tê.be.kan
کتێبەکاندا	.ki.tê.be.kan.da
کتێبەکانی	.ki.tê.be.ka.nî
کتێبەکانیان	.ki.tê.be.kan.yan
کتێبەکانیشی	.ki.tê.be.ka.nî.şî
کتێبەکە	.ki.tê.be.ke
کتێبەکەش	.ki.tê.be.keş
کتێبەکەی	.ki.tê.be.key
کتێبەکەیان	.ki.tê.be.ke.yan
کتێبەکەیانە	.ki.tê.be.ke.ya.ne
کتێبەی	.ki.tê.bey
کر	.kir
کرا	.ki.ra
کرابانەوە	.ki.ra.ba.ne.we
کرابوو	.ki.ra.bû
کرابوون	.ki.ra.bûn
کرابوونەوە	.ki.ra.bû.ne.we
کرابووەوە	.ki.ra.bu.we.we
کرابێت	.ki.ra.bêt
کرام	.ki.ram
کران	.ki.ran
کرانی	.ki.ra.nî
کرانەوە	.ki.ra.ne.we
کرانەوەی	.ki.ra.ne.wey
کراو	.ki.raw
کراون	.ki.ra.win
کراونەتەوە	.ki.raw.ne.te.we
کراوی	.ki.ra.wî
کراوە	.ki.ra.we
کراوەتە	.ki.ra.we.te
کراوەتەوە	.ki.ra.we.te.we
کراوەن	.ki.ra.wen
کراوەکان	.ki.ra.we.kan
کراوەکاندا	.ki.ra.we.kan.da
کراوەکانی	.ki.ra.we.ka.nî
کراوەیە	.ki.ra.we.ye
کرایە	.ki.ra.ye
کرایەوە	.ki.ra.ye.we
کربا	.kir.ba
کربوو	.kir.bû
کربوون	.kir.bûn
کربوونەوە	.kir.bû.ne.we
کرد	.kird
کرداری	.kir.da.rî
کردبا	.kir.di.ba
کردبوو	.kir.di.bû
کردبوون	.kir.di.bûn
کردبوونەوەی	.kir.di.bû.ne.wey
کردبووەوە	.kir.di.bu.we.we
کردبێ	.kir.di.bê
کردبێت	.kir.di.bêt
کردم	.kir.dim
کردمەوە	.kir.di.me.we
کردن	.kir.din
کردنی	.kir.di.nî
کردنیان	.kir.din.yan
کردنە	.kir.di.ne
کردنەوە	.kir.di.ne.we
کردنەوەکانی	.kir.di.ne.we.ka.nî
کردنەوەی	.kir.di.ne.wey
کردنەکان	.kir.di.ne.kan
کردوو	.kir.dû
کردووم	.kir.dûm
کردوون	.kir.dûn
کردوونەتەوە	.kir.dû.ne.te.we
کردووین	.kir.dûyn
کردووە	.kir.du.we
کردووەتەوە	.kir.du.we.te.we
کردوە	.kir.dwe
کردۆتە	.kir.do.te
کردی	.kir.dî
کردین	.kir.dîn
کردە	.kir.de
کردەوە	.kir.de.we
کردەوەی	.kir.de.wey
کردەوەیەک	.kir.de.we.yek
کردەی	.kir.dey
کرماشان	.kir.ma.şan
کرمانجی	.kir.man.cî
کرن	.ki.rin
کرۆنی	.ki.ro.nî
کریستیانۆ	.ki.rîst.ya.no
کرێکار	.ki.rê.kar
کرێکاران	.ki.rê.ka.ran
کرێکارانی	.ki.rê.ka.ra.nî
کرێکاری	.ki.rê.ka.rî
کرێکارەکانی	.ki.rê.ka.re.ka.nî
کرێکراوی	.ki.rê.ki.ra.wî
کشانەوە	.ki.şa.ne.we
کشانەوەی	.ki.şa.ne.wey
کشتوکاڵ	.kiş.tu.kał
کشتوکاڵی	.kiş.tu.ka.łî
کفری	.kif.rî
کلاسیک	.ki.la.sîk
کلاسیکی	.ki.la.sî.kî
کلتوری	.kil.tu.rî
کلتووری	.kil.tû.rî
کلۆبی	.ki.lo.bî
کلۆبەکان	.ki.lo.be.kan
کلۆد	.ki.lod
کم	.kim
کو	.ku
کوا	.kwa
کوبانێ	.ku.ba.nê
کوت	.kut
کوتلە	.kut.le
کوتلەی	.kut.ley
کورت	.kurt
کورتی	.kur.tî
کورتیان	.kurt.yan
کورتە	.kur.te
کورتەپێداچوونەوەیەک	.kur.te.pê.da.çû.ne.we.yek
کورتەچیرۆکەکانی	.kur.te.çî.ro.ke.ka.nî
کورد	.kurd
کوردان	.kur.dan
کوردانی	.kur.da.nî
کوردانێک	.kur.da.nêk
کوردانە	.kur.da.ne
کوردانەش	.kur.da.neş
کوردانەی	.kur.da.ney
کوردانەیە	.kur.da.ne.ye
کوردایەتی	.kur.da.ye.tî
کورددا	.kurd.da
کوردستان	.kur.dis.tan
کوردستاندا	.kur.dis.tan.da
کوردستانن	.kur.dis.ta.nin
کوردستانی	.kur.dis.ta.nî
کوردستانیان	.kur.dis.tan.yan
کوردستانیش	.kur.dis.ta.nîş
کوردستانیشدا	.kur.dis.ta.nîş.da
کوردستانییەکان	.kur.dis.ta.nî.ye.kan
کوردستانێ	.kur.dis.ta.nê
کوردستانێڕا	.kur.dis.ta.nê.řa
کوردستانە	.kur.dis.ta.ne
کوردستانەوە	.kur.dis.ta.ne.we
کوردم	.kur.dim
کوردن	.kur.din
کوردوستانی	.kur.dus.ta.nî
کوردی	.kur.dî
کوردیان	.kurd.yan
کوردیبێژ	.kur.dî.bêj
کوردیخوێن	.kur.dî.xwên
کوردیدا	.kur.dî.da
کوردیدایە	.kur.dî.da.ye
کوردیزادە	.kur.dî.za.de
کوردیش	.kur.dîş
کوردیم	.kur.dîm
کوردیمان	.kur.dî.man
کوردین	.kur.dîn
کوردیگەلە	.kur.dî.ge.le
کوردیی	.kur.dîy
کوردییان	.kur.dî.yan
کوردییانە	.kur.dî.ya.ne
کوردیییەکانیان	.kur.dîy.ye.kan.yan
کوردییە	.kur.dî.ye
کوردییەوە	.kur.dî.ye.we
کوردییەکان	.kur.dî.ye.kan
کوردییەکاندا	.kur.dî.ye.kan.da
کوردییەکانی	.kur.dî.ye.ka.nî
کوردییەکانیان	.kur.dî.ye.kan.yan
کوردییەکانیانەوە	.kur.dî.ye.kan.ya.ne.we
کوردییەکانیش	.kur.dî.ye.ka.nîş
کوردییەکانە	.kur.dî.ye.ka.ne
کوردێک	.kur.dêk
کوردە	.kur.de
کوردەواری	.kur.de.wa.rî
کوردەوە	.kur.de.we
کوردەکان	.kur.de.kan
کوردەکاندا	.kur.de.kan.da
کوردەکانن	.kur.de.ka.nin
کوردەکانی	.kur.de.ka.nî
کوردەکانیان	.kur.de.kan.yan
کوردەکانیش	.kur.de.ka.nîş
کوردەکانیشی	.kur.de.ka.nî.şî
کوردەکانە	.kur.de.ka.ne
کوردەکانەوە	.kur.de.ka.ne.we
کورسی	.kur.sî
کورمانج	.kur.manc
کورمانجی	.kur.man.cî
کورمانجیبێژ	.kur.man.cî.bêj
کورمانجیش	.kur.man.cîş
کورمێنج	.kur.mênc
کوروس	.ku.rus
کوروسە	.ku.ru.se
کورکەی	.kur.key
کوشت	.kuşt
کوشتن	.kuş.tin
کوشتنی	.kuş.ti.nî
کوشتووە	.kuş.tu.we
کولتوور	.kul.tûr
کولتووری	.kul.tû.rî
کومیتەی	.ku.mî.tey
کووتاڵەکان	.kû.ta.łe.kan
کوڕ	.kuř
کوڕان	.ku.řan
کوڕی	.ku.řî
کوڕە	.ku.ře
کوڕەکەی	.ku.ře.key
کوژرا	.kuj.ra
کوژران	.kuj.ran
کوژرانی	.kuj.ra.nî
کوژراو	.kuj.raw
کوژراون	.kuj.ra.win
کوژراوە	.kuj.ra.we
کوێ	.kwê
کوێت	.kwêt
کوێرەوەری	.kwê.re.we.rî
کُردِستان	.kur.dîs.tan
کچ	.kiç
کچان	.ki.çan
کچانی	.ki.ça.nî
کچی	.ki.çî
کچێک	.ki.çêk
کچێکی	.ki.çê.kî
کچە	.ki.çe
کچەکە	.ki.çe.ke
کچەکەی	.ki.çe.key
کڕی	.ki.řî
کڕیارەکانیشی	.kiř.ya.re.ka.nî.şî
کڕین	.ki.řîn
کڕینی	.ki.řî.nî
کڕیوە	.ki.řî.we
کۆ	.ko
کۆبانی	.ko.ba.nî
کۆبانێ	.ko.ba.nê
کۆبوونەوە	.ko.bû.ne.we
کۆبوونەوەکان	.ko.bû.ne.we.kan
کۆبوونەوەکانی	.ko.bû.ne.we.ka.nî
کۆبوونەوەکە	.ko.bû.ne.we.ke
کۆبوونەوەکەدا	.ko.bû.ne.we.ke.da
کۆبوونەوەگەلی	.ko.bû.ne.we.ge.lî
کۆبوونەوەگەلێک	.ko.bû.ne.we.ge.lêk
کۆبوونەوەگەلە	.ko.bû.ne.we.ge.le
کۆبوونەوەی	.ko.bû.ne.wey
کۆبوونەوەیەدا	.ko.bû.ne.we.ye.da
کۆبوونەوەیەک	.ko.bû.ne.we.yek
کۆبوونەوەیەکی	.ko.bû.ne.we.ye.kî
کۆبۆنەوەگەلێک	.ko.bo.ne.we.ge.lêk
کۆتای	.ko.tay
کۆتایی	.ko.ta.yî
کۆتاییدا	.ko.ta.yî.da
کۆتاییی	.ko.ta.yîy
کۆراندمانەوە	.ko.ran.di.ma.ne.we
کۆراندمەوە	.ko.ran.di.me.we
کۆریای	.kor.yay
کۆسرەت	.kos.ret
کۆسپ	.kosp
کۆسپانەدایە	.kos.pa.ne.da.ye
کۆسپێکی	.kos.pê.kî
کۆسپە	.kos.pe
کۆسپەکان	.kos.pe.kan
کۆشکی	.koş.kî
کۆلێجی	.ko.lê.cî
کۆلێژی	.ko.lê.jî
کۆم	.kom
کۆما	.ko.ma
کۆمار	.ko.mar
کۆمارخوازی	.ko.mar.xwa.zî
کۆمارخوازیدا	.ko.mar.xwa.zî.da
کۆمارخوازەکانی	.ko.mar.xwa.ze.ka.nî
کۆماری	.ko.ma.rî
کۆمال	.ko.mal
کۆمپانیا	.kom.pan.ya
کۆمپانیاکان	.kom.pan.ya.kan
کۆمپانیاکانی	.kom.pan.ya.ka.nî
کۆمپانیاگەلی	.kom.pan.ya.ge.lî
کۆمپانیاگەلە	.kom.pan.ya.ge.le
کۆمپانیای	.kom.pan.yay
کۆمپانیایەک	.kom.pan.ya.yek
کۆمپانیایەکی	.kom.pan.ya.ye.kî
کۆمۆنیستی	.ko.mo.nîs.tî
کۆمیتەی	.ko.mî.tey
کۆمیتەیەک	.ko.mî.te.yek
کۆمیتەیەکی	.ko.mî.te.ye.kî
کۆمیسیۆن	.ko.mîs.yon
کۆمیسیۆنی	.ko.mîs.yo.nî
کۆمێنت	.ko.mênt
کۆمێنتی	.ko.mên.tî
کۆمەک	.ko.mek
کۆمەڵ	.ko.meł
کۆمەڵانی	.ko.me.ła.nî
کۆمەڵایەتی	.ko.me.ła.ye.tî
کۆمەڵایەتیی	.ko.me.ła.ye.tîy
کۆمەڵایەتییەکان	.ko.me.ła.ye.tî.ye.kan
کۆمەڵناس	.ko.meł.nas
کۆمەڵکوژی	.ko.meł.ku.jî
کۆمەڵگا	.ko.meł.ga
کۆمەڵگادا	.ko.meł.ga.da
کۆمەڵگای	.ko.meł.gay
کۆمەڵگایە	.ko.meł.ga.ye
کۆمەڵگایەکی	.ko.meł.ga.ye.kî
کۆمەڵگە	.ko.meł.ge
کۆمەڵگەدا	.ko.meł.ge.da
کۆمەڵگەی	.ko.meł.gey
کۆمەڵگەیەکی	.ko.meł.ge.ye.kî
کۆمەڵی	.ko.me.łî
کۆمەڵێک	.ko.me.łêk
کۆمەڵە	.ko.me.łe
کۆمەڵەی	.ko.me.łey
کۆن	.kon
کۆنترۆڵ	.kon.ti.roł
کۆنترۆڵکردنی	.kon.ti.roł.kir.di.nî
کۆنترۆڵی	.kon.ti.ro.łî
کۆنتڕۆڵی	.kon.ti.řo.łî
کۆنفرانسی	.kon.fi.ran.sî
کۆنگرە	.kon.gi.re
کۆنگرەکەدا	.kon.gi.re.ke.da
کۆنگرەی	.kon.gi.rey
کۆنگرەیەکی	.kon.gi.re.ye.kî
کۆنی	.ko.nî
کۆنێ	.ko.nê
کۆنە	.ko.ne
کۆپی	.ko.pî
کۆپیدا	.ko.pî.da
کۆپیگەلی	.ko.pî.ge.lî
کۆپیگەلێک	.ko.pî.ge.lêk
کۆپیگەلە	.ko.pî.ge.le
کۆپیگەلەیە	.ko.pî.ge.le.ye
کۆپیی	.ko.pîy
کۆپییان	.ko.pî.yan
کۆپییە	.ko.pî.ye
کۆپییەک	.ko.pî.yek
کۆپییەکی	.ko.pî.ye.kî
کۆچ	.koç
کۆچاندنە	.ko.çan.di.ne
کۆچی	.ko.çî
کۆچیان	.koç.yan
کۆچیندران	.ko.çîn.di.ran
کۆڕ	.koř
کۆڕی	.ko.řî
کۆڕەکە	.ko.ře.ke
کۆژراون	.koj.ra.win
کۆکراوەکان	.ko.ki.ra.we.kan
کۆکراوەکانی	.ko.ki.ra.we.ka.nî
کۆکراوەی	.ko.ki.ra.wey
کۆکردنەوەی	.ko.kir.di.ne.wey
کۆڵ	.koł
کۆڵی	.ko.łî
کۆڵەواری	.ko.łe.wa.rî
کۆی	.koy
کۆیلە	.koy.le
کۆیلەپەروەرانەکانی	.koy.le.per.we.ra.ne.ka.nî
کۆیە	.ko.ye
کی	.kî
کیلۆمیتر	.kî.lo.mî.tir
کیلۆمەتر	.kî.lo.me.tir
کیمیایی	.kîm.ya.yî
کێ	.kê
کێبەرکێ	.kê.ber.kê
کێبەرکێگەلێک	.kê.ber.kê.ge.lêk
کێبەرکێی	.kê.ber.kêy
کێبەرکێیەکی	.kê.ber.kê.ye.kî
کێش	.kêş
کێشا	.kê.şa
کێشابوومەوە	.kê.şa.bû.me.we
کێشانە	.kê.şa.ne
کێشی	.kê.şî
کێشە	.kê.şe
کێشەسازکەرە	.kê.şe.saz.ke.re
کێشەکان	.kê.şe.kan
کێشەکانی	.kê.şe.ka.nî
کێشەکە	.kê.şe.ke
کێشەگەلی	.kê.şe.ge.lî
کێشەگەلێکی	.kê.şe.ge.lê.kî
کێشەگەلە	.kê.şe.ge.le
کێشەی	.kê.şey
کێشەیان	.kê.şe.yan
کێشەیە	.kê.şe.ye
کێشەیەک	.kê.şe.yek
کێشەیەکی	.kê.şe.ye.kî
کێشەیەی	.kê.şe.yey
کێهە	.kê.he
کێو	.kêw
کێوی	.kê.wî
کێوین	.kê.wîn
کێیە	.kê.ye
کە	.ke
کەتالۆگێکی	.ke.ta.lo.gê.kî
کەتەلۆگ	.ke.te.log
کەتەلۆگان	.ke.te.lo.gan
کەتەلۆگانە	.ke.te.lo.ga.ne
کەتەلۆگی	.ke.te.lo.gî
کەتەلۆگەکانی	.ke.te.lo.ge.ka.nî
کەرتی	.ker.tî
کەرکووک	.ker.kûk
کەرکوک	.ker.kuk
کەرکوکی	.ker.ku.kî
کەریم	.ke.rîm
کەریمی	.ke.rî.mî
کەرەستە	.ke.res.te
کەرەستەی	.ke.res.tey
کەس	.kes
کەسان	.ke.san
کەسانی	.ke.sa.nî
کەسانێک	.ke.sa.nêk
کەسانێکی	.ke.sa.nê.kî
کەسانێکیش	.ke.sa.nê.kîş
کەسانە	.ke.sa.ne
کەسانەش	.ke.sa.neş
کەسانەی	.ke.sa.ney
کەسایەتی	.ke.sa.ye.tî
کەسایەتیگەلی	.ke.sa.ye.tî.ge.lî
کەسایەتیی	.ke.sa.ye.tîy
کەسایەتییان	.ke.sa.ye.tî.yan
کەسایەتییە	.ke.sa.ye.tî.ye
کەسایەتییەکان	.ke.sa.ye.tî.ye.kan
کەسایەتییەکی	.ke.sa.ye.tî.ye.kî
کەسوکاری	.ke.su.ka.rî
کەسی	.ke.sî
کەسیان	.kes.yan
کەسیش	.ke.sîş
کەسییەکان	.ke.sî.ye.kan
کەسییەکانیش	.ke.sî.ye.ka.nîş
کەسێتی	.ke.sê.tî
کەسێک	.ke.sêk
کەسێکی	.ke.sê.kî
کەسە	.ke.se
کەسەی	.ke.sey
کەش	.keş
کەشتی	.keş.tî
کەل	.kel
کەلار	.ke.lar
کەلتوری	.kel.tu.rî
کەلتووری	.kel.tû.rî
کەلتی	.kel.tî
کەلوپەلی	.ke.lu.pe.lî
کەلە	.ke.le
کەم	.kem
کەمال	.ke.mal
کەماڵ	.ke.mał
کەماڵیستەکان	.ke.ma.łîs.te.kan
کەمبوونەوەی	.kem.bû.ne.wey
کەمبوونەوەیەکی	.kem.bû.ne.we.ye.kî
کەمتر	.kem.tir
کەمتریش	.kem.ti.rîş
کەمترین	.kem.ti.rîn
کەمترە	.kem.ti.re
کەمپی	.kem.pî
کەمپینی	.kem.pî.nî
کەمکردنەوەی	.kem.kir.di.ne.wey
کەمی	.ke.mî
کەمێک	.ke.mêk
کەمە	.ke.me
کەمەوە	.ke.me.we
کەم‌ئەزموونەوە	.kem.ʔez.mû.ne.we
کەم‌کراو	.kem.ki.raw
کەم‌کراوەکان	.kem.ki.ra.we.kan
کەن	.ken
کەناری	.ke.na.rî
کەناڵی	.ke.na.łî
کەناڵە	.ke.na.łe
کەناڵەکانی	.ke.na.łe.ka.nî
کەنداو	.ken.daw
کەنداوی	.ken.da.wî
کەندوقووڵ	.ken.du.qûł
کەندوکۆسپە	.ken.du.kos.pe
کەنەدا	.ke.ne.da
کەنەوە	.ke.ne.we
کەوا	.ke.wa
کەوابوو	.ke.wa.bû
کەواتە	.ke.wa.te
کەوایە	.ke.wa.ye
کەوت	.kewt
کەوتبێ	.kew.ti.bê
کەوتن	.kew.tin
کەوتنی	.kew.ti.nî
کەوتنە	.kew.ti.ne
کەوتووە	.kew.tu.we
کەوتۆتە	.kew.to.te
کەوتە	.kew.te
کەوتەوە	.kew.te.we
کەون	.kewn
کەچا	.ke.ça
کەچی	.ke.çî
کەڕەت	.ke.řet
کەڕەتان	.ke.ře.tan
کەڕەتێک	.ke.ře.têk
کەڵک	.kełk
کەڵکی	.keł.kî
کەڵکیان	.kełk.yan
کەڵەوەشکێنی	.ke.łe.weş.kê.nî
کەی	.key
کەیسی	.key.sî
کەیفی	.key.fî
کەین	.keyn
گ	.gi
گاز	.gaz
گازی	.ga.zî
گاندی	.gan.dî
گاهەز	.ga.hez
گاڵ	.gał
گاڵتە	.gał.te
گرافیکەکان	.gi.ra.fî.ke.kan
گران	.gi.ran
گرت	.girt
گرتبوو	.gir.ti.bû
گرتن	.gir.tin
گرتنی	.gir.ti.nî
گرتووە	.gir.tu.we
گرتووەتەوە	.gir.tu.we.te.we
گرتە	.gir.te
گرتەوە	.gir.te.we
گرفت	.gi.rift
گرفتی	.gi.rif.tî
گرفتە	.gi.rif.te
گرفتەکانی	.gi.rif.te.ka.nî
گرن	.gi.rin
گرنگ	.gi.ring
گرنگتر	.gi.ring.tir
گرنگترین	.gi.ring.ti.rîn
گرنگی	.gi.rin.gî
گرنگیان	.gi.ring.yan
گرنگیی	.gi.rin.gîy
گرنگە	.gi.rin.ge
گرنگەکانی	.gi.rin.ge.ka.nî
گرووپ	.gi.rûp
گرووپانی	.gi.rû.pa.nî
گرووپانێکی	.gi.rû.pa.nê.kî
گرووپی	.gi.rû.pî
گرووپێکن	.gi.rû.pê.kin
گرووپێکی	.gi.rû.pê.kî
گرووپە	.gi.rû.pe
گرووپەکان	.gi.rû.pe.kan
گروپی	.gi.ru.pî
گروپێکی	.gi.ru.pê.kî
گرژی	.gir.jî
گریان	.gir.yan
گریلاکان	.gi.rî.la.kan
گریلاکانی	.gi.rî.la.ka.nî
گرینگ	.gi.rîng
گرینگی	.gi.rîn.gî
گرینگیان	.gi.rîng.yan
گرینگیی	.gi.rîn.gîy
گرینگییەکی	.gi.rîn.gî.ye.kî
گرینگە	.gi.rîn.ge
گرینگەکان	.gi.rîn.ge.kan
گرێ	.gi.rê
گرێبەستی	.gi.rê.bes.tî
گرەگەزێک	.gi.re.ge.zêk
گشت	.gişt
گشتی	.giş.tî
گشتیدا	.giş.tî.da
گشتین	.giş.tîn
گشتیی	.giş.tîy
گشتییەکان	.giş.tî.ye.kan
گشتییەکاندا	.giş.tî.ye.kan.da
گفتوگۆ	.gif.tu.go
گفتوگۆکردن	.gif.tu.go.kir.din
گفتوگۆی	.gif.tu.goy
گل	.gil
گلەیی	.gi.le.yî
گمگم	.gim.gim
گواستنەوە	.gwas.ti.ne.we
گواستنەوەی	.gwas.ti.ne.wey
گواسرایەوە	.gwas.ra.ye.we
گوایە	.gwa.ye
گوت	.gut
گوتاری	.gu.ta.rî
گوتارەکانی	.gu.ta.re.ka.nî
گوتبووی	.gu.ti.bûy
گوتبوویان	.gu.ti.bû.yan
گوترا	.gut.ra
گوتران	.gut.ran
گوتراوە	.gut.ra.we
گوتم	.gu.tim
گوتمان	.gut.man
گوتن	.gu.tin
گوتنەوە	.gu.ti.ne.we
گوتوویانە	.gu.tû.ya.ne
گوتوویەتی	.gu.tû.ye.tî
گوتی	.gu.tî
گوتیان	.gut.yan
گوتیشی	.gu.tî.şî
گوتە	.gu.te
گوتەبێژی	.gu.te.bê.jî
گوتەی	.gu.tey
گوتەیەکی	.gu.te.ye.kî
گورجییەکان	.gur.cî.ye.kan
گورزەک	.gur.zek
گوزارشت	.gu.za.rişt
گوزەرانی	.gu.ze.ra.nî
گوشار	.gu.şar
گوشاری	.gu.şa.rî
گول	.gul
گولستان	.gu.lis.tan
گوللە	.gul.le
گولێن	.gu.lên
گومان	.gu.man
گومانی	.gu.ma.nî
گومروک	.gum.ruk
گومروکەوە	.gum.ru.ke.we
گونجاو	.gun.caw
گونجاوترە	.gun.caw.ti.re
گوند	.gund
گوندانە	.gun.da.ne
گوندانەوە	.gun.da.ne.we
گوندوز	.gun.duz
گوندی	.gun.dî
گوندە	.gun.de
گوندەکان	.gun.de.kan
گوندەکانی	.gun.de.ka.nî
گوندەکانەوە	.gun.de.ka.ne.we
گووتی	.gû.tî
گوڵ	.guł
گوڵان	.gu.łan
گوڵی	.gu.łî
گوێ	.gwê
گوێرەی	.gwê.rey
گوێم	.gwêm
گوێی	.gwêy
گژ	.gij
گۆران	.go.ran
گۆرانی	.go.ra.nî
گۆرانیبێژی	.go.ra.nî.bê.jî
گۆرانیی	.go.ra.nîy
گۆرانییە	.go.ra.nî.ye
گۆرانییەوە	.go.ra.nî.ye.we
گۆشت	.goşt
گۆشتی	.goş.tî
گۆل	.gol
گۆلی	.go.lî
گۆڕا	.go.řa
گۆڕان	.go.řan
گۆڕاندایە	.go.řan.da.ye
گۆڕانکاری	.go.řan.ka.rî
گۆڕانکاریگەلێکی	.go.řan.ka.rî.ge.lê.kî
گۆڕانکاریی	.go.řan.ka.rîy
گۆڕانکارییە	.go.řan.ka.rî.ye
گۆڕانکارییەک	.go.řan.ka.rî.yek
گۆڕانکارییەکانیان	.go.řan.ka.rî.ye.kan.yan
گۆڕانکارییەکی	.go.řan.ka.rî.ye.kî
گۆڕانی	.go.řa.nî
گۆڕاوەتەوە	.go.řa.we.te.we
گۆڕدرا	.goř.di.ra
گۆڕدران	.goř.di.ran
گۆڕی	.go.řî
گۆڕینی	.go.řî.nî
گۆڕێ	.go.řê
گۆڕەپانی	.go.ře.pa.nî
گۆڤار	.go.var
گۆڤاران	.go.va.ran
گۆڤارانی	.go.va.ra.nî
گۆڤارانێک	.go.va.ra.nêk
گۆڤارانە	.go.va.ra.ne
گۆڤاری	.go.va.rî
گۆڤاریان	.go.var.yan
گۆڤاریش	.go.va.rîş
گۆڤاریشان	.go.va.rî.şan
گۆڤارێک	.go.va.rêk
گۆڤارێکی	.go.va.rê.kî
گۆڤارە	.go.va.re
گۆڤارەکان	.go.va.re.kan
گۆڤارەکاندا	.go.va.re.kan.da
گۆڤارەکانی	.go.va.re.ka.nî
گۆڤارەکانیش	.go.va.re.ka.nîş
گۆڤارەکە	.go.va.re.ke
گۆڤارەکەدایە	.go.va.re.ke.da.ye
گۆڤارەکەی	.go.va.re.key
گۆڤارەی	.go.va.rey
گۆڵ	.goł
گۆڵی	.go.łî
گۆی	.goy
گیان	.gyan
گیانی	.gya.nî
گیانیان	.gyan.yan
گیرا	.gî.ra
گیرابوو	.gî.ra.bû
گیراوم	.gî.ra.wim
گیراوە	.gî.ra.we
گیرفانی	.gîr.fa.nî
گیروداوە	.gî.ru.da.we
گیڤارا	.gî.va.ra
گێرە	.gê.re
گێل	.gêl
گێڕابووەوە	.gê.řa.bu.we.we
گێڕامەوە	.gê.řa.me.we
گێڕانەوەی	.gê.řa.ne.wey
گێڕایەوە	.gê.řa.ye.we
گە	.ge
گەبەروبێکار	.ge.be.ru.bê.kar
گەر	.ger
گەردوونی	.ger.dû.nî
گەرم	.germ
گەرمی	.ger.mî
گەرمیان	.germ.yan
گەرمیانی	.germ.ya.nî
گەرمەی	.ger.mey
گەرچی	.ger.çî
گەریلا	.ge.rî.la
گەریلایانە	.ge.rî.la.ya.ne
گەرەکتانە	.ge.rek.ta.ne
گەرەکم	.ge.re.kim
گەرەکمان	.ge.rek.man
گەرەکمە	.ge.rek.me
گەرەکیان	.ge.rek.yan
گەشت	.geşt
گەشتیاری	.geşt.ya.rî
گەشە	.ge.şe
گەشەپێدان	.ge.şe.pê.dan
گەشەپێدانی	.ge.şe.pê.da.nî
گەشەکردنی	.ge.şe.kir.di.nî
گەشەکردنێکی	.ge.şe.kir.di.nê.kî
گەشەی	.ge.şey
گەل	.gel
گەلان	.ge.lan
گەلانی	.ge.la.nî
گەلاوێژ	.ge.la.wêj
گەلاوێژی	.ge.la.wê.jî
گەلی	.ge.lî
گەلێ	.ge.lê
گەلێک	.ge.lêk
گەلێکی	.ge.lê.kî
گەلە	.ge.le
گەلەکانی	.ge.le.ka.nî
گەلەکەمان	.ge.le.ke.man
گەمارۆ	.ge.ma.ro
گەمارۆی	.ge.ma.roy
گەنج	.genc
گەنجان	.gen.can
گەنجانی	.gen.ca.nî
گەنجی	.gen.cî
گەنجێکی	.gen.cê.kî
گەنجە	.gen.ce
گەندەڵی	.gen.de.łî
گەنم	.ge.nim
گەورە	.gew.re
گەورەتر	.gew.re.tir
گەورەترین	.gew.re.ti.rîn
گەورەترینەکەیان	.gew.re.ti.rî.ne.ke.yan
گەورەکان	.gew.re.kan
گەورەکاندا	.gew.re.kan.da
گەورەکانی	.gew.re.ka.nî
گەورەی	.gew.rey
گەورەیان	.gew.re.yan
گەورەیی	.gew.re.yî
گەورەیە	.gew.re.ye
گەڕ	.geř
گەڕان	.ge.řan
گەڕانێکی	.ge.řa.nê.kî
گەڕانەوە	.ge.řa.ne.we
گەڕانەوەی	.ge.řa.ne.wey
گەڕاوم	.ge.řa.wim
گەڕایەوە	.ge.řa.ye.we
گەڕەکی	.ge.ře.kî
گەڵ	.geł
گەڵاڵەکانی	.ge.ła.łe.ka.nî
گەڵاڵەی	.ge.ła.łey
گەڵاڵەیە	.ge.ła.łe.ye
گەڵاڵەیەی	.ge.ła.łe.yey
گەیاند	.ge.yand
گەیاندن	.ge.yan.din
گەیاندنی	.ge.yan.di.nî
گەیاندە	.ge.yan.de
گەیشت	.ge.yişt
گەیشتبا	.geyş.ti.ba
گەیشتبێ	.geyş.ti.bê
گەیشتن	.geyş.tin
گەیشتنی	.geyş.ti.nî
گەیشتنە	.geyş.ti.ne
گەیشتووە	.geyş.tu.we
گەیشتووەتێ	.geyş.tu.we.tê
گەیشتووەتە	.geyş.tu.we.te
گەیشتە	.ge.yiş.te
یا	.ya
یاخود	.ya.xud
یاخی	.ya.xî
یاد	.yad
یادی	.ya.dî
یارمەتی	.yar.me.tî
یارمەتیدانی	.yar.me.tî.da.nî
یارمەتیی	.yar.me.tîy
یاری	.ya.rî
یاریدەدەری	.ya.rî.de.de.rî
یاریزان	.ya.rî.zan
یاریزانان	.ya.rî.za.nan
یاریزانانی	.ya.rî.za.na.nî
یاریزانی	.ya.rî.za.nî
یاریزانێکی	.ya.rî.za.nê.kî
یاریزانە	.ya.rî.za.ne
یاریگا	.ya.rî.ga
یاریگای	.ya.rî.gay
یاریگەی	.ya.rî.gey
یاریی	.ya.rîy
یارییە	.ya.rî.ye
یارییەکانی	.ya.rî.ye.ka.nî
یارییەکی	.ya.rî.ye.kî
یارییەکە	.ya.rî.ye.ke
یاریەکانی	.yar.ye.ka.nî
یاریەکە	.yar.ye.ke
یاسا	.ya.sa
یاسان	.ya.san
یاساوە	.ya.sa.we
یاساکان	.ya.sa.kan
یاساکانی	.ya.sa.ka.nî
یاساکە	.ya.sa.ke
یاساکەی	.ya.sa.key
یاساگۆڕێنەکە	.ya.sa.go.řê.ne.ke
یاساگەلە	.ya.sa.ge.le
یاسای	.ya.say
یاسایی	.ya.sa.yî
یاسایی کردنی	.ya.sa.yî.kir.di.nî
یاساییی	.ya.sa.yîy
یاسایییان	.ya.sa.yî.yan
یاسایییەوە	.ya.sa.yî.ye.we
یاسایییەکان	.ya.sa.yî.ye.kan
یاسایە	.ya.sa.ye
یاسایەک	.ya.sa.yek
یاسایەکی	.ya.sa.ye.kî
یاسین	.ya.sîn
یان	.yan
یانگزەهەمین	.yang.ze.he.mîn
یانی	.ya.nî
یانە	.ya.ne
یانەکانی	.ya.ne.ka.nî
یانەکە	.ya.ne.ke
یانەکەی	.ya.ne.key
یانەی	.ya.ney
یانەیە	.ya.ne.ye
یاوەری	.ya.we.rî
یوسف	.yu.sif
یوسفی	.yu.si.fî
یونس	.yuns
یوونایتد	.yû.nay.tid
یۆرۆ	.yo.ro
یۆزگات	.yoz.gat
یۆنان	.yo.nan
یۆنانی	.yo.na.nî
یۆنانییەکان	.yo.na.nî.ye.kan
ییتس	.yî.tis
یێ	.yê
یێن	.yên
یە	.ye
یەزیدی	.ye.zî.dî
یەعقووب	.yeƹ.qûb
یەمەن	.ye.men
یەک	.yek
یەکان	.ye.kan
یەکانی	.ye.ka.nî
یەکتر	.yek.tir
یەکتری	.yek.ti.rî
یەکتیا	.yek.tya
یەکجار	.yek.car
یەکجاری	.yek.ca.rî
یەکدا	.yek.da
یەکدی	.yek.dî
یەکدەست	.yek.dest
یەکسان	.yek.san
یەکسانی	.yek.sa.nî
یەکسەر	.yek.ser
یەکشەممە	.yek.şem.me
یەکلایی	.yek.la.yî
یەکڕیزی	.yek.řî.zî
یەکگرتوو	.yek.gir.tû
یەکگرتووی	.yek.gir.tûy
یەکگرتوویی	.yek.gir.tû.yî
یەکگرتووەکان	.yek.gir.tu.we.kan
یەکگرتووەکانی	.yek.gir.tu.we.ka.nî
یەکی	.ye.kî
یەکیان	.yek.yan
یەکینەکانی	.ye.kî.ne.ka.nî
یەکیەتی	.yek.ye.tî
یەکیەتیی	.yek.ye.tîy
یەکێ	.ye.kê
یەکێتی	.ye.kê.tî
یەکێتیدا	.ye.kê.tî.da
یەکێتیی	.ye.kê.tîy
یەکێتێ	.ye.kê.tê
یەکێک	.ye.kêk
یەکێکی	.ye.kê.kî
یەکێکیان	.ye.kêk.yan
یەکێکە	.ye.kê.ke
یەکە	.ye.ke
یەکەم	.ye.kem
یەکەمجار	.ye.kem.car
یەکەمدا	.ye.kem.da
یەکەمی	.ye.ke.mî
یەکەمیان	.ye.kem.yan
یەکەمین	.ye.ke.mîn
یەکەمینەکەیان	.ye.ke.mî.ne.ke.yan
یەکەمەکەیاندا	.ye.ke.me.ke.yan.da
یەکەوە	.ye.ke.we
یەکەکانی	.ye.ke.ka.nî
یەکەی	.ye.key
