a	a
aarão	aaɾɐ̃w̃
aarão	aɾɐ̃w̃
aba	aba
abacate	abakate
abacate	abakati
abacate	abakat͡ʃi
abacateiro	abakatejɾo
abacateiro	abakatejɾu
abacaxi	abakaʃi
abacaxi	ɐbakɐʃi
abacaxizeiro	abakaʃizejɾo
abacaxizeiro	abakaʃizejɾu
abacharelado	ɐbɐʃaɾeladu
abacista	abasista
abacista	abasistɐ
abacista	abasiʃtɐ
abadan	abadɐ̃
abade	abadʒi
abadesa	abadeza
abadessa	abadesa
abadessa	abadesɐ
abadia	abad͡ʒia
abadia	abad͡ʒiɐ
abafada	abafada
abafadamente	abafadamẽte
abafadamente	abafadamẽt͡ʃi
abafado	abafado
abafado	abafadu
abafador	abafadoʁ
abafação	abafasɐ̃w̃
abaixo	abajʃo
abaixo	abajʃu
abalado	abaladu
abalizado	abalɪzadu
abandonado	abɐ̃donadu
abandonar	abɐ̃donaʁ
abandono	abɐ̃donu
abanheenga	abɐj̃eẽɡɐ
abanheenga	abɐɲeẽɡɐ
abano	abɐno
abano	abɐnu
abarregado	abaʁeɡadu
abatiá	abat͡ʃia
abatiá	abat͡ʃja
abaxial	abakisiaw
abdômen	abidomẽj̃
abeberar	abebeɾaɾ
abel	abɛw
abelardo	abelaʁdu
abelharuco	abeʎaɾuku
abelheiro	abeʎejɾu
abençoada	abẽsoadɐ
aberta	abɛʁtɐ
abertamente	abɛʁtɐmẽt͡ʃi
aberto	abɛɹtu
aberto	abɛʁtu
aberto	abɛχtu
abeto	abɛto
abeto	abɛtu
abiogênese	abioʒenezi
abissal	abisaw
abiu	abiw
ablativo	ablat͡ʃivu
abobado	abobadu
abolição	abolisɐ̃w̃
abordagem	aboʁdaʒẽj̃
abordar	aboʁdaʁ
abortismo	aboʁt͡ʃizmu
aborto	aboʁtu
aborto	abɔʁtu
abotoadura	abotoaduɾɐ
abrandamento	abɾɐ̃dɐmẽtu
abrandar	abɾɐ̃daʁ
abranger	abɾɐ̃ʒeʁ
abrangência	abɾɐ̃ʒẽsja
abrasax	abɾasaks
abraão	abɾaɐ̃w̃
abraão	abɾɐ̃w̃
abraçar	abɾasaʁ
abraçável	abɾasavew
abração	abɾasɐ̃w̃
abricó	abɾikɔ
abrigado	abɾiɡadu
abril	abɾiw
abrir	abɾiʁ
abriu	abɾiw
abruptamente	abɾupitamẽte
abruptamente	abɾupitamẽt͡ʃi
abruptamente	abɾuptamẽte
abruptamente	abɾuptamẽt͡ʃi
abrupto	abɾupto
abrupto	abɾuptu
absalão	absalɐ̃w̃
absinto	abisĩtu
absinto	absĩtu
absonância	absonɐ̃sja
abstenção	abstẽsɐ̃w̃
abstenção	abʃtẽsɐ̃w̃
abster	absteʁ
absurdo	absuʁdu
abundante	abũdɐ̃t͡ʃi
abundar	abũdaʁ
abundância	abũdɐ̃sja
abutre	abutɾi
abóbora	abɔboɾɐ
abóbora	abɔbuɾɐ
acaba	akabɐ
acabar	akabaɹ
acabar	akabaɻ
acabar	akabaʁ
acabar	akabaχ
acabou	akabow
academia	akademia
academizar	akademizaʁ
acadêmico	akademiku
acaia	akajɐ
acaju	akaʒu
acalmar	akawmaʁ
acamado	akamadu
acamado	akɐmadu
acanhado	akɐ̃ɲadu
acapulco	akapuwku
acarajé	akaɾaʒɛ
acaso	akazu
accra	akɾɐ
acebolado	aseboladu
aceitabilidade	asejtabilidad͡ʒi
aceitar	asejtaʁ
acelerar	aseleɾaʁ
acelga	asɛwɡɐ
acender	asẽdeʁ
aceno	asenu
acento	asẽtu
acepipe	asepipi
acertar	aseʁtaʁ
acerto	aseɾtu
acerto	aseʁtu
acerto	asɛɾtu
acerto	asɛʁtu
acervo	asɛʁvu
aceso	asezu
acessar	asesaʁ
acessivelmente	asesivewmẽt͡ʃi
acesso	asɛsu
acha	aʃa
acha	aʃɐ
achaparrado	aʃapaʁadu
achaparrar	aʃapaʁaɾ
achaque	aʃaki
achar	aʃaʁ
achegar	aʃeɡaʁ
achismo	aʃizmu
acho	aʃu
acidente	asidẽtʃi
acima	asimɐ
acolher	akoʎeɾ
acomete	akomɛtʃi
acomodar	akomodaʁ
aconselhar	akõseʎaʁ
acontecendo	akõtesẽdu
acontecer	akõteseɹ
acontecer	akõteseɻ
acontecer	akõteseɾ
acontecer	akõteseʁ
acontecer	akõteseχ
aconteceu	akõtesew
acordar	akoʁdaʁ
acorde	akɔʁd͡ʒi
acordo	akoʁdu
acordo	akɔʁdu
acorrentado	akoʁẽtadu
acostar	akostaʁ
acostumar	akostumaʁ
acovardar	akovaʁdaʁ
acre	akɾe
acre	akɾi
acreditar	akɾed͡ʒitaʁ
acrescentar	akɾesẽtaʁ
acrograma	akɾoɡɾɐ̃mɐ
acréscimo	akɾɛsimu
acurácia	akuɾasja
acádia	akad͡ʒiɐ
acústica	akust͡ʃikɐ
adad	adad͡ʒ
adamastor	adɐmastoʁ
adaptabilidade	adaptabilidad͡ʒi
adaptação	adapitasɐ̃w̃
adelo	adɛlu
adem	adẽj̃
adentrar	adẽtɾaʁ
adequado	adekwadu
adequar	adekwaʁ
aderência	adeɾẽsia
aderência	adeɾẽsiɐ
aderência	adeɾẽsja
adesão	adezɐ̃w̃
adeus	adews
adeus	adewʃ
adeusinho	adewziɲu
adicionar	ad͡ʒisjonaʁ
adivinhar	adʒiviɲaʁ
adição	adisɐ̃w̃
adição	ad͡ʒisɐ̃w̃
admin	ad͡ʒmĩ
administrar	ɐdminiʃtrar
admirador	ad͡ʒimiɾadoʁ
admitir	admitiɦ
admitir	adʒimitʃix
admitir	adʒmitʃiɹ
admitir	adʒmitʃiɻ
admitir	ad͡ʒimit͡ʃiʁ
admitir	ad͡ʒmit͡ʃiʁ
admoestar	ɐdmwɛʃtar
adoecer	adueseʁ
adolescência	adulesẽsiɐ
adonai	adonaj
adorar	adoɾaʁ
adotar	adotaʁ
adquirir	adʒkiɾiʁ
adrede	adɾed͡ʒi
adriano	adɾiɐnu
adrianópolis	adɾiɐnɔpolis
adrião	adɾiɐ̃w̃
adscrito	ad͡ʒiskɾitu
adsorção	adsoʁsɐ̃w̃
adsorção	ad͡ʒsoʁsɐ̃w̃
aduela	ɐdwɛlɐ
adular	ɐdulaɾ
adulto	aduwtu
advento	ad͡ʒvẽtu
advogado	ad͡ʒivoɡadu
advérbio	adʒivɛɦbɪʊ
adélio	adɛlju
aeromoça	aɛɾomosɐ
aeroporto	aɛropoxtu
aeroporto	aɛropoɾtu
aerólito	aiɾɔlitu
afagar	ɐfɐɡaɾ
afago	ɐfaɡu
afamar	ɐfɐmaɾ
afastamento	afastamẽtu
afastamento	afaʃtamẽtu
afastar	afastaʁ
afazendar	ɐfɐzẽdar
afeganistão	afeɡɐnistɐ̃w̃
afeiçoar	ɐfɐjswar
afeição	afejsɐ̃w
afetar	afetaɹ
afetar	afetaɻ
afetar	afetaʁ
afetar	afetaχ
afete	afɛtʃi
afeto	afɛtu
afiado	afiadu
afiado	afjadu
afiançar	ɐfjɐ̃saɾ
afigurar	ɐfiɡuɾaɾ
afim	afĩ
afinal	afinaw
afinal	afinaɻ
afinar	afinaʁ
afinidade	afinidad͡ʒi
afirmar	afixmax
afirmar	afiɹmaɹ
afirmar	afiɻmaɻ
afirmar	afiɾmaɾ
afirmar	afiʁmaʁ
afirmação	afiʁmasɐ̃w̃
afixar	ɐfiksaɾ
aflijamos	afliʒɐmus
aflição	aflisɐ̃w̃
afogar	afoɡaʁ
afoito	afojtu
afonso	afõsu
afora	afɔɾa
afortunadamente	afoʁtunadamẽt͡ʃi
africano	afɾikɐnu
afrodito	afɾod͡ʒitu
afta	afitɐ
afta	afta
afta	aftɐ
afã	afɐ̃
agadá	aɡada
agaloar	ɐɡɐlwaɾ
agami	aɡami
agarrar	aɡaʁaʁ
agasalho	ɐɡɐzaʎu
agastamento	aɡastamẽtu
ageu	aʒew
agiotagem	aʒjotaʒẽj̃
agir	aʒiʁ
agiria	aʒiɾiɐ
agitadamente	aʒitadamẽt͡ʃi
aglaia	aɡlajɐ
aglomerastes	aɡlomeɾast͡ʃis
agoiro	aɡojɾu
agonizar	aɡõnizaχ
agora	aɡɔɾɐ
agorinha	aɡɔɾiɲɐ
agostinho	aɡost͡ʃiɲu
agosto	aɡostu
agoural	aɡowɾaw
agouro	aɡowɾu
agradar	aɡɾadaʁ
agradecemos	aɡradesemus
agradecemos	aɡradesemuʃ
agradecer	aɡɾadeseʁ
agradecimento	aɡɾadesimẽj̃tu
agrado	aɡɾadu
agradável	aɡɾadavew
agrigento	aɡɾiʒẽtu
agrícola	aɡɾikolɐ
aguado	aɡwadu
aguante	aɡwɐ̃t͡ʃi
aguar	aɡwaʁ
aguentar	aɡwẽtaʁ
aguerrido	aɡeridu
aguerrido	aɡeʁidu
aguçado	aɡusadu
agência	aʒẽsjɐ
aham	ɐhɐ̃
aham	ɐ̃hɐ̃
aids	ajds
aidético	ajdɛtʃiku
ainda	aĩdɐ
ainhum	ajɲũ
aio	aju
aipim	ajpĩ
airbag	ɛɾbɛɡi
airela	ajɾɛlɐ
airoso	ajɾozu
aja	aʒɐ
ajoelhar	aʒoeʎaʁ
ajuda	aʒudɐ
ajudar	aʒudaʁ
ajustar	aʒustaʁ
akita	akitɐ
al	aw
ala	alɐ
aladim	alad͡ʒĩ
alado	aladu
alagoas	alaɡoɐs
alambique	alɐ̃biki
alameda	alameda
alameda	alamedɐ
alameda	alamɛda
alameda	alamɛdɐ
alan	alɐ̃
alana	alɐnɐ
alaranjado	alaɾɐ̃ʒadʊ
alastrim	alastɾĩ
albano	awbɐnu
alberto	awbɛʁtu
albino	awbinu
albânia	awbaniɐ
albânia	awbanjɐ
alcachofra	awkaʃofɾa
alcalinidade	awkalinidad͡ʒi
alcaloide	awkalɔjd͡ʒi
alcance	awkɐ̃si
alcancia	awkɐ̃sia
alcancia	awkɐ̃siɐ
alcanzia	awkɐ̃ziɐ
alcançar	awkɐ̃saʁ
alcanço	awkɐ̃su
alcateia	awkateja
alcateia	awkatejɐ
alcateia	awkatɛja
alcateia	awkatɛjɐ
alcatrão	awkatɾɐ̃w
alce	awsi
alceu	awsew
alcorão	awkoɾɐ̃w̃
alcíone	awsioni
aldeia	awdejɐ
alecrim	alekɾĩ
alecto	alɛktu
alegadamente	aleɡadamẽt͡ʃi
alegação	aleɡasɐ̃w̃
alegre	alɛɡɾɪ
alegrete	aleɡɾet͡ʃi
alegria	aleɡɾiɐ
alegria	aliɡɾiɐ
aleijado	alejʒadu
aleixo	alejʃu
aleluia	alelujɐ
alemanha	alemɐɲɐ
alentejo	alẽtɛʒu
alento	alẽtu
alepo	alɛpu
aleppo	alɛpu
alerta	alɛʁtɐ
alertamente	alɛʁtamẽt͡ʃi
alessandro	alesɐ̃dɾu
alexander	aleksɐ̃deʁ
alexandra	aleʃɐ̃dɾɐ
alexandre	aleʃɐ̃dɾi
alfabetização	awfabet͡ʃizasɐ̃w̃
alfabeto	awfabɛtu
alface	awfasi
alfacinha	awfasiɲɐ
alfarrobeira	awfaʁobejɾɐ
alfarrábio	awfaʁabiu
alfarrábio	awfaʁabju
alfeu	awfew
alfinete	awfinɛtʃi
alfisol	awfisɔw
alfonso	awfõsu
alforria	awfoʁiɐ
alfredo	awfɾedu
algazarra	awɡazaʁa
algazarra	awɡazaʁɐ
algo	awɡo
algo	awɡu
algo	aɻɡo
algum	awɡũ
alguma	awɡuma
alguma	awɡumɐ
alguma	awɡũɐ
algures	awɡuɾis
alguém	awɡẽj̃
alheio	aʎeju
alho	aʎu
ali	ali
aliança	aliɐ̃sa
aliança	aliɐ̃sɐ
alicate	alikat͡ʃi
alicatear	alikateaɾ
alice	alisi
alien	aliẽj̃
alienação	alienasɐ̃w̃
alienígena	alieniʒena
alimentar	alimẽtaʁ
alimento	alimẽto
alimento	alimẽtu
aline	alini
alinhado	aliɲadu
aliás	aliajs
aliás	aljajs
alma	awmɐ
almanjarra	awmɐ̃ʒaʁa
almanjarra	awmɐ̃ʒaʁɐ
alminha	awmiɲɐ
alminhas	awmiɲɐs
almofada	awmufada
almofada	awmufadɐ
almoxarifado	awmoʃaɾifadu
almoçar	awmosaʁ
almoço	awmosu
almoço	awmɔsu
almoção	awmosɐ̃w̃
almude	awmudi
aloísio	aloizju
aloísio	aluizju
alpendre	awpẽdɾi
alpestre	aɫpɛʃtɾi
alsácia	awsasjɐ
alta	awtɐ
altear	awteaɾ
altera	aɫtɛɾa
alterar	awteɾaʁ
alternativa	awteʁnatʃivɐ
alto	awtu
altura	awtuɾɐ
altônia	awtoniɐ
altônia	awtonjɐ
aluado	alwadu
alude	alud͡ʒi
aluna	alũnɐ
alunas	alũnɐs
alunas	alũnɐʃ
aluno	alunu
alva	awva
alva	awvɐ
alvacenta	awvasẽta
alvacento	awvasẽtu
alves	awvis
alvino	awvinu
alvo	awvu
alvorotando	awvoɾotɐ̃du
alvorotar	awvoɾotaʁ
alvoroçar	awvoɾosaʁ
alvoroço	awvoɾosu
alvoroço	awvoɾɔsu
alá	ala
alça	awsɐ
além	alẽj̃
alívio	aliviu
alívio	alivju
alô	alo
ama	ɐmɐ
amadeu	amadew
amaneirar	amɐnejɾaɾ
amanhecer	amɐɲeseʁ
amanhã	amɐɲɐ̃
amanhã	ɐmɐɲɐ̃
amanteigado	amɐ̃tejɡadu
amaporã	amapoɾɐ̃
amapá	ɐmɐpa
amar	ɐmaʁ
amaral	ɐmaɾaw
amarelo	amaɾɛlu
amarelo	ɐmaɾɛlu
amargura	amɐɾɡuɾa
amargura	amɐʁɡuɾa
amarone	ɐmaɾoni
amassar	amasaʁ
amaterasu	ɐmateɾasu
amavio	amaviu
amavioso	amaviozu
amazonas	ɐmazonɐs
amazonita	ɐmɐzunitɐ
amazonítico	ɐmɐzunitiku
amazônia	amazonja
ambas	ɐ̃bɐs
ambaíba	ɐ̃baibɐ
ambiente	ɐ̃biẽt͡ʃi
ambientes	ɐ̃biẽtʃis
ambição	ɐ̃bisɐ̃w̃
ambos	ɐ̃bus
ambrósio	ɐ̃bɾɔzju
ambíguo	ɐ̃biɡwu
ameaça	ameasa
ameaça	ameasɐ
amendoim	amẽduĩ
ameno	ɐmenu
americana	ameɾikɐnɐ
amiga	ɐmiɡɐ
amigar	amiɡaʁ
amigar	ɐmiɡaʁ
amigdalite	ɐmidalit͡ʃi
amigo	amiɡo
amigo	amiɡu
amiguinho	amiɡiɲu
amistoso	amistozu
amistoso	amiʃtozu
amolar	amolaɾ
amontoado	ɐmõtuadu
amor	ɐmoʁ
amoroso	amoɾozo
amortizai	amoʁt͡ʃizaj
amostra	amɔstɾɐ
amplo	ɐ̃plu
ampola	ɐ̃polɐ
ampulheta	ɐ̃puʎeta
ampulheta	ɐ̃puʎetɐ
ampére	ɐ̃pɛɾi
amuleto	amuletʊ
amália	amaljɐ
amélia	amɛljɐ
amém	amẽj̃
américa	amɛɾikɐ
amêndoa	amẽduɐ
amêndoa	amẽdwɐ
amígdala	ɐmidalɐ
amílcar	amiwkaʁ
amós	amɔs
ana	ɐnɐ
analisar	ɐnalizaʁ
analista	analista
analista	analistɐ
analista	analiʃtɐ
anarquia	anaʁkia
anarquia	anaʁkiɐ
anastácio	anastasju
anastásio	anastazju
ancestral	ɐ̃sestraw
ancho	ɐ̃ʃu
anchova	ɐ̃ʃovɐ
anchovado	ɐ̃ʃovadu
anchoveta	ɐ̃ʃovetɐ
ancinho	ɐ̃siɲu
ancora	ɐ̃kɔɾɐ
ancorar	ɐ̃koɾaʁ
anda	ɐ̃dɐ
andando	ɐ̃dɐ̃du
andar	ɐ̃daʁ
andes	ɐ̃d͡ʒis
andirá	ɐ̃d͡ʒiɾa
andor	ɐ̃dor
andorinha	ɐ̃doɾĩɲɐ
andorra	ɐ̃doʁɐ
andrajo	ɐ̃dɾaʒu
andrajoso	ɐ̃dɾaʒozo
andré	ɐ̃dɾɛ
andrômeda	ɐ̃dɾomedɐ
anedonia	anedoniɐ
anedota	ɐ̃nedɔtɐ
anelisa	ɐnelizɐ
anestésico	anestɛziku
anexo	ɐnɛksu
angelim	ɐ̃ʒelĩ
angola	ɐ̃ɡɔlɐ
anguila	ɐ̃ɡilɐ
anguloso	ɐ̃ɡulozu
angélica	ɐ̃ʒɛlikɐ
anho	ɐɲu
anilina	anilina
anima	animɐ
anima	ɐnimɐ
animais	animajs
animais	ɐnimajs
animal	ɐnimaw
animam	animɐ̃w̃
animam	ɐnimɐ̃w̃
animar	animaʁ
anime	animi
animosidade	ɐnimozidad͡ʒi
animê	anime
aninhado	aniɲadu
anita	ɐnitɐ
anjo	ɐ̃ʒu
anjou	ɐ̃ʒu
ano	ɐnu
anonimato	ɐnunimatu
anos	ɐnus
anos	ɐnuʃ
anotar	ɐnotaʁ
anotação	anotasɐ̃w̃
anselmo	ɐ̃sɛwmu
ansim	ɐ̃sĩ
anta	ɐ̃ta
anta	ɐ̃tɐ
antanho	ɐ̃tɐɲu
antano	ɐ̃tɐnu
anteontem	õt͡ʃiõtẽj̃
anteontem	ɐ̃t͡ʃiõtẽj̃
anteontem	ɐ̃t͡ʃjõtẽj̃
antepara	ɐ̃tepaɾa
anteporia	ɐ̃tepoɾia
anterior	ɐ̃teɾioʁ
antes	ɐ̃tes
antes	ɐ̃tis
antes	ɐ̃t͡ʃis
antibullying	ɐ̃t͡ʃibulĩ
anticoagulante	ɐ̃t͡ʃikoaɡulɐ̃t͡ʃi
anticristo	ɐ̃t͡ʃikɾistu
anticultural	ɐ̃t͡ʃikuwtuɾaw
antiderrapante	ɐ̃t͡ʃideʁapɐ̃t͡ʃi
antidopagem	ɐ̃t͡ʃidopaʒẽj̃
antifumo	ɐ̃t͡ʃifumu
antigamente	ɐ̃tiɡamẽtɪ
antigamente	ɐ̃t͡ʃiɡamẽt͡ʃi
antigo	ɐ̃tiɡu
antigo	ɐ̃t͡ʃiɡo
antigo	ɐ̃t͡ʃiɡu
antiguidade	ɐ̃t͡ʃiɡwidad͡ʒi
antimonárquico	ɐ̃t͡ʃimonaʁkiku
antimoral	ɐ̃t͡ʃimoɾaw
antitético	ɐ̃t͡ʃitɛt͡ʃiku
antonieta	ɐ̃tonietɐ
antonieta	ɐ̃tonjetɐ
antonina	ɐ̃toninɐ
antropofagia	ãtɾopofaʒia
antuérpia	ɐ̃tuɛʁpjɐ
antífona	ɐ̃t͡ʃifona
antônio	ɐ̃tonju
anual	anuaw
anual	ɐnuaw
anuir	ɐnuir
anunciar	anũsiaʁ
anuência	anuẽsja
anzol	ɐ̃zɔw
análise	ɐnalizi
anápolis	anapolis
anápolis	ɐnapolis
anão	anɐ̃w̃
aníbal	anibaw
aníbal	ɐnibaw
anómalo	anomalu
anúbis	anubis
ao	aw
aonde	aõde
aonde	aõdi
aonde	aõd͡ʒ
aonde	aõd͡ʒi
aos	aws
aosta	aɔstɐ
apagar	apaɡaʁ
apaixonar	apajʃonaʁ
apalaches	apalaʃis
apalpadela	apawpadɛlɐ
apalpadelas	apawpadɛlɐs
apanhado	apɐɲadu
apanhar	apɐɲaɹ
apanhar	apɐɲaɻ
apanhar	apɐɲaʁ
apanhar	apɐɲaχ
aparato	apaɾatu
aparece	apaɾɛsi
aparecer	apaɾeseʁ
aparelho	apaɾeʎu
aparelho	apaɾɛʎu
aparentar	apaɾẽtaʁ
aparente	apaɾẽt͡ʃi
apartamento	apaʁtɐmẽtu
aparência	apaɾẽsjɐ
apatetado	apatetadu
apavorado	apavoɾadu
apaziguamento	apaziɡwamẽtu
apelar	apelaʁ
apelido	apelidu
apelo	apelu
apenas	apenɐs
apenas	apenɐʃ
apeninos	apeninus
aperfeiçoar	ɐpeɹfejsoaɾ
apertar	apeʁtaʁ
apesar	apezaʁ
apetite	apet͡ʃit͡ʃi
apetite	apit͡ʃit͡ʃi
apetência	apetẽsiɐ
api	apei
aplacar	ɐplɐkar
aplauso	aplawzu
aplicar	aplikah
aplicar	aplikaɹ
aplicar	aplikaɻ
aplicar	aplikaɾ
aplicar	aplikaʁ
aplicar	aplikaχ
aplicação	aplikasɐ̃w̃
apoderar	apodeɾaʁ
apoiar	apojaʁ
apoio	apoju
apontamento	apõtamẽtu
apontar	apõtaʁ
aporrinhação	apohiɲasɐ̃w̃
aposentadoria	apozẽtadoɾia
aposentadoria	apozẽtadoɾiɐ
aposentar	apozẽtaʁ
apreciar	apɾesiaʁ
apreender	apɾeẽdeʁ
apreender	apɾj̃ẽdeʁ
aprender	apɾẽdeʁ
apresenta	apɾezẽtɐ
apresentam	apɾezẽtɐ̃w̃
apresentar	apɾezẽtaʁ
apresentaram	apɾezẽtaɾɐ̃w̃
apressar	apɾesaʁ
apreço	apɾesu
apreço	apɾɛsu
aprimorar	apɾimoɾaʁ
apropriado	apɾopɾiadu
aproveitar	apɾovejtaʁ
aproximar	apɾosimaɾ
aproximar	apɾosimaχ
aproximar	apɾɔsimah
apucarana	apukarɐnɐ
apurar	apuɾaɾ
apurar	apuɾaχ
apuro	apuɾu
após	apɔjs
apúlia	apuljɐ
aquela	akɛlɐ
aquelas	akɛlɐs
aquele	akele
aquele	akeli
aqueles	akeles
aqueles	akelis
aqui	aki
aquilo	akilu
aquitânia	akitɐnjɐ
aquém	akej̃
aquém	akwej̃
ar	ah
ar	aɹ
ar	aʁ
arado	aɾadu
aragem	aɾaʒẽj̃
aragão	aɾaɡɐ̃w̃
arainha	aɾɐ̃iɲa
arame	aɾɐme
arame	aɾɐmi
arando	aɾɐ̃du
aranha	aɾɐ̃ɲa
aranha	aɾɐ̃ɲɐ
aranhiço	aɾɐɲisu
aranhiços	aɾɐɲisu
arapongas	aɾapõɡɐs
arapoti	aɾapot͡ʃi
arapuã	aɾapuɐ̃
araruna	aɾaɾunɐ
arau	aɾaw
araucária	aɾawkaɾiɐ
araújo	aɾauʒu
arbitramento	aʁbitɾɐmẽtu
arca	aʁkɐ
arcanjo	axkɐ̃ʒu
arcanjo	aɾkɐ̃ʒu
arcanjo	aχkɐ̃ʒu
arcano	aʁkɐnu
arcar	aʁkaʁ
arconte	aʁkõt͡ʃi
arcádia	aʁkad͡ʒiɐ
arder	aʁdeʁ
areal	aɾeaw
areal	aɾiaw
areia	aɾejɐ
arejado	aɾeʒadu
arena	aɾena
arenoso	aɾenozu
argel	aʁʒɛw
argentina	aʁʒẽt͡ʃĩnɐ
argila	aʁʒila
argila	aʁʒilɐ
argola	aɾɡɔla
argola	aʁɡɔla
argot	aʁɡo
argumentar	aɹɡumẽtaɹ
argumentar	aɻɡumẽtaɻ
argumentar	aɾɡumẽtaɾ
argumentar	aʁɡumẽtaʁ
ariano	aɾiɐnu
ariele	aɾiɛli
ariele	aɾjɛli
arigatô	aɾiɡato
arizona	aɾizonɐ
arlene	aʁleni
arma	ahma
arma	ahmɐ
arma	axmɐ
arma	aɹmɐ
arma	aɻma
arma	aɾmɐ
arma	aʁmɐ
armado	aʁmadu
armamentista	aɾmamẽtʃista
armamentista	aʁmamẽtʃijʃta
armando	aʁmɐ̃du
arminha	aʁmiɲɐ
armário	aʁmaɾju
armórica	aʁmɔɾikɐ
arno	aʁnu
aro	aɾu
aromatizar	aɾomat͡ʃizaʁ
arqueiro	aʁkejɾu
arquibaldo	aʁkibawdu
arquimedes	aʁkimɛd͡ʒis
arquivo	aʁkivu
arrais	aʁajs
arrais	aʁajʃ
arranhar	aʁɐɲaʁ
arranjado	aʁɐ̃ʒadu
arranjar	aʁɐ̃ʒaʁ
arranque	aʁɐ̃ki
arrastamento	aʁastamẽtu
arrastamento	aʁastɐmẽtu
arrastamento	aʁaʃtɐmẽtu
arrastão	aʁastɐ̃w̃
arrastão	aʁaʃtɐ̃w̃
arrebol	aʁebɔw
arredondar	aʁedõdaʁ
arregalar	aʁeɡalaʁ
arregimentar	aʁeʒimẽtaɾ
arregimentar	aʁeʒimẽtaʁ
arremete	aʁemɛtʃi
arrente	axẽti
arrente	aʁẽti
arrepiado	aʁepiadu
arrepiado	aʁepjadu
arriba	aʁibɐ
arriscar	aʁiskaʁ
arritmia	aʁit͡ʃimia
arritmia	aʁit͡ʃimiɐ
arrivederci	aʁivedeʁt͡ʃi
arrojo	aʁoʒu
arrojo	aʁɔʒu
arroto	aʁotu
arroto	aʁɔtu
arroz	ahojs
arroz	aʁojs
arruaça	aʁuasa
arruinar	ahuinaʁ
arrumador	aʁumadoʁ
arte	ahti
arte	aht͡ʃ
arte	aɹte
arte	aɹt͡ʃi
arte	aɾte
arte	aɾt͡ʃ
arte	aɾt͡ʃi
arte	aʁt͡ʃi
arte	aχt͡ʃ
arte	aχt͡ʃi
artigo	aɹtʃiɡʊ
artigo	aɻtʃiɡo
artigo	aʁtʃiɡu
artigo	aχtʃiɡʊ
artista	aɾtʃistɐ
artista	aχtʃiʃtɐ
artur	aʁtuʁ
artículo	aʁt͡ʃikulu
artística	aʁt͡ʃist͡ʃikɐ
artísticas	aʁt͡ʃist͡ʃikɐs
artístico	aʁt͡ʃist͡ʃiku
artísticos	aʁt͡ʃist͡ʃikus
arábico	aɾabiku
as	as
asa	azɐ
asar	azaʁ
ascender	asẽdeʁ
ascenso	asẽsu
ascensão	asẽsɐ̃w̃
ascese	asɛzi
ascii	aski
asclépio	asklɛpju
asfalto	asfawtu
ashanti	aʃɐ̃t͡ʃi
asno	aʒnu
aspa	aspɐ
aspa	aʃpɐ
aspecto	aspɛkitu
aspecto	aspɛktu
aspereza	aspeɾeza
aspereza	aspeɾezɐ
assassinato	asasinatu
assaí	asai
assegurar	aseɡuɾaʁ
assembleia	asẽblɛja
assembleia	asẽblɛjɐ
assento	asẽtu
asserção	aseʁsɐ̃w̃
assessor	asesoɹ
assessor	asesoχ
assessorar	asesoɾaɹ
assessorar	asesoɾaχ
assessoria	asesoɾia
assim	asĩ
assimilação	asimilasɐ̃w̃
assinar	asinaʁ
assiriologia	asiɾioloʒia
assiriologia	asiɾjoloʒia
assistir	asijʃt͡ʃiχ
assistir	asist͡ʃiɹ
assistir	asist͡ʃiɻ
assistir	asist͡ʃiʁ
assistir	asiʃtiχ
assistência	asistẽsjɐ
asso	asu
assoalho	asuaʎu
assobio	asobiu
assobio	asubiu
associais	asosjajs
associação	asosiasɐ̃w̃
associação	asosjasɐ̃w̃
assumir	asumiʁ
assunto	asũtu
assur	asuɾ
assustador	asustadoʁ
assustadores	asustadoɾis
assíria	asiɾiɐ
assíria	asiɾjɐ
astana	astɐnɐ
astenia	ajʃtenia
astenia	astenia
astorga	astɔʁɡɐ
astride	astɾid͡ʒi
astro	ajʃtɾu
astro	astɾu
astuto	astutu
astúcia	astusiɐ
atacar	atakaʁ
atalaia	atalajɐ
ataque	ataki
atarracado	ataʁakadu
atarracar	ataʁakaɾ
atenas	atenɐs
atender	atẽdeʁ
atendimento	atẽd͡ʒimẽtu
atenção	atẽsɐ̃w̃
aterrissar	ateʁisaʁ
aterrizagem	ateʁizaʒẽj̃
aterro	ateʁu
aterro	atɛʁu
aterrou	ateʁow
ateísmo	ateizmu
ateísta	ateistɐ
atinente	at͡ʃinẽt͡ʃi
atingir	at͡ʃĩʒiʁ
atirador	at͡ʃiɾadoʁ
atitude	atʃitudʒi
ativar	at͡ʃivaʁ
atividade	at͡ʃividade
atividade	at͡ʃividad͡ʒi
ativo	at͡ʃivu
atlas	atlas
atlas	atlɐs
atlântico	atlɐ̃t͡ʃiku
atmosfera	atʃimosfɛɾɐ
atmosfera	atʃmosfɛɾɐ
ato	atu
atraente	atɾaẽtʃi
atrair	atɾaiʁ
atrapalhar	atɾapaʎaʁ
atrasado	atɾazadu
atravessar	atɾavesaɾ
atravessar	atɾavesaʁ
através	atɾavɛjs
atrito	atɾitu
atrás	atɾajs
atrás	atɾajʃ
atual	atuaw
atualmente	atuawmẽtʃi
atuar	atuaʁ
atum	atũ
aturar	atuɾaʁ
aturo	atuɾu
até	atɛ
audiência	awdʒiẽsjɐ
auge	awʒi
augusto	awɡustu
aula	awla
aulas	awɫas
aulinha	awliɲɐ
aumentar	awmẽtaɹ
aumentar	awmẽtaɻ
aumentar	awmẽtaʁ
aumentar	awmẽtaχ
aumento	awmẽtu
aurora	awɾɔɾɐ
aurélia	awɾɛljɐ
aurélio	awɾɛlju
austro	awstɾu
austro	awʃtɾu
austrália	awstɾaljɐ
ausência	awzẽsjɐ
autarca	awtaʁkɐ
autenticidade	awtẽt͡ʃisidad͡ʒi
auto	awtu
autocolante	awtukolɐ̃t͡ʃi
autoevidente	awtuevidẽt͡ʃi
automobilista	awtomobilistɐ
automobilistas	awtomobilistɐs
autor	awtoʁ
autoridade	awtoɾidad͡ʒi
autômato	awtomatu
auxiliar	awsiliaʁ
auxiliar	awsiljaʁ
auxílio	awsiliw
auxílio	awsilju
avalanche	avalɐ̃ʃi
avaliar	avaliaʁ
avaliação	avaliasɐ̃w̃
avanço	avɐ̃su
ave	avi
aveia	avejɐ
avental	avẽtaw
aventurado	avẽtuɾadu
aventureiro	avẽtuɾejɾu
aventuro	avẽtuɾu
avisar	avizaʁ
avistamento	avistamẽtu
avistamento	aviʃtamẽtu
avó	avɔ
avô	avo
azagaia	azaɡajɐ
azar	azaʁ
azarento	azarẽtu
azedinha	azed͡ʒiɲɐ
azeite	azejt͡ʃi
azeiteiro	azejtejɾu
azevinho	azeviɲu
azinheira	aziɲejɾa
azinheira	aziɲejɾɐ
azáfama	azafɐmɐ
açafrão	asafɾɐ̃w̃
açaí	asai
aço	asu
açoite	asojt͡ʃi
açougue	asowɡi
açucena	asusenɐ
açude	asud͡ʒi
açular	asulaʁ
ação	asɐ̃w̃
açúcar	asukɐʁ
aécio	aɛsju
aéreo	aɛɾju
aê	ae
aí	ai
baba	babɐ
babaca	babaka
babau	babaw
babaçu	babasu
babaçuê	babasue
babaçuê	babɐsue
babe	babi
babista	babistɐ
babosa	babɔzɐ
baboseira	babozejɾa
babou	babow
babá	baba
bacalhau	bakaʎaw
bacana	bakɐna
bacana	bakɐnɐ
bacharel	baʃaɾɛw
bacharelas	baʃaɾɛlɐs
bacia	basiɐ
bacon	bejkõ
badameco	badamɛku
bafo	bafu
baga	baɡa
baga	baɡɐ
bagatela	baɡatɛla
bagel	bɛjɡew
bagre	baɡɾi
baguete	baɡɛtʃi
bahamas	bahɐmɐs
bahamas	baɐmɐs
baiano	bajɐ̃nu
baical	bajkaw
bailanta	bajlãta
baile	bajli
bainha	bɐiɲɐ
baioneta	bajonetɐ
bairro	bajʁu
baita	bajta
baita	bajtɐ
baitar	aj
baixada	bajʃadɐ
baixista	bajʃistɐ
baixo	bajʃu
balada	baladɐ
balalaika	balalajkɐ
balança	balɐ̃sa
balança	balɐ̃sɐ
balançar	balɐ̃saʁ
balanço	balɐ̃su
balaço	balasu
balde	bawd͡ʒi
baldio	bawdʒiu
bale	bali
balear	baleaʁ
baleares	baleɐɾis
baleeiro	baliejɾu
balista	balista
baliza	baliza
baliza	balizɐ
balzaca	bawzaka
balzaquiana	bawzakjɐ̃na
balzaquiano	bawzakiɐnu
balázio	balazju
balão	balɐ̃w̃
balãozinho	balɐ̃w̃ziɲu
balé	bɐlɛ
balípodo	balipodu
bambu	bɐ̃bu
banana	banɐnɐ
banana	bɐnɐnɐ
bancar	bɐ̃kaʁ
banco	bɐ̃ku
banda	bɐ̃dɐ
bandeira	bɐ̃dejɾɐ
bandeirantes	bɐ̃dejɾɐ̃t͡ʃis
bandeja	bɐ̃deʒa
bandicoot	bɐ̃d͡ʒikut͡ʃi
bandido	bɐ̃d͡ʒidu
bando	bɐ̃du
bandolim	bɐ̃dulĩ
banguela	bɐ̃ɡɛla
banha	bɐɲɐ
banhado	bɐɲadu
banheira	bɐɲejɾa
banheira	bɐɲejɾɐ
banheiro	bɐɲejɾu
banho	bɐɲu
banir	bɐniʁ
banquete	bɐ̃ketʃi
bar	baʁ
barato	baɾatu
baraço	baɾasu
barba	baɹbɐ
barba	baʁbɐ
barbeador	baʁbjadoʁ
barco	baʁku
barqueiro	baʁkejɾu
barra	baʁɐ
barracão	baʁakɐ̃w̃
barro	baʁu
bartolomeu	baʁtolomew
barulhinho	baɾuliɲu
barulhinho	baɾuʎiɲu
barulho	baɾuʎo
barulho	baɾuʎu
basalto	bazawtu
base	bazi
baseado	bazjadu
bastante	bastɐ̃t͡ʃi
bastante	baʃtɐ̃t͡ʃi
basílio	bazilju
batalha	bataʎa
batalha	bataʎɐ
batata	batatɐ
batatona	batatonɐ
bater	bateʁ
batina	batʃina
batismo	bat͡ʃizmu
batista	batʃistɐ
batom	batõw̃
batráquio	batɾakju
bauzinho	bauziɲu
bavária	bavaɾiɐ
bavária	bavaɾjɐ
bazar	bazaʁ
bazófia	bazɔfja
baça	basɐ
baço	basu
baía	baiɐ
beatriz	beatɾis
bebe	bɛbi
bebedeira	bebedejɾa
beber	bebeʁ
bebida	bebidɐ
bebo	bebu
bebê	bebe
beca	bɛka
beco	beku
bege	bɛʒi
beijar	bejʒaχ
beijinho	bejʒiɲu
beijo	bejʒu
beijo	beʒu
beijoqueiro	bejʒokejɾu
beira	bejɾɐ
beiço	bejsu
beladona	bɛladona
beleza	belezɐ
belezura	belezuɾa
belga	bɛwɡɐ
belicista	bɛlisistɐ
beliscar	beliskaʁ
belvedere	bɛwvedɛɾi
belém	belẽj̃
bem	bẽj̃
bemol	bemɔw
bemol	bemɔɫ
bemóis	bemɔjs
bemóis	bemɔjʃ
bend	bẽd͡ʒ
bendição	bẽd͡ʒisɐ̃w̃
benedito	bened͡ʒitu
beneficiar	benefisiaʁ
benefício	benefisju
benemérita	benemɛɾitɐ
benesse	benɛsi
benevento	benevẽtu
bengala	bẽɡala
bengali	bẽɡali
benignidade	beniɡnidadʒi
benigno	beniɡinu
benta	bẽta
benta	bẽtɐ
bento	bẽtu
beque	bɛki
berilo	beɾilu
beringela	biɾĩʒɛla
berlim	beʁlĩ
berlinês	bɛʁlines
bermudas	beʁmudɐs
bernardo	beʁnaʁdu
beslan	bezlɐ̃
besta	bestɐ
besta	beʃtɐ
besta	bɛstɐ
besta	bɛʃtɐ
besteiro	bestejɾu
besteirol	bestejɾɔw
betar	betaɾ
betar	betaχ
bete	bɛtʃi
betume	betumi
bexiga	beʃiɡa
bezerro	bezeʁu
biblioteca	bibljotɛkɐ
bibliógrafo	bibliɔɡɾafu
bicar	bikaʁ
bicha	biʃɐ
bichado	biʃadu
bichinho	biʃiɲu
bicho	biʃu
bicicleta	bisiklɛta
bicla	biklɐ
bico	biku
bicuda	bikuda
bicudo	bikudu
bidê	bide
bielorrusso	bjɛloʁusu
bienal	bienaw
bigode	biɡɔd͡ʒi
bilha	biʎɐ
bilhete	biʎetʃi
bilheteira	biʎetejɾa
bilheteira	biʎetejɾɐ
bilheteiro	biʎetejɾu
bilhão	biʎɐ̃w̃
bilro	biwɦu
bimbar	bĩbah
bimbar	bĩbaɹ
bimbar	bĩbaɻ
bimbar	bĩbaʁ
biologista	bioloʒia
bioquímica	biokimikɐ
birra	biʁa
birra	biʁɐ
biruta	biɾutɐ
bis	bis
bis	biʃ
bisavó	bizavɔ
bisavô	bizavo
bisbilhotice	bizbiʎot͡ʃisi
biscoito	biskojtu
bishkek	biʃkɛk
bispo	bispu
bisu	bizu
bit	biti
bit	bit͡ʃi
bituca	bitukɐ
bituruna	bituɾunɐ
biênio	bienju
biónico	bioniku
biônico	bioniku
blenda	blẽdɐ
blica	blika
blitz	blits
blocagem	blokaʒẽj̃
bluetooth	blutu
bluetooth	bluwtuf
blush	blɐʃ
boa	boɐ
boas	bowas
boas	bowaʃ
boate	boate
boate	boat͡ʃi
boate	buat͡ʃ
boate	buat͡ʃi
boazona	boazonɐ
bob	bɔbi
bobes	bɔbis
bobinar	bobinaʁ
bobo	bobu
boboca	bobɔka
boca	bokɐ
bocado	bokadu
bocado	bukadu
bocejo	boseʒu
bocha	bɔt͡ʃɐ
bocha	bɔʃɐ
bochicho	buʃiʃu
boco	boku
bocó	bokɔ
boda	bodɐ
boeing	bɔj̃ɡ
boi	boj
boiadeiro	bojadejɾu
boiardo	bojaʁdu
bola	bɔlɐ
bolapé	bolapɛ
bolapé	bɔlapɛ
bolas	bɔlas
boleto	buletu
bolha	boʎɐ
boliche	boliʃi
bollywood	bɔliwud͡ʒ
bolo	bolu
bolota	bolɔta
bolsa	bowsɐ
bolsa	boɻsɐ
bolsominion	bowsominiõ
bolsominion	bowsominjõ
bolsonaro	bɔwsunaɾu
bolívia	bolivjɐ
bom	bõ
bomba	bõbɐ
bombado	bõbadu
bombaim	bõbaĩ
bombar	bõbaʁ
bombas	bõbɐ
bombava	bõbavɐ
bombeiro	bõbejɾu
bombo	bõbu
bombom	bõbõ
bombril	bõbɾiw
bonacheirão	bonaʃejɾɐ̃w̃
bonachão	bonaʃɐ̃w̃
bonde	bõdi
bondoso	bõdozu
bonina	bonina
bonina	boninɐ
bonitinho	bonit͡ʃiɲu
bonitinho	bunit͡ʃiɲu
bonito	bonitu
bons	bõs
bons	bõʃ
bonsai	bõsaj
boné	bonɛ
booleano	buleɐnu
booleano	buliɐnu
bope	bɔpi
boquete	bokɛtʃi
borboleta	boʁboleta
borboleta	boʁboletɐ
borboletear	boʁboleteaʁ
borda	bɔʁdɐ
bordel	boɾdɛw
bordo	boʁdu
bordo	bɔʁdu
bordoada	buɾduadɐ
borrar	boʁaʁ
borrazópolis	boʁazɔpolis
bosque	bɔski
bosquímano	boskimɐnu
bosquímano	boʃkimɐnu
bosta	bɔstɐ
boston	bɔstõ
bot	bɔt
bot	bɔt͡ʃ
bota	bɔtɐ
botar	botaɾ
bote	bɔt͡ʃi
boticário	botʃikaɾju
boto	botu
boto	bɔtu
box	bɔks
boçal	bosaw
boçal	bosaɫ
brabo	bɾabu
bracelete	bɾaseletʃi
braganey	bɾaɡanej
bragança	bɾaɡɐ̃sɐ
branca	bɾɐ̃kɐ
branco	bɾɐ̃ku
brando	bɾɐ̃du
brasil	bɾaziw
brasileiro	bɾazilejɾu
brasileiro	bɾɐzilejɾu
brasilidade	bɾazilidadʒi
brasis	bɾazis
brasília	bɾaziljɐ
bravateiro	bɾavatejɾu
bravo	bɾavu
bravura	bɾavuɾa
braço	bɾasu
breakdance	bɾejkidẽsɪ
breca	bɾɛkɐ
brecha	bɾɛʃa
bregueço	bɾeɡesu
breja	bɾeʒa
breja	bɾɛʒa
brejeirar	breʒejɾaɾ
brejeirar	breʒejɾaʁ
brejeirice	breʒejɾisi
brejeiro	bɾeʒejɾu
brejo	bɾɛʒu
bretanha	bɾetɐɲɐ
bretão	bɾetɐ̃w̃
breu	bɾew
breve	bɾɛvi
brida	bɾidɐ
briga	bɾiɡɐ
brigada	bɾiɡadɐ
brigar	bɾiɡaʁ
brilhante	bɾiʎɐ̃tʃi
brilhar	bɾiʎaʁ
brincadeira	bɾĩkadejɾɐ
brincar	bɾĩkaʁ
brinco	bɾĩku
brindisi	bɾĩdʒizi
brinquedo	bɾĩkedu
bristol	bɾistow
broa	bɾoa
broa	bɾoɐ
broche	bɾɔʃi
brochura	bɾoʃuɾa
broderagem	bɾodeɾaʒẽj̃
brodo	bɾɔdu
bronze	bɾõzi
broquel	bɾokɛw
brotar	bɾotaʁ
bruaca	bruaka
bruno	bɾunu
brusqueta	bɾusketɐ
bruxa	bɾuʃɐ
bruxelas	bɾuʃɛlɐs
bruxo	bɾuʃʊ
bruços	bɾusus
brício	bɾisju
brígida	bɾiʒidɐ
bróder	brɔdeʁ
bucareste	bukaɾɛst͡ʃi
buchicho	buʃiʃu
bucéfalo	busɛfalu
bucólico	bukɔliku
buda	budɐ
budapeste	budapɛst͡ʃi
buffer	bɐfeʁ
buffet	bife
bufo	bufu
bufê	bufe
bug	buɡ
bug	buɡi
bug	bɐɡ
bug	bɐɡi
bugar	buɡaɾ
bugio	buʒiu
bugre	buɡɾi
bula	bula
bulbo	buwbu
bulgária	buwɡaɾjɐ
bulhufas	buʎufajʃ
bulhufas	buʎufas
buliçoso	bulisozu
bullying	bulĩ
bumbum	bũbũ
bunda	bũdɐ
buque	buki
buquê	buke
buraco	buɾaku
buscar	buskaʁ
busto	bustu
busão	buzɐ̃w̃
butiá	but͡ʃia
butiá	but͡ʃja
buxo	buʃu
bv	beve
bypass	bajpɛs
byte	bajtʃi
bácoro	bakoɾu
bálcãs	bawkɐ̃s
básico	baziku
bão	bɐ̃w̃
bélgica	bɛwʒikɐ
bélico	bɛliku
bê	be
bênção	bẽsɐ̃w̃
bíblia	bibliɐ
bíblia	bibljɐ
bípede	bipedʒi
bóbi	bɔbi
bóbis	bɔbis
bóris	bɔɾis
bósforo	bɔsfoɾu
bósnia	bɔzniɐ
bósnia	bɔznjɐ
búlgaro	buwɡaɾu
bússola	busolɐ
cabaço	kabasu
cabe	kabi
cabelo	kabelu
caber	kabeʁ
cabeu	kabew
cabeça	kabesɐ
cabide	kabid͡ʒi
cabido	kabidu
cabisbaixo	kabiʒbajʃu
cabo	kabu
cabra	kabɾɐ
cabral	kabɾaw
cabul	kabuw
caca	kakɐ
cacareco	kakarɛku
cacete	kasetʃi
cachaça	kaʃasa
cachaça	kaʃasɐ
cachecol	kaʃekɔw
cachoeira	kaʃoejɾɐ
cachoeira	kaʃuejɾɐ
cachopo	kaʃopu
cachorro	kaʃoʁu
cachê	kaʃe
cacofonia	kakofoniɐ
cada	kadɐ
cadastrar	kadastɾaʁ
cadeado	kadeadu
cadeado	kadʒiadu
cadeado	kad͡ʒadu
cadeira	kadejɾɐ
cadela	kadɛlɐ
cadete	kadet͡ʃi
caduco	kaduku
cadê	kade
cadência	kadẽsjɐ
caetano	kaetɐ̃nu
cafofo	kafofu
cafona	kafona
cafoto	kafotu
cafuné	kafunɛ
café	kafɛ
cagueta	kaɡweta
cagueta	kaɡwɛta
caguetar	kaɡuetaɾ
caguetar	kaɡwetaɾ
caguete	kaɡwɛtʃi
caia	kajɐ
caiais	kajajs
caiam	kajɐ̃w̃
caiamos	kajɐmus
caias	kajɐs
caiem	kajẽj̃
caim	kaĩ
caim	kɐĩ
caimão	kajmɐ̃w̃
caio	kaju
caipira	kajpiɾɐ
caipirinha	kajpiɾiɲɐ
cair	kaiʁ
cais	kajs
cais	kajʃ
caixa	kajʃɐ
caixa	kaʃɐ
caixilho	kajʃiʎu
caixote	kajʃɔt͡ʃi
caixão	kajʃɐ̃w̃
caixão	kajʃɐ̃õ
caju	kaʒu
cajón	kaʁõ
calafrio	kalafɾiu
calafrio	kalafɾiw
calais	kalɛ
calar	kalaɻ
calar	kalaʁ
calcanhar	kawkɐɲaʁ
calculadora	kawkuladora
calculação	kawkulasɐ̃w̃
calcutá	kawkuta
caldo	kawdu
calebe	kalɛbi
calgary	kawɡaɾi
calhorda	kaʎɔɻda
calibre	kaʎibɾi
califa	kalifɐ
calipso	kalipsu
calistenia	kalistenia
calmaria	kawmaɾiɐ
calo	kalu
calor	kaloʁ
caloroso	kaloɾozu
calouro	kalowɾo
calouro	kalowɾu
calouro	kaloɾu
calvinismo	kawvinizmu
calão	kalɐ̃w̃
calça	kawsɐ
calçada	kawsada
calças	kawsɐs
calço	kawsu
cama	kɐmɐ
camada	kamada
camal	kamaw
camarada	kamaɾadɐ
cambará	kɐ̃baɾa
cambira	kɐ̃biɾɐ
cambridge	kejmbɹid͡ʒ
cambridge	kẽj̃bɹid͡ʒ
cambridge	kẽj̃bɾid͡ʒ
cambé	kɐ̃bɛ
camelo	kɐmelu
camelódromo	kamelɔdɾomu
camelô	kamelo
camerlengo	kameʁlẽɡu
camila	kamilɐ
camila	kɐmilɐ
caminhada	kamiɲada
caminhar	kamiɲaɻ
caminhar	kɐmiɲaɻ
caminhar	kɐmiɲaʁ
caminho	kɐmiɲu
caminhão	kamiɲɐ̃w̃
camisa	kɐmizɐ
camiseta	kamizetɐ
camisola	kamizɔla
camisola	kamizɔlɐ
camisola	kɐmizɔlɐ
camomila	kamomila
campanha	kɐ̃pɐɲa
campanha	kɐ̃pɐɲɐ
campesino	kɐ̃pezinu
campestre	kɐ̃pɛstɾi
campestre	kɐ̃pɛʃtɾi
campeã	kɐ̃piɐ̃
camping	kɐ̃pĩ
campo	kɐ̃po
campo	kɐ̃pu
camponês	kɐ̃ponejs
camponês	kɐ̃põnejʃ
campânia	kɐ̃pɐniɐ
camundongo	kamũdõɡu
cana	kɐna
cana	kɐnɐ
canadá	kɐnada
canal	kanaw
cananeu	kɐnɐnew
canaque	kanaki
candango	kɐ̃dɐ̃ɡu
candeeiro	kɐ̃d͡ʒiejɾo
candeeiro	kɐ̃d͡ʒiejɾu
candeeiro	kɐ̃d͡ʒjejɾo
candeeiro	kɐ̃d͡ʒjejɾu
candidato	kɐ̃d͡ʒidatu
candidatura	kɐ̃d͡ʒidatuɾɐ
candil	kɐ̃d͡ʒiw
candomblé	kɐ̃dõblɛ
candura	kãduɾa
candói	kɐ̃dɔj
caneco	kɐnɛku
canela	kɐnɛlɐ
caneta	kanetɐ
canhoto	kɐɲotu
canhão	kɐɲɐ̃w̃
canil	kɐniw
canivete	kanivɛte
canivete	kɐnivɛte
canja	kɐ̃ʒa
canja	kɐ̃ʒɐ
canoa	kɐnoɐ
cansaço	kɐ̃sasu
canseira	kɐ̃sejɾa
canso	kɐ̃su
cantar	kɐ̃taʁ
cante	kɐ̃t͡ʃi
cantiga	kɐ̃t͡ʃiɡɐ
cantina	kɐ̃t͡ʃina
canto	kɐ̃tu
cantochão	kɐ̃toʃɐ̃w̃
cantor	kɐ̃toʁ
cantoria	kɐ̃toɾia
cantoria	kɐ̃toɾiɐ
cantuária	kɐ̃tuaɾiɐ
cantão	kɐ̃tɐ̃w̃
canudo	kanudu
canção	kɐ̃sɐ̃w̃
caos	kaws
capa	kapɐ
capacete	kapasetʃi
capachinho	kapaʃiɲu
capacidade	kapasidadʒi
capacitância	kapasitɐ̃sia
capacitância	kapasitɐ̃sja
capanema	kapanemɐ
capaz	kapajs
capeta	kapetɐ
capetagem	kapetaʒẽj̃
capetagens	kapetaʒẽs
capetagens	kapetaʒẽʃ
capim	kapĩ
capitais	kɐpitaiʃ
capital	kapitaw
capitão	kapitɐ̃w̃
capixaba	kapiʃabɐ
capoeira	kapoejɾɐ
capoeira	kapuejɾɐ
capoeirista	kapuejɾistɐ
caprichar	kapɾiʃar
capricho	kapɾiʃu
capricórnio	kapɾikɔʁnju
captar	kaptaʁ
capturar	kapituɾaʁ
capturar	kaptuɾaʁ
capturo	kaptuɾu
capuz	kapujs
capuz	kapus
capão	kapãw
capítulo	kapitulu
caqui	kaki
cara	kaɾɐ
caracal	kaɾakaw
caracol	kaɾakɔw
caractere	kaɾakitɛɾi
caractere	kaɾaktɛɾi
característica	kaɾakteɾistʃikɐ
caralho	kaɾaʎu
caramba	kaɾɐ̃bɐ
carambeí	kaɾɐ̃bei
carambola	kaɾɐ̃bɔla
caraminhola	kaɾamij̃ɔla
caranguejeira	kaɾɐ̃ɡeʒejɾɐ
carapau	kaɾapaw
caratê	kaɾate
caravana	kaɾavɐna
caravela	kaɾavɛlɐ
carcanhol	kɐɾkɐɲɔɫ
cardinal	kaʁd͡ʒinaw
careca	kaɾɛkɐ
carente	kaɾẽt͡ʃi
cargo	kaʁɡu
carica	kɐrikɐ
caricatura	kaɾikatuɾa
caridade	kaɾidad͡ʒi
carimã	kaɾimɐ̃
carinho	kaɾiɲu
carioca	kaɾiɔkɐ
carioca	kaɾjɔkɐ
carlópolis	kaʁlɔpolis
carmim	kaɹmĩ
carmim	kaɾmĩ
carmim	kaʁmĩ
carnaval	kaʁnavaw
carne	kaɻne
carne	kaɾni
carne	kaʁni
carniça	kaʁnisɐ
carnífice	kaʁnifisi
caro	kaɾu
carola	kaɾɔla
carolina	kaɾolinɐ
caronte	kaɾõt͡ʃi
caroça	kaɾɔsɐ
caroçama	kaɾosɐma
caroçama	kaɾosɐmɐ
caroço	kaɾosu
caroçudo	kaɾosudu
carpete	kaɾpɛtʃi
carpinteiro	kaʁpĩtejɾu
carpo	kaɻpo
carranca	kaʁɐ̃kɐ
carrapato	kaʁapatu
carrapicho	kaʁapiʃu
carrasco	kaʁasku
carrasco	kaʁaʃku
carregar	kaheɡaɻ
carregar	kaʁeɡah
carregar	kaʁeɡax
carregar	kaʁeɡaɹ
carregar	kaʁeɡaʁ
carreira	kaʁejɾɐ
carreta	kɐʁetɐ
carro	kaʁo
carro	kaʁu
carroça	kaʁɔsa
carroça	kaʁɔsɐ
carta	kaʁtɐ
cartaz	kaɾtas
carteira	kaʁtejɾɐ
cartomante	kaʁtomɐ̃t͡ʃi
cartão	kaʁtɐ̃w̃
carvão	kaʁvɐ̃w̃
cará	kaɾa
caráter	kaɾateʁ
carícia	kaɾisjɐ
cas	kas
casa	kazɐ
casaca	kazakɐ
casaco	kazaku
casal	kazaw
casamento	kazamẽto
casamento	kazɐmẽtu
casar	kazaʁ
casarão	kazaɾɐ̃w̃
cascavel	kaskavɛw
casco	kasku
case	kazi
caseiro	kazejɾu
caserna	kazɛʁnɐ
caso	kazu
casquilho	kajʃkiʎu
casquilho	kaskiʎu
cassete	kasɛtʃi
cassino	kasinu
castanha	kastɐɲa
castelhano	kasteʎɐnu
castelo	kastɛlo
castelo	kastɛlu
castelo	kaʃtɛlu
castidade	kastidade
castidade	kast͡ʃidad͡ʒi
castidade	kaʃtidadɪ
castidade	kaʃt͡ʃidad͡ʒi
castigado	kast͡ʃiɡadu
castigado	kaʃt͡ʃiɡadu
castigo	kast͡ʃiɡu
castiçal	kastʃisaw
castro	kastɾu
castro	kaʃtɾu
casulo	kazulʊ
catafalco	katafawku
catai	kataj
catanduvas	katɐ̃duvɐs
cataplana	kataplɐnɐ
catapúcia	katapusja
catar	kataʁ
catarina	kataɾinɐ
catarro	kataʁu
catastrófica	katastɾɔfikɐ
catequista	katekista
cateter	katetɛʁ
cateter	katɛteʁ
catinga	kɐtʃĩɡɐ
catita	kat͡ʃita
catita	kat͡ʃitɐ
cativariam	kat͡ʃivaɾiɐ̃w̃
cativo	kat͡ʃivu
cato	katu
catorze	katoɾzi
catorze	katoʁzi
catorze	katoχzi
catraio	katɾaju
caubói	kawbɔj
cauda	kawdɐ
caudal	kawdaw
caulinita	kawlinitɐ
causa	kawzɐ
causar	kawzaʁ
cautelarmente	kawtelaʁmẽt͡ʃi
cauã	kawɐ̃
cauê	kawe
cava	kavɐ
cavaleiro	kavalejɾo
cavaleiro	kavalejɾu
cavalheiro	kavaʎejɾu
cavalo	kavalo
cavalo	kavalu
cavaquinho	kavakiɲu
cavaquinho	kavɐkiɲu
caveira	kavejɾɐ
caveirão	kavejɾɐ̃w̃
caviar	kaviaɾ
cavoucar	kavokaɾ
cavoucar	kavokaχ
caxinguelê	kaʃĩɡele
caxumba	kaʃũbɐ
caça	kasa
caçada	kasadɐ
caçador	kasadoʁ
caçamba	kɐsãbɐ
caçarola	kasaɾɔla
caçula	kasulɐ
caô	kao
cd	sede
ceará	seaɾa
ceará	siaɾa
cebolinha	seboliɲɐ
cecília	sesiljɐ
cecílio	sesiliu
ceder	sedeʁ
cedilha	sed͡ʒiʎɐ
cedo	sedu
cefeu	sefew
cega	sɛɡɐ
cegas	sɛɡɐs
cego	sɛɡu
cegueta	seɡeta
ceguinho	sɛɡiɲu
ceguinhos	sɛɡiɲus
ceia	seja
cela	sɛla
celebrar	selebɾaʁ
celebérrimo	sɛlebɛʁimu
celeiro	selejɾu
celeste	selɛst͡ʃi
celeste	selɛʃt͡ʃi
celestial	selest͡ʃiaw
celestial	selest͡ʃjaw
celestial	seleʃt͡ʃiaw
celestial	seleʃt͡ʃjaw
celeuma	selewmɐ
celular	selulaʁ
cem	sẽj̃
cemitério	semitɛɾju
cena	senɐ
cenoura	senowɾɐ
censo	sẽsu
censura	sẽsuɾɐ
censurar	sẽsuɾaʁ
censuro	sẽsuɾu
centauro	sẽtawɾu
centavo	sẽtavu
centeio	sẽteju
cento	sẽtu
centopeia	sẽtopɛja
central	sẽtɾaw
centro	sẽtɾo
centro	sẽtɾu
centrípeto	sẽtɾipetu
centurião	sẽtuɾjɐ̃w̃
ceo	siiow
cepo	sepu
cera	seɾa
cereal	seɾeaw
cereal	seɾiaw
cereja	seɾeʒa
cereja	seɾeʒɐ
ceres	sɛɾis
cerimônia	seɾimonia
cerimônia	seɾimonja
certamente	sɛʁtamẽt͡ʃi
certificar	seʁt͡ʃifikaʁ
certo	sɛʁtu
cerva	sɛʁvɐ
cerveja	seʁveʒɐ
cervo	seʁvu
cesareia	sɛzaɾɛjɐ
cesta	sesta
cetim	setʃĩ
cetona	setona
ceuta	sewtɐ
chacina	ʃasina
chafariz	ʃafaɾis
chaga	ʃaɡɐ
chaim	ʃaĩ
chaleira	ʃalejɾa
chama	ʃɐmɐ
chamada	ʃɐmadɐ
chamar	ʃamaɻ
chamar	ʃamaɾ
chamar	ʃɐmah
chamar	ʃɐmaɹ
chamar	ʃɐmaɾ
chamar	ʃɐmaʁ
chamar	ʃɐmaχ
chamejar	ʃɐmeʒaɾ
chamejar	ʃɐmeʒaχ
champanhe	ʃɐ̃pɐɲi
champanhe	ʃɐ̃pɐ̃j̃
champignon	ʃɐ̃piɲõ
chance	ʃɐ̃si
chanucá	ʁɐnuka
chapa	ʃapɐ
chapeada	ʃapeadɐ
chapeada	ʃapiadɐ
chapecoense	ʃapekoẽse
chapecoense	ʃapekoẽsi
chapecoense	ʃapekwẽse
chapecó	ʃapekɔ
chapeuzinho	ʃapɛwziɲu
chapéu	ʃapɛw
charada	ʃaɾada
charada	ʃaɾadɐ
charamela	ʃaɾɐmɛlɐ
charque	ʃaʁki
charrete	ʃarɛtʃi
charrete	ʃaʁɛtʃi
chat	ʃatʃi
chat	ʃɛtʃi
chatear	ʃateaɾ
chato	ʃatu
chau	ʃaw
chave	ʃave
chave	ʃavi
chavelha	ʃaveʎɐ
chavão	ʃavɐ̃w̃
checagem	ʃekaʒẽ
checar	ʃekaɻ
checar	ʃekaʁ
checheno	ʃeʃenu
cheddar	ʃɛdaʁ
cheerleader	t͡ʃieʁlideʁ
cheesecake	t͡ʃiskejk
cheesecake	t͡ʃiskejki
cheesecake	ʃiskejki
chefe	ʃɛfi
chefiar	ʃefiaʁ
chefão	ʃɛfɐ̃w̃
chefículo	ʃɛfikulu
chega	ʃeɡɐ
chegada	ʃeɡada
chegar	ʃeɡaʁ
cheia	ʃejɐ
cheio	ʃeju
cheirar	ʃejɾaʁ
cheque	ʃɛki
chernobil	ʃeʁnobiw
chibata	ʃibata
chibo	ʃibu
chicago	ʃikaɡu
chicho	ʃiʃu
chiclete	ʃiklɛt͡ʃi
chico	ʃiku
chicotada	ʃikotada
chicotada	ʃikotadɐ
chicote	ʃikɔt͡ʃi
chifre	ʃifɾi
chile	ʃili
chili	t͡ʃili
chimarrear	ʃimaʁeaʁ
china	ʃinɐ
chinfrim	ʃĩfɾĩ
chinês	ʃinejs
chiqueiro	ʃikejɾu
chispa	ʃispa
chispa	ʃispɐ
chispa	ʃiʃpɐ
chita	ʃitɐ
chocado	ʃokadu
chocalho	ʃokaʎu
chocante	ʃokɐ̃t͡ʃi
chocar	ʃokaʁ
chocarreira	ʃokaʁejɾɐ
chocolate	ʃokolat͡ʃi
chon	ʃõ
chope	ʃopi
chopinzinho	ʃopĩziɲu
choque	ʃɔki
chorar	ʃoɾaʁ
choro	ʃoɾu
choro	ʃɔɾu
chororô	ʃoɾoɾo
chorão	ʃoɾɐ̃w̃
choupana	ʃowpɐna
choupana	ʃowpɐnɐ
choupo	ʃowpu
chovendo	ʃovẽdu
chover	ʃoveʁ
chuca	ʃuka
chuinga	ʃuĩɡa
chulca	ʃuwka
chulipa	ʃulipɐ
chumbo	ʃũbu
chupeta	ʃupeta
chupisco	ʃupisku
chupisco	ʃupiʃku
churras	ʃuʁas
churrasco	ʃuʁasku
churrasco	ʃuʁaʃku
churro	ʃuʁu
chutar	ʃutaɾ
chuto	ʃutu
chuva	ʃuvɐ
chuvoso	ʃuvozu
chuço	ʃusu
chá	ʃa
chádico	ʃad͡ʒiku
chão	ʃɐ̃w̃
cianorte	siɐnɔʁt͡ʃi
cicatriz	sikatɾis
cicatrize	sikatɾizi
cicerone	siseɾoni
cidadania	sidadɐnia
cidadania	sidadɐniɐ
cidade	sidade
cidade	sidadɪ
cidade	sidad͡ʒi
cidadezinha	sidad͡ʒiziɲɐ
cidadão	sidadɐ̃w̃
cidreira	sidɾejɾɐ
ciente	siẽtʃi
científico	siẽtʃifiku
científico	sjẽtʃifiku
cifrão	sifɾɐ̃w̃
cigano	siɡɐnu
cilindrar	silĩdɾaʁ
cima	simɐ
cimento	simẽtu
cinamomo	sinɐmomu
cinco	sĩku
cinema	sinemɐ
cinquenta	sĩkwẽtɐ
cinto	sĩtu
cintura	sĩtuɾɐ
cinza	sĩzɐ
cinzenta	sĩzẽta
cinzento	sĩzẽtu
cipoal	sipoaw
cipoama	sipoɐmɐ
cipozal	sipozaw
cipozinho	sipɔziɲu
cipozão	sipɔzɐ̃w̃
ciprestal	sipɾestaw
ciprestal	sipɾeʃtaw
cipó	sipɔ
circense	siɹsẽsi
circense	siχsẽsi
circular	siʁkulaʁ
circulares	siʁkulaɾis
circulação	siʁkulasɐ̃w̃
circuncentro	sirkũsẽtru
circunspecção	siɾkũʃpɛsɐ̃w̃
circunspeção	siɾkũʃpɛsɐ̃w̃
circunstancia	siʁkũstɐ̃siɐ
circunstanciar	siʁkũstɐ̃siaʁ
circunstanciar	siʁkũstɐ̃sjaʁ
circunstância	siʁkũstɐ̃sjɐ
cirenaica	siɾenajkɐ
cireneu	siɾenew
cirilo	siɾilu
cisco	sisku
cisco	siʃku
cisma	sizmɐ
cismar	sizmaʁ
cisne	sizne
cisne	sizni
cisne	siʒni
cisto	sistu
citadino	sitad͡ʒinu
cito	situ
civil	siviw
ciência	siẽsjɐ
ciúme	siumi
ciúme	sjumi
clandestino	klɐ̃destinu
clara	klaɾɐ
clarificar	klaɾifikaʁ
claro	klaɾo
claro	klaɾu
claríssima	klaɾisimɐ
claríssimo	klaɾisimu
classe	klase
classe	klasi
classificação	klasifikasɐ̃w̃
clava	klava
clavícula	klavikula
clemente	klemẽt͡ʃi
cleptomania	klɛpitomania
cleptomania	klɛpitomɐnia
cleptomania	klɛptomania
cleptomania	klɛptomɐnia
clevelândia	klevelɐ̃d͡ʒiɐ
cliente	kliẽt͡ʃi
clima	klimɐ
clitóris	klitɔɾis
cloroplasto	kloɾoplastu
clorose	kloɾɔzi
clotilde	klot͡ʃiwd͡ʒi
clube	klube
clube	klubi
cluster	klɐsteʁ
clássico	klasiku
clã	klɐ̃
clínica	klinikɐ
clínico	kliniku
clítoris	klitoɾis
coabitar	koabitaʁ
coadoção	koadosɐ̃w̃
cobertor	kobeʁtoʁ
cobra	kɔbɾa
cobrar	kobɾaʁ
cobre	kɔbɾi
cobrir	kobɾiɻ
cobrir	kobɾiʁ
cobrir	kubɾiɹ
cochicho	kuʃiʃu
cochinchina	koʃĩʃinɐ
cociente	kosiẽti
coclear	kokliaʁ
coco	koku
cocota	kokota
cocô	koko
coentro	koẽtɾu
cognato	koɡnatu
cogumelo	koɡumɛlu
coice	kojsi
coimbra	koĩbɾɐ
coincide	koĩsid͡ʒi
coisa	kojzɐ
coisas	kojzɐs
coisinha	kojziɲa
coisinha	kojziɲɐ
coitado	kojtadu
cola	kɔlɐ
colaboração	kolaboɾasɐ̃w̃
colante	kolɐ̃t͡ʃi
colar	kolaʁ
colarinho	kolaɾiɲu
colega	kolɛɡɐ
coleta	koletɐ
coleta	kolɛtɐ
coletar	koletaʁ
colete	kolɛtʃi
coletivamente	kolɛtivɐmẽt͡ʃi
coleção	kolesɐ̃w̃
colher	koʎeʁ
colher	koʎɛʁ
colher	kuʎeʁ
colheres	koʎɛɾis
colheres	koʎɛɾiʃ
colhão	kuʎɐ̃w̃
colina	kolina
colina	kolinɐ
colmeia	kowmejɐ
colmeia	kowmɛjɐ
colmo	kowmu
colo	kɔlu
colocar	kolokaʁ
colonial	koloniaw
colonial	kolonjaw
colonização	kolonizasɐ̃w̃
coloquial	kolokiaw
coloquial	kolokjaw
colorau	koloɾaw
colossal	kolosaw
coluna	kolunɐ
colégio	kolɛʒju
colégio	kɔlɛʒju
colômbia	kolõbjɐ
colônia	koloniɐ
com	kõ
com	kũ
coma	komɐ
comadre	komadɾi
comadre	kumadɾi
comandar	komɐ̃daʁ
comando	komɐ̃du
combate	kõbat͡ʃi
combatente	kõbatẽt͡ʃi
combinar	kõbinaʁ
combinação	kõbinasɐ̃w̃
come	komi
comemorar	komemoɾaʁ
comentar	komẽtaʁ
comentário	komẽtaɾju
comer	komeʁ
comercializar	komeʁsjalizaʁ
comeres	komeɾis
cometa	kometa
cometa	kometɐ
comete	komɛtʃi
começa	komɛsɐ
começar	komesaʁ
começo	komesu
começo	komɛsu
começo	kumɛsu
comichão	komiʃãw̃
comida	komidɐ
comida	kumidɐ
comidinha	komid͡ʒiɲɐ
comilão	komilɐ̃w̃
cominação	kominasɐ̃w̃
comintern	komĩtɛʁni
comissão	komisɐ̃w̃
comité	komite
como	komu
compacta	kõpaktɐ
compacto	kõpakitu
compacto	kõpaktu
compaixão	kõpajʃɐ̃w̃
companha	kõpɐɲɐ
companhia	kõpɐniɐ
companhia	kõpɐɲiɐ
comparar	kõpaɾaʁ
comparecer	kõpaɾeseʁ
compartilhar	kõpaɻt͡ʃiʎaɻ
compartilhar	kõpaʁt͡ʃiʎaʁ
comparável	kõpaɾavew
compasso	kõpasu
compatriota	kõpatɾiɔtɐ
competente	kõpetẽt͡ʃi
competir	kõpetʃiʁ
competirem	kõpet͡ʃiɾẽj̃
competitividade	kõpet͡ʃit͡ʃividad͡ʒi
competitivo	kõpet͡ʃit͡ʃivu
competição	kõpetʃisɐ̃w̃
compilação	kõpilasɐ̃w̃
compincha	kõpĩʃɐ
completamente	kõplɛtɐmẽt͡ʃi
completar	kõpletaʁ
completo	kõplɛtu
complexar	kũplekisaʁ
complexo	kõplɛksu
componente	kõponẽt͡ʃi
comportamento	kõpoɻtamẽto
comportamento	kõpoʁtɐmẽtu
comportar	kõpoʁtaʁ
compositor	kõpuzitoɾ
compostura	kõpostuɾa
compota	kõpɔta
compra	kõpɾa
comprar	kõpɾaʁ
compreender	kõpɾeẽdeʁ
compreender	kõpɾiẽdeʁ
compreensão	kõpɾiẽsɐ̃w̃
comprido	kõpɾidu
comprido	kũpɾidu
comprimento	kõpɾimẽto
comprimento	kõpɾimẽtu
comprimento	kũpɾimẽtu
compromete	kõpɾomɛtʃi
comprometer	kõpɾometeʁ
compromisso	kõpɾomiso
compromisso	kõpɾomisu
comprovar	kõpɾovaʁ
computador	kõputadoʁ
comu	komu
comum	komũ
comuna	komunɐ
comunicado	komunikadu
comunicado	kumunikadu
comunicar	komunikaʁ
comunicação	komunikasɐ̃w̃
comunidade	komunidade
comunidade	komunidad͡ʒi
comunismo	komunizmu
comunista	komunistɐ
comércio	komɛɻsio
comércio	komɛɻsjo
comércio	komɛʁsju
conceder	kõsedeʁ
conceito	kõsejtu
concentrar	kõsẽtɾaʁ
concessão	kõsesɐ̃w̃
concha	kõʃa
conciliar	kõsiljaɾ
concitador	kõsitadoʁ
concluir	kõkluiʁ
conclusão	kõkluzɐ̃w̃
concluíram	kõkluiɾɐ̃w̃
concorda	kõkɔʁdɐ
concordar	kõkoʁdaʁ
concordância	kõkoʁdɐ̃sjɐ
concorrência	kõkoʁẽsjɐ
concreto	kõkɾɛtu
condado	kõdado
condado	kõdadu
condefé	kõdɛfɛ
condensação	kõdẽsasɐ̃w̃
condicionado	kõd͡ʒisjonadu
condicional	kõd͡ʒisionaw
condicional	kõd͡ʒisjonaw
condigno	kõd͡ʒiɡinu
condigno	kõd͡ʒiɡnu
condimentar	kõd͡ʒimẽtaʁ
condição	kõd͡ʒisɐ̃w̃
conduzir	kõduziʁ
condução	kõdusɐ̃w̃
condão	kõdɐ̃w̃
conexo	konɛksu
conexão	koneksɐ̃w̃
confederação	kõfedeɾasɐ̃w̃
conferir	kõfeɾiʁ
conferência	kõfeɾẽsjɐ
confessar	kõfesaʁ
confete	kõfɛtʃi
confiança	kõfiɐ̃sɐ
confiar	kõfiaʁ
configuro	kõfiɡuɾu
confinar	kõfinaɾ
confirmar	kõfiʁmaʁ
conflito	kõflitu
confortavelmente	kõfoʁtavewmẽt͡ʃi
confrade	kõfɾad͡ʒi
confraria	kõfɾaɾia
confraria	kõfɾaɾiɐ
confrontar	kõfrõtaʁ
confuso	kõfuzu
confusão	kõfuzɐ̃w̃
confúcio	kõfusju
congonhinhas	kõɡoɲiɲɐs
congratular	kõɡɾatulaʁ
congratulou	kõɡɾatulow
congressista	kõɡɾesistɐ
congresso	kõɡɾɛsu
congênere	kõʒeneɾi
conhecer	koɲeseɻ
conhecer	koɲeseʁ
conhecimento	koɲesimẽtu
conjunto	kõʒũtu
conjuro	kõʒuɾu
conosco	konosku
conquanto	kõkwɐ̃tu
conquista	kõkista
conquista	kõkistɐ
conquistar	kõkistaɾ
conquistar	kõkiʃtaɾ
conrado	kõʁadu
consagrar	kõsaɡɾaʁ
consciente	kõsiẽt͡ʃi
consciente	kõsjẽt͡ʃi
consciência	kõsiẽj̃sia
consciência	kõsiẽj̃sja
consciência	kõsiẽsia
consciência	kõsiẽsja
consegue	kõsɛɡi
conseguinte	kõseɡĩti
conseguir	kõseɡiʁ
conseguiram	kõseɡiɾɐ̃w̃
conselho	kõseʎu
consequência	kõsekwẽsjɐ
consertar	kõseʁtaʁ
conserto	kõseʁtu
conserto	kõsɛɻtu
conserva	kõsɛʁvɐ
considerar	kõsideɾaʁ
consideração	kõsideɾasɐ̃w̃
considerável	kõsideɾavew
consigo	kõsiɡu
consigo	kũsiɡu
consistir	kõsistʃiʁ
consta	kõstɐ
constante	kõstɐ̃t͡ʃi
constantino	kõstɐ̃t͡ʃinu
constança	kõstɐ̃sɐ
constança	kõʃtɐ̃sɐ
constar	kõstaʁ
constatação	kõstatasɐ̃w̃
constituir	kõstʃituiʁ
constrangimento	kõstrɐ̃ʒimẽtu
construir	kõstɾuiʁ
construção	kõstɾusɐ̃w̃
constância	kõstɐ̃sia
constância	kõstɐ̃sja
constância	kõʃtɐ̃siɐ
constância	kõʃtɐ̃sjɐ
consulado	kõsuladu
consular	kõsulaʁ
consulta	kõsuwtɐ
consultar	kõsuwtaʁ
consultório	kõsuwtɔɾju
consumidor	kõsumidoʁ
consumo	kõsumu
conta	kõtɐ
contactar	kõtataɻ
contactar	kõtataʁ
contagem	kõtaʒẽj̃
contam	kõtɐ̃w̃
contanto	kõtɐ̃tu
contar	kõtaʁ
contato	kõtatu
contenda	kõtẽdɐ
contente	kõtẽt͡ʃi
conter	kõteʁ
contexto	kõtestu
conteúdo	kõteudu
contigo	kõtʃiɡu
continente	kõt͡ʃinẽt͡ʃi
contingenciamento	kõtĩʒẽsjamẽtu
contino	kõt͡ʃinu
continua	kõt͡ʃinuɐ
continuamente	kõt͡ʃinuamẽt͡ʃi
continuando	kõt͡ʃinuɐ̃du
continuando	kõt͡ʃinwɐ̃du
continuar	kõt͡ʃinuaʁ
conto	kõtu
contra	kõtɾɐ
contramestra	kõtɾamɛstɾa
contramestra	kõtɾamɛʃtɾa
contramestre	kõtɾamɛstɾi
contramestre	kõtɾamɛʃtɾi
contramão	kõwtɾamãw
contraste	kõtɾastʃi
contrato	kõtɾatu
contribuir	kõtɾibuiʁ
contribuição	kõtɾibuisɐ̃w̃
contribuição	kõtɾibujsɐ̃w̃
controlar	kõtɾolaɹ
controlar	kõtɾolaɻ
controlar	kõtɾolaɾ
controlar	kõtɾolaʁ
controle	kõtɾole
controle	kõtɾoli
controle	kõtɾɔle
controle	kõtɾɔli
controlo	kõtɾolu
controlo	kõtɾɔlu
contudo	kõtudu
contumaz	kõtumas
contêiner	kõtejneʁ
contínuo	kõt͡ʃinuu
contínuo	kõt͡ʃinwu
convencer	kõvẽseʁ
convenção	kõvẽsɐ̃w̃
conversa	kõvɛʁsɐ
conversar	kõveʁsaʁ
converter	kõveʁteʁ
convidar	kõvidaʁ
convés	kõvɛjs
convés	kõvɛs
convênio	kõvẽnju
cookie	kuki
cooptar	kooptaɾ
cooptar	kooptaʁ
copa	kɔpɐ
copas	kɔpas
copeiro	kopejɾu
copo	kɔpu
coquete	kokɛtʃi
cor	koʁ
cor	kɔʁ
coragem	koɾaʒẽj̃
coral	koɾaw
coração	koɾasɐ̃w̃
coraçãozinho	koɾasɐ̃w̃ziɲu
corbélia	koʁbɛliɐ
corcunda	koxkũdɐ
corcunda	koɹkũdɐ
corcunda	koɾkũdɐ
corcunda	koʁkũdɐ
corcunda	kɔhkũda
core	kɔɹ
core	kɔɾi
coreia	koɾɛjɐ
cores	koɾis
cores	kɔɹs
cores	kɔɾis
corintiano	koɾĩtʃiɐ̃nu
corisco	koɾisku
corisco	koɾiʃku
cornélio	koʁnɛlju
coro	koɾu
coro	kɔɾu
coroa	koɾoɐ
coronariano	koɾonaɾiãnu
coronavírus	koɾonaviɾus
coronel	koɾonɛw
corpo	koʁpu
corre	kɔʁi
correndo	koʁẽdu
correr	koɦeɻ
correr	koʁeʁ
correto	koʁɛtu
corrida	koʁidɐ
corroboração	koʁoboɾasɐ̃w̃
corrupio	koʁupiu
corrupio	kuʁupiu
corruptela	koʁuptɛlɐ
corrupto	koʁuptu
corrupção	kohupisɐ̃w̃
corréu	koʁɛw
cortar	koʁtaʁ
corte	koɾtʃi
corte	koʁtʃi
corte	kɔʁt͡ʃi
cortiça	koʁt͡ʃisɐ
cortiço	koʁt͡ʃisu
coruchéu	koɾuʃɛw
corvo	koʁvu
corão	koɾɐ̃w̃
coró	koɾɔ
cos	kos
cos	kus
coser	kuzer
cospe	kɔspi
cospe	kɔʃpi
costa	kɔsta
costa	kɔstɐ
costas	kɔstɐs
costume	kostumi
costume	kustumi
cota	kɔta
cotiano	kotʃiɐ̃nu
cotonete	kotonɛtʃi
cotovelo	kotovelu
cotovelo	kutuvelu
cotovia	kotoviɐ
cotão	kotɐ̃w̃
country	kaw̃tɾi
couro	kowɾu
couve	kowvɪ
coveiro	kovejɾʊ
covo	kovu
coxa	koʃɐ
coxim	koʃĩ
cozer	kozeʁ
cozido	kozidu
cozido	kuzidu
cozinha	koziɲɐ
cozinhando	koziɲɐ̃du
cozinhar	koziɲaʁ
crase	kɾazi
crasso	kɾasu
cratera	kɾatɛɾa
cratera	kɾatɛɾɐ
cravejado	kɾaveʒadʊ
cravo	kɾavu
credo	kɾɛdu
credor	kɾedoɾ
credulidade	kɾɛdulidad͡ʒi
cremado	kɾemadu
creme	kɾemi
crença	kɾẽsɐ
creolina	kɾewlinɐ
crepe	kɾɛpe
crepe	kɾɛpi
crepes	kɾɛpes
crepes	kɾɛpis
crepes	kɾɛpiʃ
crer	kɾeɾ
crer	kɾeʁ
crescer	kɾeseɾ
crescer	kɾeseʁ
crescer	kɾeseχ
crescimento	kɾesimẽtu
cretino	kɾet͡ʃinu
creu	kɾew
cria	kɾiɐ
criada	kɾiadɐ
criadora	kɾiadoɾɐ
criança	kɾiɐ̃sɐ
criar	kɾiax
criar	kɾiaɦ
criar	kɾiaɹ
criar	kɾiaɻ
criar	kɾiaʁ
criatura	kɾiatuɾɐ
criação	kɾiasɐ̃w̃
crica	kɾika
cricri	kɾikɾi
crime	krimi
criminal	kɾiminaw
crioulo	kɾiowlu
criptido	kɾiptʃido
criptoanalista	kɾiptoanalijʃta
criptoanalista	kɾiptoanalista
criptoanálise	kɾiptoanalizi
criptobiose	kɾiptobiɔzi
criptobiótico	kɾiptobiɔtʃiku
criptococose	kɾiptokokɔzi
criptocomunismo	kɾipkomunijʃmu
criptocomunismo	kɾipkomunismu
criptocomunista	kɾipkomunijʃta
criptocomunista	kɾipkomunista
criptofascismo	kɾiptofasijʃmu
criptofascismo	kɾiptofasismu
criptofascista	kɾiptofasijʃta
criptofascista	kɾiptofasista
criptofone	kɾiptofoni
criptoftalmia	kɾiptoftawmia
criptoftalmia	kɾiptoftaɫmia
criptoftalmo	kɾiptoftawmu
criptografia	kɾiptoɡɾafia
criptograma	kɾiptoɡɾɐma
criptogâmico	kɾipɡɐmiku
criptologia	kɾiptoloʒia
criptológico	kɾiptolɔʒiku
criptomnésia	kɾiptomnɛzja
criptomnésico	kɾiptomnɛziku
criptomoeda	kɾiptomuɛda
criptorquia	kɾiptoɾkia
criptorquia	kɾiptoʁkia
criptoscopia	kɾiptoskopia
criptoscopia	kɾiptoʃkopia
criptossistema	kɾipsijʃtema
criptossistema	kɾipsistema
criptoxantina	kɾiptoʃãtʃina
criptozoologia	kɾiptozooloʒia
criptozoólogo	kɾiptozoɔloɡu
criptídeo	kɾiptʃidʒiu
criptógama	kɾiptɔɡɐma
criptógrafo	kɾiptɔɡɾafu
criptósporo	kɾiptɔspoɾu
criptósporo	kɾiptɔʃpoɾu
criptônimo	kɾiptonimu
crise	kɾizi
crisma	kɾizmɐ
crisol	kɾizɔw
crispada	kɾispadɐ
crispado	kɾispadu
crispar	kɾispaʁ
crispim	kɾispĩ
cristal	kɾistaw
cristal	kɾiʃtaw
cristandade	kɾistɐ̃dad͡ʒi
cristianismo	krist͡ʃjɐnizmu
cristiano	kɾist͡ʃjɐnu
cristo	kɾistu
cristão	kɾistɐ̃w̃
cristão	kɾiʃtɐ̃w̃
cristóvão	kɾistɔvɐ̃w̃
criticar	kɾitikaʁ
croata	kɾoatɐ
crocante	kɾokɐ̃t͡ʃi
crocodilo	kɾokod͡ʒilu
croissant	kɾoasɐ̃
croissant	kɾwasɐ̃
croquete	kɾokɛtʃi
crossa	kɾɔsa
crossa	kɾɔsɐ
croácia	kɾoasjɐ
cru	kɾu
cruel	kɾuɛw
crush	kɹɐʃ
crush	kɾɐʃ
cruz	kɾujs
cruzada	kɾuzadɐ
cruzar	kɾuzaʁ
cruzeta	kɾuzeta
cruzeta	kɾuzetɐ
cruzmaltina	kɾuzmawt͡ʃinɐ
crápula	kɾapula
crás	kɾas
crédito	kɾɛdʒitu
crédulo	kɾɛdulu
crítica	kɾitʃikɐ
crítico	kɾitʃiku
crónica	kɾonika
cu	ku
cubicar	kubikaʁ
cuca	kuka
cuca	kukɐ
cueca	kuɛkɐ
cuecas	kuɛkɐs
cuecas	kwɛkɐs
cuia	kuja
cuia	kujɐ
cuiabá	kujaba
cuidadinho	kujdad͡ʒiɲu
cuidado	kujdadu
cuidadoso	kujdadozu
cuidar	kujdaɹ
cuidar	kujdaɻ
cuidar	kujdaɾ
cuidar	kujdaʁ
cujo	kuʒu
culinária	kulinaɾia
culinária	kulinaɾja
culminar	kuwminaʁ
culpa	kuwpɐ
culpar	kuwpaʁ
culposamente	kuwpozamẽt͡ʃi
cult	kuwt͡ʃ
cultivo	kuwt͡ʃivu
culto	kuwtu
cultura	kuwtuɾɐ
cultural	kuwtuɾaw
cumprir	kũpɾiʁ
cuneiforme	kunejfɔɻme
cuneta	kuneta
cunha	kuɲɐ
cupido	kupidu
cupim	kupĩ
cupincha	kupĩʃɐ
cupom	kupõ
cupuaçu	kupuasu
cupuaçuzeiro	kupuasuzejɾu
curador	kuɾadoʁ
curandeiro	kuɾɐ̃dejɾu
curação	kuɾasɐ̃w̃
curcuma	kuʁkumɐ
curdistão	kuʁd͡ʒistɐ̃w̃
curdo	kuʁdu
curinga	kuɾĩɡɐ
curiosidade	kuɾiozidad͡ʒi
curiosidade	kuɾjozidad͡ʒi
curitiba	kuɾit͡ʃibɐ
curiúva	kuɾiuvɐ
curo	kuɾu
currículo	kuʁikulu
curso	kuɻso
curso	kuʁsu
curtir	kuht͡ʃih
curtir	kuht͡ʃiɾ
curtir	kuɾt͡ʃiɾ
curtir	kuʁt͡ʃiʁ
curto	kuʁtu
cus	kus
cuspe	kuspi
cuspe	ɡuspi
custar	kustaʁ
custo	kusto
custo	kustu
custo	kuʃtu
cutcharra	kut͡ʃaχa
cutelo	kutɛlu
cuti	kut͡ʃi
cuzão	kuzɐ̃w̃
czar	kzaʁ
czar	tsaʁ
cá	ka
cágado	kaɡadu
cálice	kalisi
cárie	kaɾi
cárie	kaɾie
cárie	kaɾje
cárpatos	kaʁpatus
cátedra	katedɾɐ
cátia	kat͡ʃjɐ
cávado	kavadu
câmara	kɐmaɾa
câmara	kɐmaɾɐ
câmbio	kɐ̃biu
câmbio	kɐ̃bju
cândido	kãdʒidu
cã	kɐ̃
cãibra	kɐ̃j̃bɾɐ
cão	kɐ̃w̃
célebre	sɛlebɾi
célere	sɛleɾi
célula	sɛlulɐ
cénico	seniku
cérebro	sɛɾebɾu
césar	sɛzɐʁ
céu	sɛw
cê	se
cíclades	siklad͡ʒis
cílio	siliu
cílio	silju
cíntia	sĩt͡ʃjɐ
círculo	siʁkulu
cítara	sitaɾa
cível	siviw
cóccix	kɔks
cóccix	kɔksis
códice	kɔd͡ʒisi
código	kɔd͡ʒiɡu
cólera	kɔleɾɐ
cómodo	komodu
cópia	kɔpjɐ
córrego	kɔʁeɡu
córsico	kɔʁsiku
cômpito	kõpitu
cônsul	kõsuw
côvão	kovɐ̃w̃
cúmplice	kũplisi
cúmulo	kumulu
cúrcuma	kuʁkumɐ
da	da
dada	dadɐ
dafne	dafni
dagmar	daɡimaʁ
dagmar	daɡmaʁ
dai	daj
dakar	dakaʁ
dalgum	dawɡũ
dalguma	dawɡuma
dalguma	dawɡumɐ
dalgumas	dawɡumas
dalgumas	dawɡumɐs
dalgumas	dawɡumɐʃ
dalguns	dawɡũs
dalguns	dawɡũʃ
dali	dali
dall'agnol	dalɐɲɔw
dama	dɐmɐ
damasco	damasku
danado	danadu
danado	dɐnadu
daniel	dɐniɛw
daniel	dɐnjɛw
danificar	dɐnifikaʁ
dano	dɐnu
dantas	dɐ̃tɐs
dante	dɐ̃t͡ʃi
dança	dɐ̃sa
dançar	dɐ̃saʁ
danço	dɐ̃su
daora	daɔɾɐ
daquela	dakɛlɐ
daquelas	dakɛlɐs
daquele	dakele
daquele	dakeli
daqueles	dakelis
daqui	daki
daquilo	dakilu
dar	daʁ
darknet	daɹknɛt͡ʃ
darknet	daʁknɛt͡ʃ
darwin	daʁvĩ
das	das
das	daʃ
data	datɐ
datashow	dataʃow
datiloscopia	dat͡ʃiloʃkopiɐ
datilógrafo	dɐt͡ʃilɔɡɾɐfu
davam	davɐ̃w̃
davi	davi
david	dejvid͡ʒ
david	dejvid͡ʒi
daí	dai
de	de
de	di
de	d͡ʒi
deadlock	dɛdlɔki
deadlock	dɛd͡ʒilɔki
debaixo	d͡ʒibaiʃu
debate	debatʃi
debelar	debelaɾ
debelar	debelaχ
debruçado	debɾusadu
debruçar	debɾusaʁ
debruçou	debɾusow
debuxar	debuʃaʁ
decadência	dekadẽsjɐ
decidir	desid͡ʒiʁ
decisiva	desizivɐ
decisão	desizɐ̃w̃
declarar	deklaɾaʁ
declaração	deklaɾasɐ̃w̃
declinativas	deklinat͡ʃivɐs
declinativo	deklinat͡ʃivu
declive	deklivi
decolagem	dekolaʒẽ
decolagem	dekolaʒẽj̃
decorar	dekoɾaɹ
dedal	dedaw
dedetização	dedetʃizasɐ̃w̃
dedicar	ded͡ʒikaʁ
dedicava	ded͡ʒikavɐ
deduro	deduɾu
default	defo
default	defow
default	difow
defender	defẽdeʁ
defensiva	defẽsivɐ
defensável	defẽsavew
defesa	defezɐ
deficiente	defisiẽt͡ʃi
deficiente	defisjẽt͡ʃi
deficitário	defisitarju
definir	definiʁ
definitiva	definit͡ʃivɐ
definitivas	definit͡ʃivɐs
definitivo	definit͡ʃivu
definitivos	definit͡ʃivus
definição	definisɐ̃w̃
deflagrar	deflaɡɾaɾ
deflagrar	deflaɡɾaχ
deflagração	deflaɡɾasɐ̃w̃
deformação	defoʁmasɐ̃w̃
defunto	defũtu
defunto	d͡ʒifũtu
degelo	deʒelu
degrau	deɡɾaw
deia	dɛjɐ
deificação	deifikasɐ̃w̃
deitado	dejtadu
deitar	dejtaɹ
deitar	dejtaɻ
deitar	dejtaʁ
deitar	dejtaχ
deixa	dejʃɐ
deixar	dejʃaʁ
dela	dɛlɐ
delas	dɛlɐs
delaware	delawɛʁ
delay	delej
dele	dele
dele	deli
delegacia	deleɡasiɐ
deles	delis
delete	dlɛtʃi
delgada	dewɡadɐ
delgado	dewɡadu
deli	dɛli
delicado	delikadu
delito	delitu
delivery	deliveɾi
delta	dɛwtɐ
demais	demajs
demais	d͡ʒimajs
demanda	demɐ̃da
demanda	demɐ̃dɐ
demandar	demɐ̃daʁ
demissexual	demiseksuaw
demo	demu
democracia	demokɾasiɐ
democrático	demokɾatʃiku
demográfico	demoɡɾafiku
demonstrar	demõstɾaʁ
demorar	demoɾaɦ
demorar	demoɾaɹ
demorar	demoɾaɾ
demorar	demoɾaʁ
demétrio	demɛtɾiu
dendê	dẽde
dengo	dẽɡu
denguice	dẽɡisi
denso	dẽsu
dentada	dẽtada
dentada	dẽtadɐ
dentadura	dẽtaduɾa
dentadura	dẽtaduɾɐ
dente	dẽte
dente	dẽti
dente	dẽt͡ʃ
dente	dẽt͡ʃi
dentista	dẽt͡ʃista
dentre	dẽtɾe
dentre	dẽtɾi
dentro	dẽtɾu
denunciar	denũsiaʁ
deodato	dewdatu
departamento	depaʁtamẽtu
depender	depẽdeʁ
dependurada	depẽduɾadɐ
depilação	depilasɐ̃w̃
depois	depojs
deprecar	depɾekaɾ
deprecar	depɾekaχ
depreciativo	depɾesjatʃivu
depressão	depɾesɐ̃w̃
deprê	depɾe
deputado	deputadu
deque	dɛki
der	dɛʁ
dera	dɛɾɐ
derivada	deɾivada
derradeira	deʁadejɾɐ
derradeiro	deʁadejɾu
derramamento	deχamamẽtu
derramar	deʁɐmaʁ
derrame	deʁami
derrame	d͡ʒiʁami
derrete	deʁɛtʃi
derrocar	deʁokaʁ
derrubar	deʁubaʁ
desacato	dezakatu
desacompanhei	dezakõpɐɲej
desafiar	dezafiaʁ
desafio	dezafiu
desafio	dezafiw
desaforamento	dezafoɾamẽtu
desaforamento	dʒizafoɾamẽtu
desaforar	dʒizafoɾaɾ
desaforar	dʒizafoɾaχ
desaforo	dezafoɾu
desaforo	dezafɔɾu
desaforo	dʒizafoɾu
desaforo	dʒizafɔɾu
desafortunada	dezafoʁtunadɐ
desalojado	dezaloʒadu
desalojado	d͡ʒizaloʒadu
desamparada	dezɐ̃paɾadɐ
desamparar	dezɐ̃paɾaʁ
desaparecer	dezapaɾeseʁ
desapercebido	dezapeɾsebidu
desapercebido	dʒizapeɾsebidu
desaprender	dezapɾẽdeʁ
desarmamentista	dezaʁmamẽtʃijʃta
desarmamentista	dʒizaɾmamẽtʃista
desarticular	dezartʃikular
desbocado	dezbokadu
desbocado	d͡ʒisbokadu
descaem	deskaẽj̃
descaem	deʃkaẽj̃
descansar	deskɐ̃saʁ
descanso	deskɐ̃so
descanso	deskɐ̃su
descanso	d͡ʒiskɐ̃su
descaroçado	kaɾosudu
descarrilamento	deskaʁilamẽtu
descarte	d͡ʒiskaʁt͡ʃi
descartes	d͡ʒiskaʁt͡ʃis
descartável	deʃkaχtavɛw
descer	deseʁ
descida	desida
descida	desidɐ
descobrir	deskobɾiʁ
desconexo	dʒijʃkonɛksu
desconexo	dʒiskonɛksu
desconhecido	d͡ʒiskoɲesidu
desconversar	deskõveʁsaʁ
descortinar	deskoɾt͡ʃinaɾ
descrever	deskɾeveʁ
descrita	deskɾitɐ
descrita	d͡ʒiskɾitɐ
descrito	deskɾitu
descrição	deskɾisɐ̃w̃
desculpa	d͡ʒiskuwpa
desculpa	d͡ʒiskuwpɐ
desculpa	d͡ʒiʃkuwpɐ
desculpar	deskuwpaʁ
desculpar	d͡ʒiskuwpaʁ
desde	dejzd͡ʒi
desdenhar	dezdeɲaʁ
desdenhoso	dezdeɲozu
desdo	dejzdu
deseducado	dʒizedukadu
desejar	dezeʒaɹ
desejar	dezeʒaɻ
desejar	dezeʒaʁ
desejar	dezeʒaχ
desejo	dezeʒu
desejoso	dezeʒozu
desempenho	dezẽpeɲu
desemprego	dezĩpɾeɡu
desencadear	dezẽkadiaʁ
desenhar	dezeɲaʁ
desenhista	dezeɲistɐ
desenhista	dezeɲiʃtɐ
desenho	dezeɲu
desenrascanço	dezẽj̃ʁaskɐ̃su
desenrascanço	dezẽj̃ʁaʃkɐ̃su
desenrugar	dezẽj̃ʁuɡaʁ
desentendimento	dezẽtẽdʒimẽtu
desenvencilhar	desẽvẽsiʎaɾ
desenvencilhar	desẽvẽsiʎaχ
desenvincilhar	desẽvĩsiʎaɾ
desenvincilhar	desẽvĩsiʎaχ
desenvolver	dezẽvowveʁ
desenvolver	dʒizĩvowveʁ
desenvolveu	dezẽvowvɛw
desenvolvido	dezẽvowvidu
desenvolvimento	dezĩvowvimẽtu
desenvolvimento	d͡ʒizĩvowvimẽtu
desequilibrou	dezekilibɾow
desertificar	dezeʁtifikaʁ
desfazimento	desfazimẽtu
desfazimento	dʒisfazimẽtu
desfecho	dʒisfeʃu
desgastar	dezɡastaʁ
desgraça	dezɡɾasɐ
desgraça	diʒɡɾasɐ
desgraça	dzɡɾasɐ
desgraça	d͡ʒizɡɾasɐ
desgraça	d͡ʒiʃɡɾasɐ
desgraçar	d͡ʒizɡrasaχ
desidratação	dezidɾatasɐ̃w̃
designadamente	deziɡinadamẽt͡ʃi
designado	deziɡinadu
desinteresse	dezĩteɾesi
desinteresse	dezĩteɾɛsi
desistir	dezist͡ʃiʁ
desjejua	desʒeʒua
desjejum	d͡ʒizʒeʒũ
desligado	diʒliɡadu
desligado	dʒiʃliɡadu
desligado	dʒiʒliɡadu
desligar	desliɡaɻ
desligar	dezliɡaʁ
desligar	d͡ʒisliɡaʁ
deslocar	deslokaʁ
deslocar	dʒislokaʁ
deslocação	dezlokasɐ̃w̃
desnivelado	dezniveladu
desolar	dezolaɾ
desolar	dezolaχ
desolação	dezolasɐ̃w̃
desonerar	dezoneɾaʁ
despedido	desped͡ʒidu
despedir	desped͡ʒiɻ
despedir	desped͡ʒiʁ
despender	despẽdeʁ
despenhadeiro	despeɲadejɾu
desperdiçar	despeʁdʒisaʁ
desperdiçar	dʒispeʁdʒisaʁ
desperdício	despeʁdʒisju
desperdício	dʒispeʁdʒisju
despesa	despezɐ
despesa	dʒispezɐ
despir	despiʁ
despir	d͡ʒispiʁ
despiu	despiw
despiu	d͡ʒispiw
desprezo	despɾezu
desprezo	despɾɛzu
desprezível	despɾezivew
desqualificar	deskwalifikaʁ
desrespeito	dezʁespejtu
desrespeito	deʒʁeʃpejtu
desrespeitoso	dezʁespejtozu
desrespeitoso	deʒʁeʃpejtozu
dessa	dɛsɐ
dessas	dɛsɐs
desse	desi
desses	desis
desta	dɛstɐ
destacamento	destakamẽtu
destacar	diʃtakaɾ
destacar	dʒistakaɾ
destacar	dʒiʃtakaɾ
destas	dɛstɐs
deste	deste
deste	dest͡ʃi
deste	deʃti
deste	dɛst͡ʃi
deste	dɛʃt͡ʃi
desterro	desteʁu
desterro	deʃteʁu
destes	destes
destes	dest͡ʃis
destes	dɛst͡ʃis
destes	dɛʃt͡ʃiʃ
destino	destʃĩnu
destra	dɛstɾɐ
destras	dɛstɾɐs
destreza	destɾezɐ
destro	dɛstɾu
destruir	destɾuiʁ
destruição	d͡ʒistɾuisɐ̃w̃
destruído	destɾuidu
destruído	deʃtɾuidu
destruído	d͡ʒistɾuidu
destruído	d͡ʒiʃtɾuidu
desuso	dezuzu
desvencilhar	desvẽsiʎaɾ
desvencilhar	desvẽsiʎaχ
desvio	d͡ʒisviu
desvio	d͡ʒiʃviu
desânimo	dezɐnimu
desídia	dezidʒja
desígnio	deziɡnju
detalhe	detaʎi
detectar	detektaʁ
deterioração	deteɾioɾasɐ̃w̃
determinado	deteɾminadu
determinar	deteʁminaʁ
detonado	detonadu
detran	detɾɐ̃
detroit	detɾɔjt
detroit	detɾɔjt͡ʃ
deturpação	detuɾpasɐ̃w̃
deturpação	detuʁpasɐ̃w̃
deus	dews
deus	dewʃ
deusa	dewzɐ
devagar	devaɡaʁ
devagar	dʒivaɡaʁ
devassa	devasɐ
devasso	devasu
deve	dɛvi
dever	deveʁ
devia	deviɐ
devia	d͡ʒiviɐ
devolver	devowveʁ
devon	dɛvõ
devorar	devoɾaɹ
devorar	devoɾaɻ
devorar	devoɾaʁ
devorar	devoɾaχ
devoto	devɔtu
devoção	devosɐ̃w̃
dexter	dɛksteʁ
dez	dɛjs
dez	dɛjʃ
dezembro	dezẽbɾu
dezembro	dɛzẽbɾu
dezenove	dezenɔve
dezenove	dezenɔvi
dezenove	d͡ʒizenɔvi
dezesseis	dezesejs
dezesseis	d͡ʒizesejs
dezessete	dezesɛt͡ʃi
dezessete	d͡ʒizesɛt͡ʃi
dezoito	dezojtu
dezoito	d͡ʒizojtu
deísta	deistɐ
dia	diɐ
dia	d͡ʒiɐ
diabete	dʒiabɛtʃi
diabo	diabu
diabo	d͡ʒiabu
diabo	d͡ʒjabu
diabos	d͡ʒjabus
diamante	d͡ʒjamɐ̃t͡ʃi
diana	d͡ʒiɐnɐ
diana	d͡ʒjɐnɐ
diarista	d͡ʒiaɾistɐ
diarista	d͡ʒjaɾistɐ
dica	d͡ʒikɐ
dicionário	d͡ʒisjonaɾjo
dicionário	d͡ʒisjonaɾju
diet	dajt͡ʃ
diferenciar	dʒifeɾẽsiaʁ
diferente	difɛrẽti
diferente	d͡ʒifeɾẽt͡ʃi
diferença	d͡ʒifeɾẽsɐ
diferir	d͡ʒifeɾiʁ
dificuldade	d͡ʒifikuwdad͡ʒi
difuso	d͡ʒifuzu
difícil	difisiw
difícil	d͡ʒifisiw
diga	d͡ʒiɡɐ
digam	d͡ʒiɡɐ̃w̃
digitar	d͡ʒiʒitaʁ
dignificar	d͡ʒiɡinifikaʁ
digno	d͡ʒiɡinu
digno	d͡ʒiɡnu
digo	diɡu
dimensão	d͡ʒimẽsɐ̃w̃
diminuir	d͡ʒiminuiʁ
dimitri	d͡ʒimitɾi
dinastia	dʒinastʃia
dindim	dĩdĩ
dindim	dʒĩdʒĩ
dinheiro	d͡ʒiɲejɾu
dinis	d͡ʒinis
dino	d͡ʒinu
dinossauro	dinɔsawɾu
diploma	dʒiplomɐ
diplomática	d͡ʒiplomat͡ʃikɐ
diplomático	d͡ʒiplomatiku
direcionar	dʒiɾesjonaʁ
direita	d͡ʒiɾejtɐ
direito	d͡ʒiɾejtu
diretamente	d͡ʒiɾɛtɐmẽt͡ʃi
diretiva	d͡ʒiɾɛt͡ʃivɐ
direto	dɪɾɛtʊ
direto	d͡ʒiɾɛto
direto	d͡ʒiɾɛtu
diretor	d͡ʒiɾetoʁ
direção	d͡ʒiɾesɐ̃w̃
dirigir	diɾiʒih
dirigir	d͡ʒiɾiʒiɹ
dirigir	d͡ʒiɾiʒiɻ
dirigir	d͡ʒiɾiʒiʁ
dirigir	d͡ʒiɾiʒiχ
dirigível	d͡ʒiɾiʒivew
discente	disẽtʃi
discernimento	d͡ʒiseʁnimẽtu
disciplina	dʒisiplinɐ
discipline	disiplini
discretamente	d͡ʒiskɾɛtɐmẽt͡ʃi
discurso	d͡ʒiskuʁsu
discussão	dʒiskusɐ̃w̃
discutir	d͡ʒiskut͡ʃiʁ
disenteria	dezĩteɾiɐ
disenteria	d͡ʒizẽteɾiɐ
disgeusia	disʒewzia
disponível	d͡ʒisponivew
disposto	d͡ʒispostu
disse	d͡ʒisi
disser	d͡ʒisɛʁ
dissesse	d͡ʒisɛsi
dissipar	d͡ʒisipaʁ
disso	d͡ʒiso
disso	d͡ʒisu
dissociável	dʒisosiavew
dissonância	dʒisonɐ̃sja
distante	d͡ʒistɐ̃t͡ʃi
distante	d͡ʒiʃtɐ̃t͡ʃi
distantes	distɐ̃tis
distantes	diʒtɐ̃tiʒ
distantes	dstɐ̃ts
distantes	d͡ʒistɐ̃tes
distantes	d͡ʒistɐ̃ts
distantes	d͡ʒistɐ̃t͡ʃis
distantes	d͡ʒiʃtɐ̃t͡ʃiʃ
distinguir	dʒistʃĩɡwiʁ
distinta	d͡ʒist͡ʃĩtɐ
distintas	d͡ʒist͡ʃĩtɐs
distinto	d͡ʒist͡ʃĩtu
distintos	d͡ʒist͡ʃĩtus
distinção	distĩsɐ̃w̃
distinção	diʃtĩsɐ̃w̃
distinção	d͡ʒist͡ʃĩsɐ̃w̃
distinção	d͡ʒiʃt͡ʃĩsɐ̃w̃
disto	d͡ʒisto
disto	d͡ʒistu
distorção	distoʁsɐ̃w̃
distração	distɾasɐ̃w̃
distribuição	dʒistɾibujsɐ̃w̃
distrito	d͡ʒistɾitu
distrito	d͡ʒiʃtɾitu
distância	dʒistɐ̃sjɐ
distúrbio	d͡ʒistuʁbju
dita	ditɐ
dita	dʒitɐ
ditado	d͡ʒitadu
ditadura	d͡ʒitaduɾa
ditatorial	d͡ʒitatoɾiaw
ditatorial	d͡ʒitatoɾjaw
dito	d͡ʒitu
diurese	dʒiuɾɛzi
diurna	d͡ʒiuʁnɐ
diurnas	d͡ʒiuʁnɐs
diurno	d͡ʒiuʁnu
diurnos	d͡ʒiuʁnus
diva	d͡ʒiva
divertimento	dʒivehtʃimẽtu
dividido	d͡ʒivid͡ʒidu
dividir	dʒividʒiʁ
divindade	d͡ʒivĩdad͡ʒi
divisa	divizɐ
divisão	dʒivizɐ̃w̃
divã	d͡ʒivɐ̃
diz	d͡ʒis
diz	d͡ʒiʃ
dizem	d͡ʒizẽj̃
dizer	dizeh
dizer	d͡ʒizeʁ
diário	dʒiaɾju
diáspora	d͡ʒiaspoɾɐ
dj	did͡ʒej
dj	d͡ʒid͡ʒej
dmitri	d͡ʒimitɾi
dmitri	d͡ʒmitɾi
do	du
doar	doaɹ
dobra	dɔbɾɐ
dobras	dɔbɾɐs
dobro	dobɾu
dobro	dɔbɾu
dobrão	dobɾɐ̃w̃
doce	dosi
docente	dosẽt͡ʃi
doceria	doseɾia
documental	dokumẽtaw
documentar	dokumẽtaʁ
documento	dokumẽtu
dodecaedro	dodekaɛdɾu
dodecaneso	dodekɐnezu
doe	doi
doente	duẽt͡ʃi
doença	doẽsɐ
doenças	doẽsɐs
doenças	duẽsɐs
doer	doeʁ
dog	dɔɡ
dog	dɔɡi
dogma	dɔɡimɐ
dogma	dɔɡmɐ
dogão	dɔɡɐ̃w̃
doido	dojdu
dois	dojs
doleiro	dolejɾu
dolores	doloɾis
dolorida	doloɾidɐ
doloroso	doloɾozu
dom	dõ
domina	dominɐ
dominada	dominadɐ
dominatrix	dominatriks
dominatrixes	dominatriksis
domingo	domĩɡu
domingueiro	domĩɡejɾu
dominó	dominɔ
doméstico	domɛstʃiku
donbass	dõbas
donizete	donizɛt͡ʃi
dono	dono
dono	donu
donzela	dõzɛla
donzela	dõzɛlɐ
doping	dɔpĩ
dor	do
dor	doh
dor	dor
dor	dox
dor	doɹ
dor	doɻ
dor	doɾ
dor	doʁ
dor	doχ
dorido	doɾidu
dormente	doʁmẽt͡ʃi
dorminhoco	duɾmiɲoku
dormir	doʁmiʁ
doroteia	doɾotɛjɐ
dorzinha	doʁziɲɐ
dos	dus
doudo	dowdu
douglas	dowɡlɐs
dourado	dowɾado
dourado	dowɾadu
douro	dowɾu
doutor	dowtoʁ
doutorzinho	dowtoʁziɲu
doutrinação	dotɾinasɐ̃w̃
doutro	dowtɾu
dover	doveʁ
download	daw̃lowd͡ʒ
doze	doze
doze	dozi
doçura	dosuɾa
doído	doidu
doído	duidu
dragão	dɾaɡɐ̃w̃
dresdem	dɾɛzdẽj̃
drible	dɾibli
drinque	dɾĩki
drive	dɾajv
drive	dɾajvi
driver	dɾajveʁ
droga	dɾɔɡɐ
drogaria	dɾoɡaɾiɐ
dropar	dɾopaʁ
drusa	dɾuzɐ
drácula	dɾakulɐ
duas	duɐs
dubai	dubaj
dublim	dublĩ
dublim	dɐblĩ
dudinka	dud͡ʒĩkɐ
duende	duẽd͡ʒi
duende	dwẽd͡ʒi
dum	dũ
duma	dumɐ
dumas	dumɐs
duna	dunɐ
duns	dũs
duplo	duplu
duque	duki
durar	duɾaʁ
durazzo	duɾatsu
durban	duʁbɐ̃
durex	durɛks
duro	duɾu
duríssimo	duɾisimu
duunvirato	duũviɾatu
duvidar	duvidaʁ
duzentos	duzẽtus
dá	da
dádiva	dad͡ʒivɐ
dão	dɐ̃w̃
débil	dɛbiw
débito	dɛbitu
década	dɛkɐdɐ
décimo	dɛsimu
déficit	dɛfisit
dê	de
dê	dɛ
dêixis	dejksis
dêixis	dejksiʃ
dênis	denis
díspar	d͡ʒispaʁ
dívida	d͡ʒivida
dó	dɔ
dólar	dɔlaɾ
dúvida	duvidɐ
e	e
e	i
e	ɛ
eau	eau
ebó	ebɔ
ecografia	ɛkoɡɾafiɐ
economia	ekonomiɐ
economista	ekonomistɐ
econômico	ekonomiku
eczema	eɡzemɐ
edgar	ed͡ʒiɡaʁ
edgar	ed͡ʒɡaʁ
edgar	ɛd͡ʒɡaʁ
edificar	ed͡ʒifikaʁ
edifício	edifisju
edifício	edʒifisju
editor	ed͡ʒitoʁ
editorial	editoɾiaw
edna	ɛd͡ʒinɐ
edna	ɛd͡ʒnɐ
edredom	edɾedõ
eduardo	eduardu
eduardo	eduaɾdu
eduardo	eduaʁdu
eduardo	edwaʁdu
educacional	edukasjonaw
educação	edukasɐ̃w̃
efeito	efejto
efeito	efejtu
efetivo	efetʃivu
eficaz	efikajs
egina	eʒinɐ
egito	eʒitu
ego	ɛɡu
egoísta	eɡoista
egoísta	eɡoistɐ
egoísta	eɡoiʃtɐ
egídio	eʒid͡ʒju
egípcio	eʒipsiu
ei	ej
einstein	aj̃staj̃
eira	ejɾa
eis	ejs
eis	ejʃ
ejete	eʒɛtʃi
ela	ɛlɐ
elas	ɛlɐs
ele	ele
ele	eli
ele	ɛli
elefante	elefɐ̃t͡ʃi
elegantemente	eleɡɐ̃t͡ʃimẽt͡ʃi
elegível	eleʒivew
eleição	elejsɐ̃w̃
elemento	elemẽtu
eles	eles
eles	elis
elevado	elevadu
elevar	elevaɹ
elevar	elevaɻ
elevar	elevaɾ
elevar	elevaʁ
eli	eli
elias	eliɐs
eliminar	eliminaʁ
eliminação	iliminasɐ̃w̃
elisabete	elizabɛt͡ʃi
elmo	ɛwmu
eloá	eloa
elucubrar	elukubraɾ
elucubração	elukubɾasɐ̃w̃
elvis	ɛwvis
elástico	elast͡ʃiku
elísio	elizju
em	ĩ
em	ẽj̃
emagrecer	emaɡɾeseɹ
emagrecer	emaɡɾeseɻ
emagrecer	emaɡɾeseɾ
emagrecer	emaɡɾeseʁ
emagrecer	imaɡɾeseɹ
emagrecer	imaɡɾeseɾ
emagrecer	imaɡɾeseʁ
emascular	emaskulaʁ
embaixada	ẽbajʃadɐ
embaixo	ĩbajʃu
embalagem	ĩbalaʒẽj̃
embaraço	ĩbaɾasu
embargo	ẽbaʁɡu
embolar	ĩbolaɾ
embolar	ĩbolaχ
embora	ĩbɔɾɐ
embora	ẽbɔɾa
embora	ẽbɔɾɐ
embromation	ĩbɾomejʃõ
embrulho	ĩbɾuʎu
emburrecer	ĩbuʁeseɾ
emburrecer	ĩbuʁeseχ
emburrecimento	ĩbuʁesimẽtu
eme	emj
ementa	emẽtɐ
emergir	emeʁʒiʁ
emigrar	emiɡɾaɾ
emigrar	imiɡɾaɾ
emir	emiʁ
emissora	emisoɾɐ
emitir	emitʃiʁ
emos	emus
emoção	emosɐ̃w̃
emoção	ɛmɔsɐ̃w̃
empecilho	ĩpesiʎu
empedernido	ẽpedeʁnidu
empedernidos	ẽpedeʁnidus
empedernir	ẽpedeʁniʁ
empolado	ĩmpoladu
empregar	ĩpɾeɡaʁ
emprego	ĩpɾeɡu
emprego	ĩpɾɛɡu
emprego	ẽpɾeɡu
emprego	ẽpɾɛɡu
empresa	ĩpɾezɐ
emprestar	ĩpɾestaʁ
empréstimo	ẽpɾɛst͡ʃimu
empunhar	ẽpuj̃aɾ
empurrar	ĩpuʁaʁ
empáfia	ĩpafjɐ
empório	ĩpɔɾju
emu	emu
emulação	emulasɐ̃w̃
emílio	emilju
encafifar	ĩkafifaɾ
encaixar	ĩkajʃaɹ
encaixar	ĩkajʃaɻ
encaixar	ĩkajʃaɾ
encaixar	ĩkajʃaʁ
encaixar	ẽkajʃaɹ
encaixar	ẽkajʃaɾ
encaixar	ẽkajʃaʁ
encaixe	ĩkajʃi
encaixe	ẽkajʃi
encalistrar	ĩkalijʃtɾaʁ
encalistrar	ĩkalistɾaɾ
encalço	ĩkawsu
encantar	ĩkɐ̃tah
encantar	ĩkɐ̃taʁ
encantar	ẽkɐ̃taʁ
encantação	ẽkɐ̃tasɐ̃w̃
encanto	ĩkɐ̃tu
encanto	ẽkɐ̃tu
encaroçado	ĩkaɾosadu
encavacar	ĩkavakaɾ
encefalograma	ẽsɛfaloɡɾɐmɐ
encenação	ẽsenasɐ̃w̃
encharcado	ẽʃɐɾkadu
encher	ĩʃeʁ
encher	ẽʃeʁ
enciclopédia	ẽsiklopɛd͡ʒia
encomenda	ẽkomẽdɐ
encontrar	ĩkõtɾaʁ
encontro	ĩkõtɾu
encontro	ẽkõtɾu
encorajar	ĩkõɾaʒaʁ
encravar	ẽkɾavaʁ
encravou	ẽkɾavow
endereço	ĩdeɾesu
endereço	ẽdeɾeso
endomingado	ĩdumĩɡadu
endoscopia	ĩdoskopia
endoscopia	ĩdoʃkopia
endoscopia	ẽdoskopia
endoscopia	ẽdoʃkopia
energia	eneɻʒia
energia	eneʁʒiɐ
enfardassem	ẽfaʁdasẽj̃
enfim	ẽfĩ
enfiteuse	ẽfitewzi
enfitêutico	ẽfitewt͡ʃiku
enfrentar	ĩfɾẽtaʁ
engajar	ĩɡaʒaʁ
engajar	ẽɡaʒaʁ
enganar	ĩɡɐnaʁ
enganoso	ẽɡɐnozu
engavete	ẽɡavɛtʃi
engenheiro	ẽʒeɲejɾu
engorgitamento	ẽɡoʁʒitamẽtu
engorgitamentos	ẽɡoʁʒitamẽtus
engorovinhado	ĩɡoɾoviɲadu
engraçadinho	ĩɡɾasad͡ʒiɲu
engruvinhado	ĩɡɾuviɲadu
enguia	ẽɡiɐ
enjoo	ĩʒou
enjoo	ẽj̃ʒou
enlevo	ej̃levu
enorme	enɔʁmi
enormemente	enɔʁmimẽt͡ʃi
enquadrar	ẽj̃kwadɾaɾ
enquanto	ĩkwɐ̃tu
enquanto	ẽkwɐ̃tu
enraizar	ẽʁaizaʁ
enredo	ĩʁedu
enredo	ĩʁɛdu
enrolar	ĩʁolaʁ
enrugar	ẽj̃ʁuɡaʁ
ensinamento	ĩsinamẽtu
ensinamento	ẽsinamẽtu
ensinar	ĩsinaʁ
ensino	ĩsinu
ensino	ẽsino
ensino	ẽsinu
entalhe	ẽtaʎi
entanto	ĩtɐ̃tu
ente	ẽt͡ʃi
enteado	ẽt͡ʃiadu
entediar	ĩted͡ʒiaɹ
entediar	ĩted͡ʒiaɻ
entediar	ĩted͡ʒiaɾ
entediar	ĩted͡ʒjaɹ
entediar	ĩted͡ʒjaɻ
entediar	ĩted͡ʒjaɾ
entediar	ẽted͡ʒiaɹ
entediar	ẽted͡ʒiaɻ
entediar	ẽted͡ʒiaɾ
entender	ĩtẽdeʁ
entendimento	ẽtẽd͡ʒimẽtu
entrada	ẽtɾadɐ
entrar	ẽtɾaʁ
entrave	ĩtɾavi
entre	ẽtɾe
entre	ẽtɾi
entregador	ĩtɾeɡadoɾ
entregador	ĩtɾeɡadoχ
entregar	ĩtɾeɡaʁ
entregar	ẽtɾeɡaʁ
entremeio	ẽtɾemeiu
entretanto	ẽtɾitɐ̃tu
entretenimento	ẽtɾetenimẽtu
entulhado	ẽtuʎadu
entusiasmo	ẽtuziazmu
entusiasta	ẽtuziasta
entusiasta	ẽtuziastɐ
entusiasta	ẽtuziaʃtɐ
entusiasticamente	ẽtuziastikɐmẽt͡ʃi
entusiástico	ẽtuziastiku
então	ĩtɐ̃w̃
enumeração	enumeɾasɐ̃w̃
envelope	ẽvelɔpi
envencilhar	ẽvẽsiʎaɾ
envencilhar	ẽvẽsiʎaχ
enviar	ẽviaʁ
envolver	ĩvowveʁ
envolver	ẽvowveɻ
envólucro	ĩvɔlukɾu
enxergar	ĩʃeʁɡaʁ
enxofre	enʃɔfɾɪ
enxofre	ẽjʃofɾi
enxuto	ẽʃutu
enxágue	ĩʃaɡwi
enzímico	ẽzimiku
enérgica	enɛʁʒikɐ
enérgico	enɛʁʒiku
eoo	eɔu
epifania	epifɐniɐ
epigenesia	epiʒenezia
epigenia	epiʒenia
epigênese	epiʒenezi
epilepsia	epilepsiɐ
epopeia	epopɛjɐ
epíscopo	episkopu
equidade	ekwidad͡ʒi
equilibra	ekilibɾɐ
equilíbrio	ekilibɾiw
equilíbrio	ekilibɾju
equino	ekwinu
equinócio	ekinɔsjʊ
equipa	ekipɐ
equipamento	ekipamẽtu
equipar	ekipaʁ
equipe	ekipi
equipendência	ikwipẽdẽsiɐ
equivalente	ekivalẽt͡ʃi
equivocou	ekivokow
era	ɛɾɐ
erasmo	eɾazmu
erevan	eɾevɐ̃
erguer	eʁɡeʁ
erradamente	eʁadamẽtʃi
errado	eʁadu
errar	ehaɻ
errar	ehaɾ
errar	eʁaɹ
errar	eʁaɾ
errar	eʁaʁ
errar	ɛɦah
erre	ɛʁi
erro	eʁu
erro	ɛʁu
erróneo	eʁoniu
erróneo	eʁonju
esboçar	ezbosaʁ
escachar	eskaʃaʁ
escadaria	eskadaɾia
escadaria	eskadaɾiɐ
escadaria	eʃkadaɾiɐ
escadaria	iskadaɾiɐ
escadaria	iʃkadaɾiɐ
escala	iskalɐ
escalar	iskalaʁ
escancarar	iskɐ̃kaɾaʁ
escancarar	iʃkɐ̃kaɾaɾ
escandinávia	eskɐ̃d͡ʒinavjɐ
escapar	iskapaʁ
escassez	eskases
escatológica	eskatolɔʒikɐ
esclarecedora	esklaɾesedoɾɐ
esclarecer	isklaɾeseʁ
escocesa	eskosezɐ
escocesas	eskosezɐs
escoceses	eskosezis
escocês	eskosejs
escola	eskɔlɐ
escola	iskɔlɐ
escolha	iskoʎɐ
escolher	eskoʎeɻ
escolher	iskoʎeʁ
escolho	eskoʎu
escolhos	eskɔʎus
esconder	iskõdeʁ
escorpião	eskoʁpjɐ̃w̃
escorregar	iskoʁeɡaʁ
escova	iskovɐ
escravagismo	ijʃkravaʒijʒmu
escravagismo	iskravaʒismu
escravismo	ijʃkravijʒmu
escravismo	iskravismu
escravizar	eskɾavizaʁ
escravo	ijʃkɾavu
escravo	iskɾavu
escrever	iskɾeveʁ
escrito	eskɾitu
escritor	iskɾitoʁ
escritor	iʃkɾitoʁ
escritores	iskɾitoɾis
escritores	iʃkɾitoɾiʃ
escritório	eskɾitɔɾio
escritório	eskɾitɔɾjo
escritório	eskɾitɔɾju
escritório	iskɾitɔɾju
escritório	iʃkɾitɔɾju
escrotal	iskɾotaw
escultura	eskuwtuɾɐ
escumalha	iskumaʎa
escumalha	iʃkumaʎa
escumalho	iskumaʎu
escumalho	iʃkumaʎu
escuridão	iskuɾidɐ̃w̃
escuro	iskuɾu
escusamos	eskuzɐmus
escutar	iskutaʁ
escápula	eskapula
esdras	ɛzdɾɐs
esfinge	esfĩʒi
esfinge	isfĩʒi
esforço	isfoʁsu
esfênio	isfeniu
esmagamento	izmaɡɐmẽtu
esmagar	ezmaɡaʁ
esmeralda	izmeɾawdɐ
esmirna	ezmiʁnɐ
esopo	ezopu
espacial	espasiaw
espadachim	espadaʃĩ
espalhar	espaʎaɻ
espalhar	ispaʎaʁ
espanha	ispɐɲɐ
espanhol	espɐɲɔw
esparavel	ijʃpaɾavɛw
esparavel	ispaɾavɛw
esparta	espaʁtɐ
esparta	ispaʁtɐ
espaço	ispasu
especial	ispesiaw
especificar	espesifikaʁ
especificar	ispesifikaʁ
específico	espesifiku
específico	ispesifiku
espelho	espeʎo
espelho	ispeʎu
espelho	ispɛʎu
espelho	iʃpɛʎu
esperanto	ispeɾɐ̃tʊ
esperança	espeɾɐ̃sɐ
esperança	eʃpeɾɐ̃sɐ
esperança	ispeɾɐ̃sɐ
esperança	iʃpeɾɐ̃sɐ
esperançadora	espeɾɐ̃sadoɾɐ
esperar	ispeɾaʁ
espere	espɛɾi
espere	iʃpɛɾi
esperma	ispɛʁmɐ
espertinho	espɛʁt͡ʃiɲu
esperto	ispɛʁtu
esperto	iʃpɛʁtu
espesso	espɛsu
espesso	ispɛsu
espetar	espetaʁ
espeto	espetu
espeto	espɛtu
espeto	ispetu
espeto	ispɛtu
espetou	ispetow
espiga	espiɡa
espinela	ispinɛlɐ
espingarda	espĩɡaʁdɐ
espinha	espiɲɐ
espinhaço	espiɲasu
espinho	espiɲu
espinho	ispiɲu
espinho	iʃpiɲu
espirrar	ispiʁaɾ
esplêndido	isplẽd͡ʒidu
esponsal	ispõsaw
espora	espɔɾɐ
esporte	espɔʁtʃi
esporte	ispɔʁtʃi
esposa	espoza
esposa	ispozɐ
espuma	ispũmɐ
espuma	iʃpũmɐ
espumaram	espumaɾɐ̃w̃
espádua	espadua
espártaco	espaʁtaku
espécie	espɛsji
espécie	ispɛsji
espécie	iʃpɛsji
espírito	espiɾitu
espírito	ispiɾitu
esquecer	iskeseʁ
esquecido	iskesidu
esqueleto	eskeletʊ
esquema	eskemɐ
esquema	iskemɐ
esquerda	iskeʁdɐ
esquerdo	iskeʁdu
esqui	eski
esquimó	eskimɔ
esquina	eskina
esquina	iskinɐ
essa	ɛsɐ
essas	ɛsɐs
esse	ese
esse	esi
esse	ɛsi
esses	esis
esta	ɛstɐ
estabelecer	estabeleseʁ
estabelecer	istabeleseʁ
estabelecida	estabelesidɐ
estabelecido	estabelesidu
estaca	estakɐ
estado	ejʃtadu
estado	estado
estado	istadu
estanho	iʃtɐɲu
estaquia	estakiɐ
estar	istaɹ
estar	istaɾ
estar	istaʁ
estar	iʃtaχ
estar	ta
estas	ɛstɐs
estatal	istataw
estatura	ijʃtatuɾa
estatura	istatuɾa
estatuto	estatutu
estavas	estavas
estação	istasɐ̃w̃
este	este
este	est͡ʃi
este	eʃtɪ
este	ɛste
este	ɛst͡ʃi
estender	estẽdeʁ
estender	istẽdeʁ
ester	estɛʁ
estes	est͡ʃis
esteva	estevɐ
esticar	estʃikaʁ
esticar	istʃikaʁ
estilo	est͡ʃilo
estilo	ist͡ʃilu
estimulador	est͡ʃimuladoʁ
estimulante	est͡ʃimulɐ̃t͡ʃi
estio	istʃiu
estio	iʃtʃiu
estivador	ist͡ʃivadoɻ
estofado	estofadu
estofo	estofu
estofo	estɔfu
estol	istɔw
estoma	istoma
estomacal	estomakaw
estopim	ijʃtupĩ
estopim	istupĩ
estoque	istɔki
estou	estow
estou	istow
estourar	istowɾaʁ
estouro	estowɾu
estrada	estɾadɐ
estrada	istɾadɐ
estrada	iʃtɾadɐ
estrangeirismo	istrɐ̃ʒejɾizmu
estrangeiro	istɾɐ̃ʒejɾu
estranho	istɾɐɲu
estranhíssimo	estrɐɲisimu
estratagema	estɾataʒemɐ
estratégia	estɾatɛʒia
estratégia	estɾatɛʒja
estreiteza	estɾejtezɐ
estreito	estɾejtu
estreito	istɾejtu
estrela	istɾelɐ
estremeceu	estɾemesew
estresse	estɾɛsi
estrompido	estɾõpidu
estrondo	istɾõdu
estrume	estɾumi
estrume	istɾumi
estrutura	estɾutuɾɐ
estrutura	istɾutuɾɐ
estrépito	estɾɛpitu
estudante	estudɐ̃te
estudante	istudɐ̃t͡ʃi
estudante	studɐ̃ti
estudar	istudaʁ
estudo	istudu
estudo	iʃtudu
estupenda	estupẽdɐ
estupro	ijʃtupɾu
estupro	istupɾu
está	esta
está	ista
está	ta
estádio	istad͡ʒju
estádio	iʃtad͡ʒju
estágio	estaʒiw
estágio	estaʒju
estágio	istaʒiw
estágio	istaʒju
estás	estajs
estátua	estatua
estátua	estatwa
estância	istɐ̃siɐ
estão	istɐ̃w̃
estão	iʃtɐ̃w̃
estética	estɛtikɐ
estética	estɛt͡ʃikɐ
estética	eʃtɛt͡ʃikɐ
estética	ɪʃtɛtikɐ
estêvão	estevɐ̃w̃
estêvão	istevɐ̃w̃
estímulo	est͡ʃimulu
estímulos	est͡ʃimulus
estômago	istomaɡu
etapa	etapɐ
eternamente	etɛʁnamẽt͡ʃi
eterno	etɛɹnu
eterno	etɛɾnu
etimologia	etʃimoloʒiɐ
etna	ɛt͡ʃinɐ
etíope	et͡ʃiopi
etólogo	etɔloɡu
eu	ew
eua	ewɐ
eucalipto	ewkalipitu
eucalipto	ewkaliptu
eureca	ewɾɛkɐ
euro	ewɾu
europa	ewɾɔpɐ
europeia	ewɾopɛja
europeia	ewɾopɛjɐ
europeu	ewɾopew
europol	ewɾopɔw
eurásia	ewɾazjɐ
eurípides	ewɾipid͡ʒis
eustácio	ewstasju
eustáquio	ewstakju
eusébio	ewzɛbju
euterpe	ewtɛʁpi
euzinha	ewziɲa
euzinho	ewziɲu
evento	evẽtu
evidenciar	evidẽsiaʁ
evitar	evitaʁ
evocar	evokaɻ
ex	ejs
exagero	ezaʒeɾu
exagero	ezaʒɛɾu
exalar	ezalaʁ
exame	ezɐmi
exame	izɐmi
examinar	ezɐminaʁ
examinar	izɐminaʁ
exatamente	izatɐmẽt͡ʃi
exato	ezatu
exausto	ezawstu
excalibur	eskalibuʁ
excelente	eselẽtʃi
excelência	eselẽj̃sia
excelência	eselẽj̃sja
excitador	esitadoʁ
excluir	eskluiʁ
excluir	iskluiʁ
executivo	ezekutʃivu
exegese	ezeʒɛzi
exemplo	ezẽplu
exequibilidade	ezekwibilidadʒi
exercitar	ezeʁsitaʁ
exercício	ezeʁsisju
exibido	ezibidu
exibir	ezibiʁ
exibição	ezibisɐ̃w̃
exigir	eziʒiʁ
exiguidade	eziɡwidad͡ʒi
exigência	eziʒẽsjɐ
existe	ezist͡ʃi
existe	izist͡ʃi
existem	ezistẽj̃
existem	eziʃtẽj̃
existente	ezistẽt͡ʃi
existentes	ezistẽt͡ʃis
existir	ezijʃt͡ʃiχ
existir	ezist͡ʃiɹ
existir	ezist͡ʃiɻ
existir	ezist͡ʃiʁ
existir	eziʃtiχ
existir	izist͡ʃi
existir	iziʃtiχ
existência	ezistẽsjɐ
exonerar	izoneɾaʁ
exoplaneta	ezoplaneta
exosfera	ezojʃfɛɾa
exosfera	ezosfɛɾa
expandir	ispɐ̃dʒiʁ
expansiva	espɐ̃sivɐ
expectativa	ispektatʃivɐ
experienciar	ispeɾjẽsiaʁ
experimentar	ispeɾimẽtaʁ
experiência	ispeɾiẽsjɐ
experiência	ispeɾjẽsjɐ
expert	ɛkspɛʁt͡ʃ
experto	espɛʁtu
expiração	espiɾasɐ̃w̃
explicar	isplikaʁ
explicação	esplikasɐ̃w̃
explicação	isplikasɐ̃w̃
explodir	isplodʒiʁ
exploit	eksplɔjt͡ʃ
explorar	isploɾaʁ
exploratória	esploɾatɔɾiɐ
explosão	isplozɐ̃w̃
exposição	espozisɐ̃w̃
expressar	ispɾesaʁ
expressão	ispɾesɐ̃w̃
expulsar	ispuwsaʁ
exsicante	esikãtʃi
exsicar	esikaɾ
exsicar	esikaʁ
exsudar	esudaʁ
exsurgir	esuɾʒiɾ
exsurgir	esuχʒiχ
extensão	istẽsɐ̃w̃
exterior	esteɾioʁ
exteriores	esteɾjoɾis
externo	estɛʁnu
externo	istɛʁnu
extinção	est͡ʃĩsɐ̃w̃
extinção	eʃt͡ʃĩsɐ̃w̃
extorsão	estoʁsɐ̃w̃
extra	estɾɐ
extravio	estɾaviu
extravio	istɾaviu
extração	ejstɾasɐ̃w̃
extremenho	estɾemeɲu
extremenho	eʃtɾemeɲu
extremista	estɾemistɐ
exéquias	ezɛkjas
exército	ezɛʁsitu
exíguo	iziɡwu
exímio	ezimju
exótico	ezɔtʃiku
fabiano	fabjɐnu
fabricante	fabɾikɐ̃t͡ʃi
faca	faka
faca	fakɐ
face	fasi
facebook	fejsibuki
facebook	fejzbuk
facebook	fejzbuki
faceiro	fasejɾu
fachada	faʃada
facto	faktu
factício	fakt͡ʃisju
factível	fatʃivew
faculdade	fakuwdad͡ʒi
facão	fakɐ̃w̃
fada	fada
fada	fadɐ
fadiga	fad͡ʒiɡɐ
fado	fadu
faiança	fajɐ̃sa
faixa	fajʃɐ
faixa	faʃɐ
fake	fejki
fala	falɐ
falangeta	falɐ̃ʒeta
falanginha	falɐ̃ʒiɲa
falante	falɐ̃tʃi
falar	falah
falar	falaɹ
falar	falaɻ
falar	falaʁ
falaram	falaɾɐ̃w̃
falcata	fawkata
falcão	fawkɐ̃w̃
falecer	faleseʁ
falena	falenɐ
falha	faʎɐ
falhar	faʎaʁ
falo	faɫu
falou	falow
falso	fawsu
falta	fawtɐ
faltar	fawtaʁ
faltas	fawtɐs
fama	fɐmɐ
familiar	fɐmiljaʁ
faminto	fɐmĩtu
famoso	fɐmozu
família	fɐmiljɐ
família	fɐmiʎɐ
fancaria	fɐ̃kaɾiɐ
fanfarronice	fãfaʁonisi
fantasia	fɐ̃tɐziɐ
fantasie	fɐ̃tazii
fantasies	fɐ̃taziis
fantasma	fɐ̃tazmɐ
fapar	fapaɾ
faq	fak
faraó	faɾaɔ
farc	faʁk
farelo	faɾɛlu
farinha	faɾiɲɐ
faro	faɾu
farol	faɾɔw
farra	faʁɐ
farrapo	faʁapu
fartura	faɾtuɾa
fartura	faʁtuɾa
fascismo	fasizmu
fascista	fasistɐ
fase	fazi
fashion	fɛʃõ
fatia	fat͡ʃia
fatiota	fatʃiɔtɐ
fato	fatu
fator	fatoʁ
fatorial	fatoɾiaw
fatorial	fatoɾjaw
fatwa	fatuɐ
fatwa	fatwɐ
faustoso	fawstozu
fava	favɐ
favela	favɛlɐ
favor	favoʁ
faz	fajs
faz	fajʃ
fazem	fazẽ
fazem	fazẽj̃
fazenda	fazẽdɐ
fazer	fazeh
fazer	fazeɹ
fazer	fazeɻ
fazer	fazeɾ
fazer	fazeʁ
fazer	fazeχ
faça	fasa
façam	fasɐ̃w̃
façanha	fasɐɲɐ
faço	fasu
febe	fɛbi
febre	fɛbɾe
febre	fɛbɾi
fechadura	feʃaduɾɐ
fechar	feʃaʁ
federação	fedeɾasɐ̃w̃
feed	fid͡ʒ
feedback	fidbɛk
feedback	fid͡ʒbɛk
feedback	fid͡ʒbɛki
feijoada	fejʒoadɐ
feijoada	fejʒuadɐ
feijão	fejʒɐ̃w̃
feio	feju
feioso	fejozu
feira	fejɾɐ
feitio	fejt͡ʃiw
feitiço	fejt͡ʃisu
feito	fejtu
feliz	felis
felizes	felizɪs
felizmente	felizmẽtʃi
femicídio	femisidʒju
feminicídio	feminisidʒju
feminino	femininu
feminismo	feminizmu
fenestra	fenɛstɾɐ
fenestra	fɛnɛstɾa
feno	fenu
fenícia	fenisiɐ
fenícia	fenisjɐ
fenício	fenisio
fenício	fenisjo
fera	fɛɾa
feriado	feɾiadu
ferida	feɾida
ferida	fiɾida
ferido	feɾidu
ferido	fiɾidu
ferir	feɾiʁ
fernandes	fehnɐ̃ds
fernandes	fexnɐ̃dʒiʃ
fernandes	feɾnɐ̃dʒis
ferramenta	fɛʁɐmẽtɐ
ferreira	feʁejɾɐ
ferreirinha	feʁejɾiɲɐ
ferrenho	feʁeɲu
ferro	fɛʁu
ferrovia	feʁoviɐ
ferrugem	feʁuʒẽj̃
fertilizante	fɛʁt͡ʃilizɐ̃t͡ʃi
ferve	fɛʁvi
festa	fɛstɐ
festo	fɛstu
feto	fɛtu
feudal	fewdaw
feudalismo	fewdalismo
feudalismo	fewdalismu
feudalismo	fewdaliʃmu
feudo	fewdu
fevereiro	feveɾejɾu
fez	fejs
fez	fejʃ
fez	fɛs
fez	fɛʃ
fi	fi
fiar	fiaɾ
fiar	fiaʁ
ficar	fikaɹ
ficar	fikaɾ
ficar	fikaʁ
ficará	fikaɾa
fidúcia	fidusja
figueira	fiɡejɾɐ
figura	fiɡuɾɐ
figurada	fiɡuɾadɐ
figurar	fiɡuɾaʁ
figuração	fiɡuɾasɐ̃w̃
filado	filadu
filar	filaʁ
filas	filɐs
fileira	filejɾɐ
filha	fiʎɐ
filho	fiʎu
filhos	fiʎus
filhos	fiʎuʃ
filhote	fiʎɔt͡ʃi
filhó	fiʎɔ
filial	filiaw
filipa	filipɐ
filmar	fiwmaʁ
filme	fiwme
filme	fiwmi
filomena	filomenɐ
filosofal	filozofaw
filão	filɐ̃w̃
filé	filɛ
filósofo	filɔzofu
fim	fĩ
final	finaw
finale	finali
finalizar	finalizaʁ
finalização	finalizasɐ̃w̃
finalmente	finawmẽt͡ʃi
finalzinho	finawziɲu
financeiro	finɐ̃sejɾu
financiar	finɐ̃siaʁ
finanças	finɐ̃sɐs
findo	fĩdu
fineza	fineza
fineza	finezɐ
fingimento	fĩʒimẽtu
fingir	fĩʒiʁ
finito	finitu
fino	finu
fio	fiu
fiorde	fiɔʁd͡ʒi
fiorde	fjɔʁd͡ʒi
fique	fiki
firmemente	fiʁmimẽt͡ʃi
firula	fiɾula
fisgada	fizɡadɐ
fita	fitɐ
fitness	fit͡ʃnes
fivela	fivɛlɐ
fixar	fiksaʁ
fixo	fiksu
fizeste	fizɛstʃi
flagelo	flaʒelu
flagrante	flaɡɾɐ̃t͡ʃi
flagrantes	flaɡɾɐ̃t͡ʃis
flamengo	flɐmẽɡu
flamingo	flɐmĩɡu
flamífero	flamifeɾu
flamígero	flamiʒeɾu
flanco	flɐ̃ku
flandres	flɐ̃dɾis
flanela	flanɛla
flango	flɐ̃ɡu
flashback	flɛʃbɛk
flashback	flɛʃibɛki
flatulência	flatulẽsia
flatulência	flatulẽsja
flauta	flawta
flauta	flawtɐ
fleuma	flewma
flood	flɐd͡ʒ
flor	floh
flor	floɹ
flor	floɻ
flor	floɾ
flor	floʁ
flor	floχ
flor	fɾoɻ
flora	flɔɾɐ
florença	floɾẽsɐ
floresta	floɾɛstɐ
florzinha	floʁziɲɐ
flume	flumi
fluvial	fluvjaw
fluxo	fluksu
fluência	fluẽsja
fluído	fluidu
flórida	flɔɾidɐ
fobia	fobia
foca	fɔkɐ
focar	fokaʁ
foco	fɔku
foda	foda
foda	fɔda
foder	fodex
fodão	fɔdɐ̃w̃
fodões	fɔdõj̃s
fodões	fɔdõj̃ʃ
fofo	fofu
fofoca	fɔfɔka
fofura	fofuɾa
fogaréu	foɡaɾɛw
fogaça	foɡasa
fogem	fɔʒẽj̃
fogo	foɡu
fogueira	foɡejɾɐ
foguete	fuɡetʃi
foi	foj
folegar	foleɡaʁ
folha	foʎɐ
folhear	foʎeaɾ
folia	folia
folia	foliɐ
folk	fowki
fome	fõmi
fona	fonɐ
fondue	fõd͡ʒi
fonema	fonemɐ
fonte	fõte
fonte	fõt͡ʃi
fonêmico	fonemiku
for	foʁ
for	fɔɹ
for	fɔʁ
fora	foɾɐ
fora	fɔɾɐ
foram	foɾɐ̃w̃
forasteiro	foɾastejɾu
forja	fɔʁʒɐ
forma	foʁmɐ
forma	fɔʁmɐ
formal	foʁmaw
formar	foʁmaʁ
formato	foʁmatu
formiga	foɾmiɡa
formosa	foxmɔza
formoso	foʁmozu
formulário	foʁmulaɾju
fornecer	foʁneseʁ
fornecimento	foʁnesimẽtu
foro	foɾu
forragem	foʁaʒẽj̃
forro	foʁu
forro	fɔʁu
forrobodó	foʁɔbodɔ
forró	fɔʁɔ
fortalecer	foʁtaleseʁ
fortaleza	foʁtalezɐ
forte	fɔhtɪ
forte	fɔʁt͡ʃi
fortificação	foʁt͡ʃifikasɐ̃w̃
força	foɹsa
força	foɹsɐ
força	foɻsa
força	foɻsɐ
força	foɾsa
força	foʁsɐ
forçado	foɾsadu
forçar	foʁsaʁ
fosfato	fosfatu
fosse	fosi
fosse	fɔsi
foto	fɔto
foto	fɔtu
fotografia	fotoɡɾafiɐ
foz	fɔs
fracasso	fɾakasu
fraco	fɾaku
fraga	fɾaɡɐ
fralda	fɾawdɐ
frame	fɹejm
frame	fɾejm
frame	fɾejmi
francesa	fɾɐ̃sezɐ
francisca	fɾɐ̃siskɐ
francisco	fɾɐ̃sisku
franco	fɾɐ̃ku
francês	fɾɐ̃sejs
frangalho	fɾɐ̃ɡaʎu
frango	fɾɐ̃ɡʊ
frank	fɾɐ̃k
frank	fɾɐ̃ki
frankfurt	fɾɐ̃kfuʁt͡ʃ
frança	fɾɐ̃sɐ
frapê	fɾape
fraqueza	fɾakeza
frase	fɾaze
frase	fɾazi
fraternidade	fɾateʁnidad͡ʒi
frauda	fɾawdɐ
frear	fɾeaʁ
frederico	fɾedeɾiku
freegan	fɾiɡɐ̃
freguesia	fɾeɡeziɐ
freguês	fɾeɡejs
freguês	fɾeɡejʃ
freio	fɾeju
fremente	fɾemẽtʃi
frente	fɾẽt͡ʃi
frenético	fɾenɛt͡ʃiku
frequentar	fɾekwẽtaʁ
frequente	fɾekwẽtʃi
frequência	fɾekwẽsja
freqüentemente	fɾekwẽt͡ʃimẽt͡ʃi
fresco	fɾejʃku
fresco	fɾesku
frescura	fɾejʃkuɾa
frescura	fɾeskuɾa
fresquear	fɾeskjaʁ
frete	fɾɛtʃi
fria	fɾiɐ
friagem	fɾiaʒẽj
frialdade	fɾiawdadʒi
fricção	fɾiksɐ̃w̃
frigir	fɾiʒiʁ
frincha	fɾĩʃɐ
frio	fɾiu
frio	fɾiw
friorento	fɾioɾẽtu
friulano	fɾiwlɐnu
frol	fɾɔw
frontal	fɾõtaw
fronte	fɾõt͡ʃi
fronteira	fɾõtejɾɐ
frouxidão	fɾowʃidɐ̃w̃
frouxo	fɾowʃu
frufru	fɾufɾu
fruição	fɾuisɐ̃w̃
fruição	fɾujsɐ̃w̃
fruta	fɾutɐ
fruteira	fɾuteɾɐ
fruto	fɾutʊ
frágil	fɾaʒiw
frângão	fɾɐ̃ɡɐ̃w̃
frísio	fɾiziu
frísio	fɾizju
frívolo	fɾivolu
fueguino	fueɡinu
fugir	fuʒiʁ
fui	fuj
fujão	fuʒɐ̃w̃
fulano	fulɐnu
fulcral	fuwkɾaw
fulgurar	fuwɡuɾaʁ
fuligem	fuliʒẽj̃
fulá	fula
fumacê	fumase
fumar	fumaʁ
fumaça	fumasɐ
fume	fumi
fumeante	fumeãtʃi
fumegante	fumeɡãtʃi
fumo	fumu
fumoso	fumozu
fumígeno	fumiʒenu
funchal	fũʃaw
funcho	fũʃu
funcionamento	fũsjonamẽtu
funda	fũda
fundamentais	fũdamẽtajs
fundamental	fũdamẽtaw
fundamentar	fũdamẽtaɾ
fundamentar	fũdamẽtaχ
fundação	fũdasɐ̃w̃
fundir	fũd͡ʒiʁ
fundo	fũdo
fundo	fũdu
fundão	fũdɐ̃w
funeral	funeɾaw
fungando	fũɡɐ̃du
fungar	fũɡaʁ
fungicida	fũʒisida
fungo	fũɡu
fungou	fũɡow
funil	funiw
funk	fɐ̃ki
funkeiro	fɐ̃kejɾu
funks	fɐ̃kis
função	fũsɐ̃w̃
furacão	fuɾakɐ̃w̃
furadeira	fuɾadejɾa
furem	furẽj̃
furibundo	fuɾibũdu
furioso	fuɾiozu
furioso	fuɾjozu
furo	fuɾu
furou	fuɾow
furto	fuʁtu
furão	fuɾɐ̃w̃
fusa	fuza
fusa	fuzɐ
fustigar	fustiɡaʁ
futebol	futebɔw
futebol	futibɔw
futebol	futʃbɔw
futebol	futʃibɔw
futebolista	futebolista
futicar	futʃikaɾ
futicar	futʃikaʁ
futrica	futɾika
futricada	futɾikada
futricagem	futɾikaʒi
futricagem	futɾikaʒɐ̃j̃
futricar	futɾikaɾ
futricar	futɾikaʁ
futriqueiro	futɾikejɾu
futucar	futukaɾ
futucar	futukaʁ
futum	futũ
futuro	futuɾo
futuro	futuɾu
fuxicar	fuʃika
fuxicar	fuʃikaɾ
fuxicar	fuʃikaχ
fuxico	fuʃiku
fuxiqueiro	fuʃikejɾu
fuê	fwe
fá	fa
fábrica	fabɾikɐ
fábula	fabula
fácil	fasiw
fã	fɐ̃
fé	fɛ
félix	fɛliks
fêmea	femeɐ
fêmea	femiɐ
fíbula	fibula
fígado	fiɡɐdu
física	fizikɐ
físico	fiziku
fócida	fɔsidɐ
fórum	fɔɾũ
fósforo	fɔsfoɾu
gabi	ɡabi
gabinete	ɡabinetʃi
gabriel	ɡabɾiɛw
gabão	ɡabɐ̃w̃
gadanha	ɡadɐɲɐ
gado	ɡadu
gagaúzia	ɡaɡauziɐ
gaiatar	ɡajataɾ
gaiatar	ɡajataχ
gaiatice	ɡajatʃisi
gaiato	ɡajatu
gaitar	ɡajtaɾ
gaitar	ɡajtaχ
gaitaço	ɡajtasu
gaiteiro	ɡajtejɾu
gaivota	ɡajvɔta
gajo	ɡaʒu
galego	ɡaleɡu
galera	ɡalɛɾɐ
galeria	ɡaleɾiɐ
galgo	ɡawɡu
galhada	ɡaʎadɐ
galho	ɡaʎo
galho	ɡaʎu
galileu	ɡalilew
galinha	ɡaliɲɐ
galo	ɡalu
galopeado	ɡalopiadu
galáxia	ɡalaksia
galáxia	ɡalaksja
galé	ɡalɛ
galícia	ɡalisjɐ
galípoli	ɡalipoli
gamba	ɡɐ̃bɐ
game	ɡejm
game	ɡejmi
game	ɡɐmi
gamo	ɡɐmu
gana	ɡɐnɐ
gancho	ɡɐ̃ʃu
gandhi	ɡɐ̃d͡ʒi
gangue	ɡɐ̃ɡi
ganhar	ɡɐɲaʁ
ganso	ɡɐ̃su
garagem	ɡaɾaʒẽj̃
garantir	ɡaɾɐ̃tʃiʁ
gardênia	ɡaʁdẽnjɐ
garfo	ɡaʁfu
gari	ɡaɾi
garnisé	ɡaʁnizɛ
garota	ɡaɾotɐ
garoto	ɡaɾotu
garrafa	ɡaʁafɐ
garrafas	ɡaʁafɐs
garrafas	ɡaʁafɐʃ
garrafeira	ɡaʁafejɾɐ
garrafão	ɡaʁafɐ̃w̃
garrancho	ɡahɐ̃ʃu
garrancho	ɡarɐ̃ʃu
garrancho	ɡaxɐ̃ʃu
garrano	ɡaʁɐnu
garrido	ɡɐʁidu
garrir	ɡɐʁiɾ
garça	ɡaʁsɐ
garçom	ɡaʁsõ
gastar	ɡastaʁ
gastronomia	ɡastɾonomia
gata	ɡatɐ
gate	ɡejt͡ʃ
gatilho	ɡat͡ʃiʎo
gatilho	ɡat͡ʃiʎu
gatinha	ɡat͡ʃiɲɐ
gatinha	ɡat͡ʃĩjɐ
gatinho	ɡat͡ʃiɲu
gatinho	ɡat͡ʃĩju
gato	ɡato
gato	ɡatu
gaveta	ɡaveta
gay	ɡej
gazua	ɡazua
gaúcho	ɡauʃu
geada	ʒeada
geladeira	ʒeladejɾa
geladinho	ʒeladʒiɲu
gelatina	ʒelat͡ʃina
gelinho	ʒeliɲu
gelinski	ʒelĩski
gelo	ʒelu
gelo	ʒɛlu
gema	ʒemɐ
gengiva	ʒẽʒivɐ
genioso	ʒeniozu
genitiva	ʒenit͡ʃiva
genoveva	ʒenovɛvɐ
gentalha	ʒẽtaʎa
gentalha	ʒẽtaʎɐ
gente	ʒẽte
gente	ʒẽti
gente	ʒẽt͡ʃi
gentil	ʒẽt͡ʃiw
gentileza	ʒẽtʃilezɐ
gentílico	ʒẽtʃiliku
geocêntrico	ʒeosẽtɾiku
geracional	ʒeɾasionaw
gerais	ʒeɾajs
geral	ʒeɾaw
gerar	ʒeɾaʁ
gerardo	ʒeɾaʁdu
geração	ʒeɾasɐ̃w̃
gerenciamento	ʒeɾẽsiamẽtu
gerenciamento	ʒeɾẽsjamẽtu
gerenciar	ʒeɾẽsiaʁ
gerente	ʒeɾẽt͡ʃi
geringonça	ʒeɾĩɡõsɐ
gerir	ʒeɾiʁ
gerência	ʒeɾẽsjɐ
gesso	ʒesu
gestapo	ɡestapu
gestor	ʒestoʁ
gestão	ʒestɐ̃w̃
geórgia	ʒeɔʁʒiɐ
geórgia	ʒɔʁʒiɐ
gibi	ʒibi
gibraltar	ʒibɾawtaʁ
giga	ʒiɡa
gigabit	ʒiɡabiti
gigabit	ʒiɡabit͡ʃi
gigabyte	ʒiɡabajtʃi
gigante	ʒiɡɐ̃t͡ʃi
gigolô	ʒiɡolo
gigote	ʒiɡɔtʃi
gigó	ʒiɡɔ
gigô	ʒiɡo
gilberto	ʒiwbɛʁtu
gilete	ʒilɛtʃi
gilgamesh	ɡiwɡamɛʃ
gim	ʒĩ
gincana	ʒĩkɐnɐ
ginete	ʒinete
ginete	ʒinet͡ʃi
ginga	ʒĩɡɐ
ginásio	ʒinazju
gioconda	ʒiokõdɐ
giovana	ʒiovɐna
girassol	ʒiɾasɔw
giratório	ʒiɾatɔɾju
giro	ʒiru
girândola	ʒiɾɐ̃dolɐ
gisela	ʒizɛlɐ
giz	ʒis
gizé	ʒizɛ
glande	ɡlɐ̃d͡ʒi
glasgow	ɡlazɡow
glasnost	ɡlasnɔst
glasnost	ɡlasnɔst͡ʃ
glauco	ɡlawku
gleba	ɡlɛba
glitter	ɡliteʁ
globo	ɡlobu
glorificação	ɡloɾifikasɐ̃w̃
glosar	ɡluzaɾ
gládio	ɡladʒju
glúten	ɡlutẽj̃
gnomo	ɡinomu
gnomo	ɡnomu
gnu	ɡinu
gnu	ɡnu
goa	ɡoɐ
godo	ɡodu
godofredo	ɡodofɾedu
goi	ɡɔj
goiaba	ɡojaba
goiabada	ɡojabadɐ
goiabeira	ɡojabejɾa
goivo	ɡojvu
goiânia	ɡojɐnjɐ
gol	ɡow
golfinho	ɡowfiɲu
golo	ɡolu
golpe	ɡɔwpi
golpear	ɡowpeaʁ
golpear	ɡowpiaʁ
golpelha	ɡowpeʎɐ
gols	ɡows
gomo	ɡomu
google	ɡuɡow
google	ɡuɡoɫ
gordice	ɡoʁd͡ʒisi
gordo	ɡoɹdu
gorila	ɡoɾilɐ
gorovinha	ɡoɾɔviɲa
gostar	ɡostaʁ
gostar	ɡoʃtaχ
gostar	ɡɔʃtah
gota	ɡotɐ
gota	ɡɔtɐ
goteira	ɡotejɾa
gotemburgo	ɡotẽbuʁɡu
gourmand	ɡuʁmɐ̃
governar	ɡoveʁnaʁ
governo	ɡoveʁnu
governo	ɡovɛʁnu
governo	ɡuveʁnu
gozo	ɡozu
graal	ɡɾaal
graal	ɡɾaaw
grade	ɡɾadʒi
grado	ɡɾadu
gradualmente	ɡɾaduawmẽt͡ʃi
graduação	ɡɾaduasɐ̃w̃
grafo	ɡɾafu
grafíti	ɡɾafiti
grama	ɡɾɐ̃mɐ
gramatical	ɡramatʃikaw
grampear	ɡɾɐ̃peaʁ
grampear	ɡɾɐ̃pjaʁ
grampo	ɡɾɐ̃pu
grana	ɡrɐnɐ
granada	ɡɾanadɐ
grande	ɡɾɐ̃de
grande	ɡɾɐ̃d͡ʒi
granja	ɡɾɐ̃ʒɐ
granulatura	ɡɾɐnulatuɾɐ
gratuito	ɡɾatuitu
gratuito	ɡɾatujtu
grau	ɡɾaw
gravar	ɡɾavaʁ
gravata	ɡɾavatɐ
grave	ɡɾavi
gravidade	ɡɾavidad͡ʒi
graviola	ɡɾaviɔla
graxa	ɡɾaʃa
graça	ɡɾasɐ
grecidade	ɡɾesidad͡ʒi
grego	ɡɾeɡu
gregório	ɡɾeɡɔɾju
grei	ɡrej
grei	ɡrɛj
grelo	ɡɾelu
grenha	ɡɾeɲɐ
greva	ɡɾɛva
grife	ɡɾifi
grifo	ɡɾifu
grilo	ɡɾilu
gripar	ɡɾipaʁ
gripes	ɡɾipis
grisalho	ɡɾizaʎu
grisu	ɡɾizu
grisão	ɡɾizɐ̃w̃
grisões	ɡɾizõj̃s
gritinhos	ɡɾit͡ʃiɲus
grito	ɡɾitu
groenlândia	ɡɾoẽlɐ̃d͡ʒia
groenlândia	ɡɾoẽlɐ̃d͡ʒja
groselha	ɡɾozɛʎa
grosseria	ɡɾoseɾia
grosso	ɡɾosu
grossura	ɡɾosuɾɐ
grostoli	ɡɾostoli
grostoli	ɡɾɔstoli
grotesca	ɡɾoteskɐ
grude	ɡɾud͡ʒi
grupo	ɡɾupu
gruta	ɡɾuta
gráfico	ɡɾafiku
grátis	ɡɾat͡ʃis
grânulo	ɡɾɐnulu
grão	ɡɾɐ̃w̃
grécia	ɡɾɛsjɐ
guabiju	ɡwabiʒu
guapo	ɡwapu
guardanapo	ɡwaʁdɐnapu
guardar	ɡwaɦdah
guardar	ɡwaʁdaʁ
guarida	ɡwaɾida
guarita	ɡwaɾita
guarujá	ɡwaɾuʒa
guarulhense	ɡwaɾuʎẽsi
guarulhos	ɡwaɾuʎus
guatemala	ɡwatemalɐ
guaxima	ɡwaʃimɐ
gude	ɡudʒi
guepardo	ɡepaʁdu
guerra	ɡɛha
guerra	ɡɛʁɐ
gugla	ɡuɡlɐ
guia	ɡiɐ
guiana	ɡiɐnɐ
guiana	ɡujɐnɐ
guiar	ɡiaʁ
guido	ɡidu
guilherme	ɡiʎɛhmi
guilherme	ɡiʎɛʁmi
guilhermina	ɡiʎeʁminɐ
guinéu	ɡinɛw
guisa	ɡizɐ
guita	ɡitɐ
guitarra	ɡitaʁa
guizo	ɡizu
gulodice	ɡulodʒisi
gulosice	ɡulozisi
gume	ɡume
gume	ɡumi
gunda	ɡũdɐ
guri	ɡuɾi
guê	ɡe
gás	ɡajs
gástrico	ɡastɾiku
gástrico	ɡaʃtɾiku
géis	ʒejs
géis	ʒejʃ
gélido	ʒɛlidu
género	ʒeneɾu
génova	ʒenovɐ
gê	ʒe
gêmeo	ʒemju
gênio	ʒenju
gói	ɡɔj
gótico	ɡɔt͡ʃiku
gôndola	ɡõdolɐ
habilidade	abilidadʒi
habilitar	abilitaʁ
habitante	abitɐ̃te
habitante	abitɐ̃tɪ
habitante	abitɐ̃t͡ʃi
habitação	abitasɐ̃w̃
habitação	abitasɐ̃õ
hacker	hakeɾ
haddad	adad͡ʒ
haia	ajɐ
haiti	ait͡ʃi
haiti	ajt͡ʃi
haja	aʒɐ
hall	hɔw
halterofilista	awteɾofilistɐ
hamburger	ɐ̃burɡer
hamlet	hɐmlet͡ʃ
hamlet	hɛmlet
handebol	ʁẽd͡ʒbɔw
hangul	ɐ̃ɡuw
hanna	ʁɐnɐ
harpa	aʁpɐ
harvard	haʁvaʁd͡ʒ
hasta	astɐ
haste	astʃi
hater	ʁejteɾ
havaí	avai
havendo	avẽdu
haver	aveh
haver	aveɹ
haver	aveɻ
haver	aveɾ
haver	aveʁ
hebe	ɛbi
hebraização	ebɾajzasɐ̃w̃
hebrom	ebɾõ
hediondo	ed͡ʒiõdu
hei	ej
hein	ẽj̃
helena	elenɐ
heleno	elenu
helicóptero	elikɔpiteɾu
heliocêntrico	ɛljosẽtɾiku
heloísa	eloizɐ
heloísa	elwizɐ
henrique	ẽʁiki
henriqueta	ẽʁiketɐ
hera	ɛɾa
heresia	eɾezia
hermano	eʁmɐnu
hertz	hɛʁts
hertz	hɛʁt͡ʃis
heráldica	eɾawd͡ʒika
hesitante	ezitɐ̃t͡ʃi
heterossexual	ɛteɾuksuaw
hexa	ɛksa
hexágono	eksaɡonu
hiato	iatu
hiato	jatu
hidrargírio	idɾaʁʒiɾiu
hidrelétrico	idɾelɛtɾiku
hidroelétrico	idɾoelɛtɾiku
hidrografia	idɾoɡɾafia
hidrogénio	idɾɔʒɛniu
hiena	ijɛnɐ
higeia	iʒɛjɐ
higienização	iʒienizasɐ̃w̃
hilda	iwdɐ
hildebrando	iwdebɾɐ̃du
himeneu	imenew
hindi	ĩd͡ʒi
hindu	ĩdu
hino	inu
hipocondria	ipokõdɾia
hipocrisia	ipokɾizia
hipoteca	ipotɛka
hipotensão	hipotẽsɐ̃w̃
hispânico	ispɐniku
histeria	isteɾiɐ
historicamente	istɔɾikɐmẽt͡ʃi
história	istɔɾjɐ
histórico	istɔɾiku
histórico	iʃtɔɾiku
hitler	hitleʁ
hiv	aɡaive
hobby	hɔbi
hodiernamente	odʒieɾnamẽtʃi
hoje	oʒe
hoje	oʒi
holanda	olɐ̃dɐ
holandês	olɐ̃dejs
hollywood	hɔliwud͡ʒi
holocausto	olokawstu
holofote	olofɔt͡ʃi
homem	omi
homem	omẽj̃
homem	ɔmẽj̃
homenagem	omenaʒẽj̃
homenagem	ɔmẽnaʒẽj̃
homens	õmẽj̃s
homens	õmẽj̃ʃ
homero	omɛɾu
homicídio	omisidʒiw
homicídio	omisidʒju
homologação	omoloɡasɐ̃w̃
homossexual	omoseksuaw
honestidade	onestidad͡ʒi
honra	õɦɐ
honra	õʁɐ
honrado	õwhadu
honrosa	õʁɔzɐ
honroso	õʁozu
hooligan	huliɡɐ̃
hoplita	oplitɐ
hora	ɔɾɐ
horizonte	oɾizõt͡ʃi
horror	oʁoʁ
horrível	oʁivew
horta	ɔʁtɐ
hortaliça	oɾtɐʎisɐ
hortelã	oɻtelɐ̃
hortelã	oɾtelɐ̃
hortelã	oʁtelɐ̃
hortelã	ɔhtɛlɐ̃
hortifrúti	oʁt͡ʃifɾut͡ʃi
horácio	oɾasju
hospedagem	ospedaʒẽj̃
hospedar	ospedaʁ
hospital	ospitaw
host	howst͡ʃ
hostil	ost͡ʃiw
hotel	otɛw
hugo	uɡu
hulha	uʎɐ
humanidade	umɐnidad͡ʒi
humanismo	umɐnizmu
humanitário	umɐnitaɾju
humano	umɐnu
humilhação	umiʎasɐ̃w̃
humo	umu
hungria	ũɡɾiɐ
hussardo	usaʁdu
há	a
hábito	abitu
hécate	ɛkatʃi
hélade	ɛlad͡ʒi
hércules	ɛʁkulis
hérnia	ɛɹniɐ
hérnia	ɛʁniɐ
hétero	ɛteɾu
hóplon	ɔplõ
hórus	ɔɾus
hóspedes	ɔsped͡ʒis
húmus	umus
húmus	umuʃ
húngaro	ũɡaɾu
ialta	jawtɐ
iam	iɐ̃w̃
ibérico	ibɛɾiku
iceberg	ajsibɛʁɡi
icônico	ikoniku
ida	ida
ida	idɐ
idade	idad͡ʒi
ideal	ideaw
idealização	idealizasɐ̃w̃
ideia	idɛjɐ
identidade	idẽt͡ʃidad͡ʒi
identificar	idẽt͡ʃifikaʁ
ideologia	idioloʒiɐ
idioma	id͡ʒiomɐ
idiota	id͡ʒjɔtɐ
ido	idu
idoso	idozu
idílio	id͡ʒiliu
idílio	id͡ʒilju
idóneo	idonju
idôneo	idonju
ignaro	iɡnaɾu
ignorante	iɡinoɾɐ̃t͡ʃi
ignorante	iɡnoɾɐ̃t͡ʃi
ignorar	iɡinoɾaʁ
ignorar	iɡnoɾaʁ
ignóbeis	iɡnɔbejs
ignóbil	iɡinɔbiw
igor	iɡoʁ
igreja	iɡɾeʒɐ
igual	iɡwaw
igualha	iɡwaʎɐ
igualmente	iɡwawmẽt͡ʃi
ilegal	ileɡaw
ilegível	ileʒivew
ilha	iʎɐ
ilharga	iʎaʁɡɐ
ilibado	ilibadu
illinois	ilinɔj
iluminismo	iluminizmu
ilusionista	iluzionista
ilusionista	iluzionistɐ
ilusionista	iluzioniʃtɐ
ilusionista	iluzjonista
ilusionista	iluzjonistɐ
ilusionista	iluzjoniʃtɐ
ilustrar	ilustɾaʁ
imagem	imaʒẽj̃
imaginar	imaʒinaʁ
imanente	imanẽtʃi
imanência	imanẽsja
imbatível	ĩbat͡ʃivew
imbecil	ĩbesiw
imediatamente	imed͡ʒatɐmẽt͡ʃi
imediato	imedʒiatu
imenso	imẽj̃su
imigração	imiɡɾasɐ̃w̃
imitam	imitɐ̃w̃
impaciente	ĩpasjẽt͡ʃi
impacientes	ĩpasjẽt͡ʃis
impacto	ĩpakitu
impacto	ĩpaktu
impasse	ĩpasi
impedimento	ĩped͡ʒimẽtu
impera	ĩpɛɾa
imperativa	ĩpeɾat͡ʃivɐ
imperdível	ĩpeʁd͡ʒivew
imperecibilidade	ĩperesibilidadʒi
imperialmente	ĩpɛɾiawmẽt͡ʃi
imperiosa	ĩpeɾiɔzɐ
imperiosa	ĩpeɾjɔzɐ
impertinente	ĩpeʁt͡ʃinẽt͡ʃi
impertinência	ĩpeʁt͡ʃinẽsjɐ
impessoalidade	ĩpesualidadʒi
impingir	ĩpĩʒiɾ
implausível	ĩplawzivew
implementar	ĩplemẽtaʁ
impoluto	ĩpolutu
impopular	ĩpopulaʁ
impopularidade	ĩpopulaɾidad͡ʒi
impor	ĩpoʁ
importante	ĩpoɹtɐ̃t͡ʃi
importante	ĩpoɻtɐ̃te
importante	ĩpoʁtɐ̃t͡ʃi
importância	ĩpoʁtɐ̃sjɐ
impossível	ĩposivew
imposto	ĩnposto
imposto	ĩpostu
impraticabilidade	ĩpratʃikabilidadʒi
impraticável	ĩpratʃikavew
imprensa	ĩpɾẽsɐ
imprescritível	ĩpɾeskritʃivew
imprimir	ĩpɾimiʁ
improvável	ĩpɾovavew
impulsivamente	ĩpuwsivɐmẽt͡ʃi
impuro	ĩpuɾu
império	ĩpɛɾju
imundície	imũd͡ʒisi
imundície	imũd͡ʒisji
imóvel	imɔvew
inacabado	inakabadu
inarticulada	inaʁt͡ʃikuladɐ
incapacidade	ĩkapasidad͡ʒi
incapacitar	ĩkapasitaʁ
incapaz	ĩkapajs
incel	ĩsɛw
incensar	ĩsẽsaʁ
incenso	ĩsẽsu
incentivar	ĩsẽt͡ʃivaʁ
incerteza	ĩseʁtezɐ
incesto	ĩsestu
incesto	ĩsɛstu
inchar	ĩʃaʁ
incisão	ĩsizɐ̃w̃
incitador	ĩsitadoʁ
incluindo	ĩkluĩdu
incluir	ĩkluiʁ
incluso	ĩkluzu
incolumidade	ĩkolumidadʒi
incomodar	ĩkomodaʁ
incomparável	ĩkõpaɾavew
inconsciente	ĩkõsiẽt͡ʃi
inconsciência	ĩkõsiẽsiɐ
inconsolada	ĩkõsoladɐ
inconstante	ĩkõstɐ̃t͡ʃi
incorporar	ĩkoʁpoɾaʁ
incrementar	ĩkremẽtaɾ
incrédulo	ĩkrɛdulu
incumprimento	ĩkũpɾimẽtu
incutir	ĩkutʃiɹ
incêndio	ĩsẽd͡ʒio
incêndio	ĩsẽd͡ʒiw
incêndio	ĩsẽd͡ʒjo
incêndio	ĩsẽd͡ʒju
indecente	ĩdesẽt͡ʃi
indefinido	ĩdefinidu
independente	ĩdepedẽtʃi
independente	ĩdepẽdẽte
independência	ĩdepẽdẽsjɐ
indicar	ĩd͡ʒikaʁ
indissociável	ĩdʒisosiavew
individual	ĩd͡ʒividuaw
indivíduo	ĩdʒividu
indivíduo	ĩdʒividwu
indo	ĩdu
indulto	ĩduwtu
industrial	ĩdustɾiaw
indústria	ĩdustɾjɐ
inepto	inɛptu
inerência	ineɾẽsja
inesperada	inespeɾadɐ
inexequibilidade	inezekwibilidadʒi
inexequível	inezekwivew
infante	ĩfɐ̃t͡ʃi
infantilmente	ĩfɐ̃t͡ʃiwmẽt͡ʃi
infelicidade	ĩfelisidad͡ʒi
infelizmente	ĩfelizmẽt͡ʃi
inferno	ĩfɛʁnu
infiltração	ĩfiwtɾasɐ̃w̃
infindo	ĩfĩdu
infinita	ĩfinitɐ
infinitivo	ĩfĩnit͡ʃivu
infinito	ĩfinitu
inflação	ĩflasɐ̃w̃
influenciar	ĩfluẽsiaʁ
influência	ĩfluẽsjɐ
informar	ĩfoʁmaʁ
informação	ĩfoʁmasɐ̃w̃
informática	ĩfoɹmat͡ʃikɐ
informática	ĩfoɻmat͡ʃika
informática	ĩfoʁmat͡ʃikɐ
ingerência	ĩʒeɾẽsja
inglaterra	ĩɡlatɛʁɐ
inglês	ĩɡlejs
inglês	ĩɡlejʃ
ingrid	ĩɡɾid͡ʒ
ingrid	ĩɡɾid͡ʒi
inguchétia	ĩɡuʃɛt͡ʃjɐ
ingurgitamento	ĩɡuʁʒitamẽtu
inhapa	iɲapɐ
inicial	inisjaw
inicialmente	inisjawmẽt͡ʃi
iniciante	inisiɐ̃tʃi
iniciar	inisiaʁ
iniquidade	inikwidadʒi
injete	ĩʒɛtʃi
injeção	ĩʒɛsɐ̃w̃
injúria	ĩʒuɾjɐ
inquisição	ĩkizisɐ̃w̃
insalubre	ĩsalubɾi
insano	ĩsɐnu
inseguro	ĩseɡuɾu
insensato	ĩsẽsatu
insensatos	ĩsẽsatus
insensibilidade	ĩsẽsibilidad͡ʒi
inseto	ĩsɛtu
insidiosa	ĩsid͡ʒiɔzɐ
insidiosa	ĩsid͡ʒjɔzɐ
insinuar	ĩsinuaʁ
insistir	ĩsistʃiʁ
insofismável	ĩsofismavew
insolvente	ĩsɔwvẽt͡ʃi
insondável	ĩsõdavew
inspirar	ĩspiɾar
instalar	ĩstalaɾ
instalar	ĩstalaʁ
instante	ĩstɐ̃t͡ʃi
instaurar	ĩstawɾaʁ
instigador	ĩstiɡadoʁ
instinto	ĩst͡ʃĩtu
instintos	ĩst͡ʃĩtus
instituição	ĩstʃituisɐ̃w̃
instituição	ĩstʃitujsɐ̃w̃
instituto	ĩstʃitutu
instrumento	ĩstɾumẽtu
instrutiva	ĩstɾut͡ʃivɐ
instável	ĩstavew
instância	ĩstɐ̃siɐ
instância	ĩstɐ̃sjɐ
insubordinação	ĩsuboɾdʒinasɐ̃w̃
insuficiente	ĩsufisiẽt͡ʃi
insulina	ĩsulinɐ
insumo	ĩsumu
insurreição	ĩsuʁejsɐ̃w̃
insuscetível	ĩsusetʃivew
insígnia	ĩsiɡinjɐ
insônia	ĩsonia
insônia	ĩsonja
int	ĩt͡ʃ
intacto	ĩtaktu
intactos	ĩtaktus
integerrimamente	ĩteʒɛʁimɐmẽt͡ʃi
integérrimo	ĩteʒɛʁimu
inteiro	ĩtejɾo
inteiro	ĩtejɾu
inteiro	ĩtɛɾu
intelectual	ĩtelɛktuaw
inteligência	ĩteliʒẽsia
inteligência	ĩteliʒẽsja
intencionalmente	ĩtẽsjonawmẽt͡ʃi
intensa	ĩtẽsɐ
intensamente	ĩtẽsɐmẽt͡ʃi
intenso	ĩtẽsu
intento	ĩtẽtu
intenção	ĩtẽsɐ̃w̃
intercessor	ĩteʁsesoʁ
intercorrência	ĩteɾkoʁẽsja
interessante	ĩteɾesɐ̃t͡ʃi
interesse	ĩteɾesi
interesseiro	ĩteɾesejɾu
interferência	ĩteʁfeɾẽsiɐ
interior	ĩteɾioʁ
interior	ĩteɾjoʁ
interiorano	ĩteɾjoɾɐnu
internacional	ĩteɹnasionaw
internacional	ĩteɻnasionaw
internacional	ĩteɻnasjonaw
internacional	ĩteʁnasjonaw
internalização	ĩteɾnalizasɐ̃w̃
internauta	ĩteɾnawtɐ
internauta	ĩteʁnawtɐ
internação	ĩteɾnasɐ̃w̃
internação	ĩteχnasɐ̃w̃
internet	ĩteɾnɛtʃi
internet	ĩteχnɛtʃi
interno	ĩtɛʁnu
interpretar	ĩteʁpɾetaʁ
interpretação	ĩteʁpɾetasɐ̃w̃
interrogativa	ĩteʁoɡat͡ʃivɐ
intervalo	ĩteʁvalu
intifada	ĩt͡ʃifadɐ
intimamente	ĩt͡ʃimamẽt͡ʃi
intimidade	ĩtĩmidadʒi
intracraniana	ĩtɾakɾɐnjɐnɐ
intracraniano	ĩtɾakɾɐnjɐnu
intragável	ĩtraɡavew
intrigue	ĩtɾiɡi
introduzir	ĩtɾoduziʁ
introdução	ĩtɾodusɐ̃w̃
introjetar	ĩtɾoʒetaɾ
introjeção	ĩtɾoʒesɐ̃w̃
intromete	ĩtɾomɛtʃi
intuitivo	ĩtuit͡ʃivu
intuição	ĩtuisɐ̃w̃
intuição	ĩtwisɐ̃w̃
invasão	ĩvazɐ̃w̃
invencível	ĩvẽsivew
inventando	ĩvẽtɐ̃du
inventário	ĩvẽtaɾju
inverno	ĩvɛʁnu
investigador	ĩvest͡ʃiɡadoʁ
investigar	ĩvest͡ʃiɡaʁ
investigação	ĩvestʃiɡasɐ̃w̃
investimento	ĩvest͡ʃimẽtu
investir	ĩvestʃiʁ
inviabilidade	ĩviabilidadʒi
invisível	ĩvizivew
invocar	ĩvokaʁ
invólucro	ĩvɔlukɾu
inácio	inasju
inês	inejs
início	inisiu
início	inisju
iníquo	inikwu
inútil	inutʃiw
ioga	ioɡa
ioga	iɔɡa
ioga	joɡa
ioga	jɔɡa
iolanda	jolɐ̃dɐ
ionosfera	jonojʃfɛɾa
ionosfera	jonosfɛɾa
ipê	ipe
ir	iʁ
ira	iɾɐ
irene	iɾeni
iria	iɾiɐ
irmandade	iʁmɐ̃dad͡ʒi
irmã	iʁmɐ̃
irmão	iʁmɐ̃w̃
ironicamente	iɾonikɐmẽt͡ʃi
irracional	iʁasiunaw
irracionalidade	iʁasiunalidad͡ʒi
irregularidades	iʁeɡulaɾidad͡ʒis
irrelevante	iʁelevɐ̃t͡ʃi
irrepreensível	iʁepɾeẽsivew
irritante	iʁitɐ̃t͡ʃi
irrupção	iʁupsɐ̃w̃
is	is
isabel	izabɛw
isaías	izaiɐs
isca	iskɐ
isentar	izẽtaɾ
isento	izẽtu
isenção	izẽsɐ̃w̃
isis	izis
islamização	izlɐmizasɐ̃w̃
islandês	izlɐ̃dejs
ismael	izmaɛw
isolação	izolasɐ̃w̃
isopor	izopoɻ
isopor	izopoɾ
isopor	izopoʁ
isqueiro	ijʃkejɾu
isqueiro	iskejɾu
israel	izʁaɛw
isso	isu
istambul	istɐ̃buw
isto	isto
isto	istu
isto	iʃtu
italiano	italiɐnu
italiano	italjɐnu
itamaraty	itamaɾatʃi
itera	itɛra
iterar	iteɾaɾ
iterar	iteɾaχ
itália	italjɐ
ivan	ivɐ̃
içado	isadu
iço	isu
iídiche	id͡ʒiʃi
j	ʒɔta
jaborandi	ʒaboɾɐ̃d͡ʒi
jabuti	ʒabut͡ʃi
jacarandá	ʒakaɾɐ̃da
jacarta	ʒakaʁtɐ
jacaré	ʒakaɾɛ
jacinto	ʒɐsĩtu
jacto	ʒaktu
jacó	ʒakɔ
jaez	ʒɐeʃ
jaguarundi	ʒaɡwaɾũdʒi
jaime	ʒajmi
jair	ʒaiʁ
jaleco	ʒalɛku
jamaica	ʒamajkɐ
jamais	ʒamajs
jamanta	ʒamɐ̃tɐ
jambo	ʒɐ̃bu
jambo	ʒɐ̃mbu
jamelão	ʒamelɐ̃w̃
janeiro	ʒɐnejɾu
janela	ʒanɛla
janela	ʒãnɛla
jangada	ʒɐ̃ɡadɐ
jano	ʒɐnu
janotar	ʒanotaɾ
janotar	ʒanotaχ
janta	ʒɐ̃tɐ
jantar	ʒɐ̃taʁ
janízaro	ʒɐnizaɾu
japa	ʒapɐ
japonesa	ʒaponezɐ
japonês	ʒaponejs
japonês	ʒaponejʃ
japão	ʒapɐ̃w̃
jaqueta	ʒaketɐ
jardim	ʒaxd͡ʒĩj̃
jardim	ʒaɦdĩj̃
jardim	ʒaʁd͡ʒĩj̃
jargão	ʒaʁɡɐ̃w̃
jasmim	ʒazmĩ
jasão	ʒazɐ̃w̃
jato	ʒatu
javalina	ʒavalina
javé	ʒavɛ
jazz	d͡ʒɛs
jean	ʒeɐ̃
jeans	d͡ʒĩs
jeito	ʒejtu
jejum	ʒeʒũ
jenifer	dʒẽnifeʁ
jeová	ʒeova
jeremias	ʒeɾemiɐs
jericó	ʒeɾikɔ
jerusalém	ʒeɾuzalẽj̃
jerónimo	ʒeɾonimu
jessé	ʒesɛ
jesus	ʒezujs
jetro	ʒɛtɾu
jihad	ʒiʁad
jihad	ʒiʁad͡ʒ
jiló	ʒilɔ
joana	ʒoɐnɐ
joana	ʒuɐnɐ
joaquim	ʒwakĩ
job	dʒɔbi
joelho	ʒueʎu
jogador	ʒoɡadoʁ
jogar	ʒoɡaɻ
jogar	ʒoɡaɾ
jogar	ʒoɡaʁ
jogging	d͡ʒɔɡĩ
jogo	ʒoɡo
jogo	ʒoɡu
jogo	ʒɔɡu
joguetar	ʒoɡetaɾ
joguetar	ʒoɡetaχ
joguete	ʒoɡɛtʃi
joice	ʒɔjsi
joinha	ʒɔiɲɐ
joio	ʒoju
jonas	ʒonɐs
jonathan	d͡ʒonatɐ̃
jonathan	ʒonatɐ̃
jorna	ʒɔʁna
jorna	ʒɔʁnɐ
jornada	ʒoɻnadɐ
jornal	ʒoʁnaw
josué	ʒozuɛ
josé	ʒozɛ
josé	ʒuzɛ
jota	ʒɔta
jovem	ʒɔvẽj̃
joão	ʒoɐ̃w̃
joão	ʒuɐ̃w̃
joão	ʒwɐ̃w̃
joãozinho	ʒoɐ̃w̃ziɲu
joãozinho	ʒwɐ̃w̃ziɲu
juba	ʒubɐ
judaico	ʒudajku
judas	ʒudɐs
judeia	ʒudɛjɐ
judeu	ʒudew
judicial	ʒudisjaw
juiz	ʒuis
juiz	ʒwis
juiz	ʒwiʃ
juizado	ʒuizadu
juju	ʒuʒu
julgadora	ʒuwɡadoɾa
julgamento	ʒuwɡamẽtu
julgar	ʒuwɡaʁ
julho	ʒuʎu
juliana	ʒuliɐnɐ
juliana	ʒuljɐnɐ
juliano	ʒuliɐnu
juliano	ʒuljɐnu
juliet	ʒuliɛtʃi
julieta	ʒulietɐ
julieta	ʒuljetɐ
jumento	ʒumẽtu
junho	ʒuɲu
junta	ʒũtɐ
juntar	ʒũtaɻ
juntar	ʒũtaʁ
juntas	ʒũtɐs
junto	ʒũtu
juntos	ʒũtus
jura	ʒuɾa
juramento	ʒuɾɐmẽtu
juro	ʒuɾu
juscelino	ʒuselinu
justamente	ʒustamẽt͡ʃi
justeza	ʒustezɐ
justificar	ʒustʃifikaʁ
justificativa	ʒust͡ʃifikat͡ʃiva
justina	ʒust͡ʃinɐ
justino	ʒust͡ʃinu
justiça	ʒustʃisɐ
justo	ʒustu
juvenil	ʒuveniw
juvenis	ʒuvenis
juventude	ʒuvẽtudʒi
juíza	ʒuiza
já	ʒa
jápeto	ʒapetu
jéssica	ʒɛsikɐ
júlia	ʒuljɐ
júlio	ʒulju
k	ka
kagoshima	kaɡoʃimɐ
kalevala	kalevalɐ
kaminski	kamĩski
kawaii	kawaji
kazatchok	kazat͡ʃɔki
khmer	kimɛʁ
khmer	kmɛʁ
kiev	kiɛv
kiev	kiɛvi
kilimanjaro	kilimɐ̃ʒaɾu
kilobit	kilobiti
kilobit	kilobit͡ʃi
kilobyte	kilobajtʃi
kirov	kiɾɔv
kit	kit͡ʃ
klinger	klĩʒɛɹ
klinger	klĩʒɛɾ
klinger	klĩʒɛʁ
klinger	klĩʒɛχ
kombi	kombi
kombi	kõbi
kosovo	kozovu
kowalski	kovawski
kuduro	kuduru
kyat	kiat͡ʃi
la	lɐ
labareda	labaɾeda
laboral	laboɾaw
labrador	labɾadoʁ
lacera	lasɛɾa
lacinho	lasiɲu
lacrau	lakɾaw
lacração	lakɾasɐ̃w̃
lacrimal	lakɾimaw
lacónia	lakoniɐ
lacônico	lakoniku
ladeira	ladejra
ladeira	ladejrɐ
ladinho	lad͡ʒiɲu
lado	ladu
ladram	ladɾɐ̃w̃
ladrar	ladɾaʁ
ladrão	ladɾɐ̃w̃
ladrãozeco	ladɾɐ̃w̃zɛku
lagartear	laɡaʁt͡ʃjaʁ
lagarto	laɡaʁtu
lago	laɡu
lagoa	laɡoɐ
lahore	lahɔɾi
laico	lajku
lama	lɐmɐ
lambiam	lɐ̃biɐ̃w̃
lambida	lɐ̃bidɐ
lambuzar	lɐ̃buzaʁ
lameira	lamejɾɐ
lameiro	lamejɾu
lamento	lɐmẽtu
lamparina	lɐ̃paɾinɐ
lampejo	lɐ̃peʒu
lampejo	lɐ̃pɛʒu
lampião	lɐ̃piɐ̃w̃
lampião	lɐ̃pjɐ̃w̃
lamúria	lamuɾja
lan	lɐ̃
lancha	lɐ̃ʃɐ
lanchar	lɐ̃ʃar
lanche	lãʃi
lanchou	lɐ̃ʃow
lande	lɐ̃d͡ʒi
lanterninha	lɐ̃tɛɾniɲɐ
lança	lɐ̃sa
lança	lɐ̃sɐ
lançamento	lɐ̃samẽtu
lançar	lɐ̃saʁ
lanço	lɐ̃su
laos	laws
lapa	lapa
lapa	lapɐ
lapidar	lapidaʁ
laptop	lɛptɔp
laquê	lake
lar	laɹ
lar	laɾ
lar	laʁ
lara	laɾɐ
laranja	laɾɐ̃ʒɐ
laranjeira	laɾɐ̃ʒejɾa
laranjeira	laɾɐ̃ʒejɾɐ
largar	laɹɡaɹ
largar	laɾɡaɾ
largar	laχɡaχ
largo	laɹɡu
largo	laɻɡo
largo	laʁɡu
las	lɐs
las	lɐʃ
lasca	laskɐ
lasso	lasu
lastimosa	last͡ʃimɔzɐ
lata	latɐ
latam	latɐ̃w̃
latamos	latɐmus
latas	latɐs
late	lat͡ʃi
latem	latẽj̃
lates	lat͡ʃis
lati	lat͡ʃi
latia	lat͡ʃiɐ
latiam	lat͡ʃiɐ̃w̃
latias	lat͡ʃiɐs
latim	lat͡ʃĩ
latimos	lat͡ʃimus
latino	lat͡ʃinu
latira	lat͡ʃiɾɐ
latiram	lat͡ʃiɾɐ̃w̃
latiras	lat͡ʃiɾɐs
latirei	lat͡ʃiɾej
latirem	lat͡ʃiɾẽj̃
latiremos	lat͡ʃiɾemus
latires	lat͡ʃiɾis
latiria	lat͡ʃiɾiɐ
latiriam	lat͡ʃiɾiɐ̃w̃
latirias	lat͡ʃiɾiɐs
latirmos	lat͡ʃiʁmus
latirá	lat͡ʃiɾa
latirás	lat͡ʃiɾas
latirão	lat͡ʃiɾɐ̃w̃
latiríamos	lat͡ʃiɾiɐmus
latis	lat͡ʃis
latisse	lat͡ʃisi
latissem	lat͡ʃisẽj̃
latisses	lat͡ʃisis
latiste	lat͡ʃist͡ʃi
latiu	lat͡ʃiw
lato	latu
latíamos	lat͡ʃiɐmus
latíramos	lat͡ʃiɾɐmus
latíssemos	lat͡ʃisemus
laudação	lawdasɐ̃w̃
laura	lawɾɐ
laurêncio	lawɾẽsju
lava	lava
lavabo	lavabu
lavanda	lavɐ̃dɐ
lavar	lavaʁ
lavra	lavɾa
layout	lejawt͡ʃ
laço	lasu
lealdade	leawdad͡ʒi
lecionar	lesjonaɾ
lecionar	lesjonaχ
led	lɛd͡ʒ
ledo	ledu
legais	leɡajs
legal	leɡaw
legenda	leʒẽda
legionário	leʒionaɾiu
legionário	leʒjonaɾju
legislação	leʒislasɐ̃w̃
legião	leʒiɐ̃w̃
legião	leʒjɐ̃w̃
lego	lɛɡu
lei	lej
leigo	lejɡu
leila	lejlɐ
leira	lejɾa
leira	lejɾɐ
leite	lejte
leite	lejti
leite	lejtʃi
leito	lejtu
leitão	lejtɐ̃w̃
lembrança	lẽbɾɐ̃sa
lembrança	lẽbɾɐ̃sɐ
lembrar	lẽbɾaʁ
leme	lemi
lenda	lẽda
lenda	lẽdɐ
lendo	lẽdu
lene	leni
leniência	leniẽsja
lente	lẽt͡ʃi
lentes	lẽt͡ʃis
lentilha	lẽt͡ʃiʎa
lentilha	lẽt͡ʃiʎɐ
lento	lẽtu
lentícula	lẽt͡ʃikulɐ
lenço	lẽsu
lençol	lẽsɔw
leo	lɛw
leonardo	leonaʁdu
leonor	lewnoʁ
lepra	lɛpɾa
lepra	lɛpɾɐ
leque	lɛki
ler	leʁ
lesma	lezma
lesma	lezmɐ
lesma	leʒmɐ
leste	lest͡ʃi
leste	lɛst͡ʃi
lesão	lezɐ̃w̃
letra	letɾɐ
letrado	letɾadu
letrinha	letɾiɲɐ
letão	letɐ̃w̃
leu	lew
leucemia	lewsemia
leucemia	lewsemiɐ
leva	lɛvɐ
levantar	levɐ̃taʁ
levar	levaʁ
leve	lɛvi
lewandowski	levɐ̃dɔvski
lexicologia	lɛksikoloʒia
lexicologia	lɛksikoloʒiɐ
leão	leɐ̃w̃
leão	ljɐ̃w̃
leão	lɛɐ̃w̃
lhama	ʎɐmɐ
lhe	li
lhe	ʎi
lhes	ʎis
liberal	libeɾaw
liberação	libeɾasɐ̃w̃
liberdade	libeɹdad͡ʒi
liberdade	libeɾdade
liberdade	libeɾdad͡ʒi
liberdade	libeʁdadʒi
liberrimamente	libɛʁimɐmẽt͡ʃi
libra	libɾɐ
libras	libɾɐs
libélula	libɛlulɐ
libéria	libɛɾiɐ
libérrimo	libɛʁimu
licença	lisẽsa
licença	lisẽsɐ
lidar	lidaʁ
lidera	lidɛɾa
liderança	lideɾɐ̃sɐ
liderar	lideɾaʁ
liga	liɡa
liga	liɡɐ
ligado	liɡadu
ligar	liɡah
ligar	liɡaɹ
ligar	liɡaɻ
ligar	liɡaʁ
ligar	liɡaχ
ligação	liɡasɐ̃w̃
light	lajt͡ʃ
lilongwe	lilõɡwɛ
lima	lima
lima	limɐ
limeira	limejɾa
limeira	limejɾɐ
limitado	limitadu
limitar	limitaʁ
limoeiro	limoejɾu
limpar	lĩpaɹ
limpar	lĩpaɻ
limpar	lĩpaʁ
limpeza	lĩpeza
limpeza	lĩpezɐ
limpo	lĩpu
limão	limɐ̃w̃
limítrofe	limitɾofi
lince	lĩsi
linda	lĩdɐ
lindo	lĩdu
lingala	lĩɡalɐ
lingerie	lɐ̃ʒeʁi
linguagem	lĩɡwaʒẽj̃
lingual	lĩɡwaw
linguiça	lĩɡuisa
linguiça	lĩɡuisɐ
linguiça	lĩɡwisa
linguiça	lĩɡwisɐ
linha	liɲɐ
linho	liɲu
lintel	lĩtɛɫ
lisboa	lizboa
liso	lizu
lista	listɐ
listagem	listaʒẽj̃
lisura	lizuɾa
literatura	liteɾatuɾa
literatura	liteɾatuɾɐ
litigar	litʃiɡaɹ
litigar	litʃiɡaχ
litoral	litoɾaw
liverpool	liveʁpuw
livrar	livɾaʁ
livraria	livɾaɾia
livraria	livɾaɾiɐ
livre	livɾi
livreiro	livɾejɾu
livremente	livɾimẽt͡ʃi
livrete	livɾet͡ʃi
livreto	livɾetu
livro	livɾu
lixa	liʃɐ
lixo	liʃu
lição	lisɐ̃w̃
lobby	lɔbi
lobisomem	lobizomẽj̃
lobisomem	lobizɔmẽj̃
lobista	lobista
lobista	lobistɐ
lobo	lobu
lobo	lɔbu
local	lokaw
localmente	lokawmẽt͡ʃi
login	lɔɡĩ
logo	loɡu
logo	lɔɡu
logos	loɡus
logro	loɡɾu
logística	loʒist͡ʃika
logística	loʒist͡ʃikɐ
logística	loʒiʃt͡ʃikɐ
loiro	lojɾu
loja	lɔʒɐ
lolardo	lolaʁdu
lombardia	lõbaʁd͡ʒiɐ
lombardo	lõbaʁdu
lombo	lõbu
londres	lõdɾes
londres	lõdɾis
londres	lõdɾiʃ
longanimidade	lõɡɐnimidadʒi
longe	lõʒi
longo	lõɡu
los	lus
los	luʃ
losango	lozɐ̃ɡu
lotar	lotaʁ
lote	lɔt͡ʃi
lotear	lot͡ʃiaɾ
louco	lowku
loucura	lowkuɾɐ
louquear	lokeaɾ
louquear	lowkeaʁ
loureiro	lowɾejɾu
lourenço	lowɾẽsu
louro	lowɾu
lousa	lowza
lousa	lowzɐ
louvar	lowvaʁ
lua	luɐ
luanda	luɐ̃dɐ
lucas	lukɐs
luciano	lusjɐnu
lucrar	lukɾaʁ
lucro	lukɾu
lugar	luɡaɹ
lugar	luɡaɻ
lugar	luɡaɾ
lugar	luɡaʁ
lugar	luɡaχ
lula	lula
lula	lulɐ
lulopetismo	lulopet͡ʃizmu
luminoso	luminozu
lupa	lupɐ
lusitano	luzitɐnu
luso	luzu
lustre	lustɾi
lustre	luʃtɾi
luta	lutɐ
lutar	lutaʁ
lutinha	lut͡ʃiɲɐ
luto	lutu
luva	luvɐ
luvaria	luvaɾiɐ
luxemburgo	luʃẽbuʁɡu
luxo	luʃu
luxúria	luʃuɾiɐ
luz	lujs
luz	lujʃ
luís	luis
luís	luiʃ
lá	la
lábio	labiu
lábio	labju
lácio	lasju
ládoga	ladoɡɐ
lágrima	laɡɾimɐ
lápide	lapid͡ʒi
lápis	lapis
lázaro	lazaɾu
lâmina	lɐminɐ
lâmpada	lɐ̃pɐdɐ
lânguido	lɐ̃ɡidu
lã	lɐ̃
lê	le
lêmure	lemuɾi
lêndea	lẽd͡ʒjɐ
líbano	libɐnu
líder	lideʁ
lídia	lid͡ʒjɐ
língua	lĩɡwɐ
lípsia	lipsjɐ
líquido	likidu
líquido	likwidu
lírica	liɾikɐ
lírico	liɾiku
lírio	liɾju
lítio	litiu
lógica	lɔʒika
lógico	lɔʒiku
lótus	lɔtus
lúcia	lusjɐ
lúcida	lusidɐ
lúpulo	lupulu
lútea	luteɐ
lútea	lut͡ʃiɐ
macaco	makaku
macarrão	makahɐ̃õ
macarrão	makaʁɐ̃w̃
macedónia	masedonjɐ
macete	masetʃi
machadiano	maʃad͡ʒjɐnu
machadinha	maʃadʒiɲa
machado	maʃadu
machista	maʃistɐ
macho	maʃu
machucar	maʃukaʁ
macio	masiu
maciço	masisu
macla	maklɐ
maconha	makoɲa
macumba	makũbɐ
madeira	madejɾa
madeira	madejɾɐ
madrasta	madɾasta
madrasta	madɾastɐ
madrasta	madɾaʃtɐ
madre	madɾi
madressilva	madɾesiwvɐ
madrigal	madɾiɡaw
madrinha	madɾĩɲɐ
madruga	madɾuɡɐ
madrugada	madɾuɡadɐ
madrugar	madɾuɡaɾ
madrugar	madɾuɡaʁ
maduro	maduɾu
mafioso	mafiozu
mafioso	mafjozu
magia	maʒia
magistratura	mɐʒiʃtɾɐtuɾɐ
magistério	maʒijʃtɛɾju
magistério	maʒistɛɾju
magnífico	maɡinifiku
magnífico	maɡnifiku
mago	maɡu
magoar	maɡwaʁ
magro	maɡɾu
maio	maju
maionese	majonɛzi
maior	majɔʁ
maioria	majoɾiɐ
maioridade	majoɾidadʒi
mais	majs
maisena	majzena
major	maʒɔʁ
mal	maw
mala	malɐ
malandragem	malɐ̃dɾaʒẽj̃
malandrar	malɐ̃dɾaʁ
malaquias	malakiɐs
maldição	mawd͡ʒisɐ̃w̃
maleficiar	malefisiaɾ
maleficiar	malefisiaχ
malefício	malefisju
maleta	maleta
maleta	maletɐ
malformação	mawfoʁmasɐ̃w̃
malformações	mawfoʁmasõj̃s
malha	maʎa
malha	maʎɐ
malhar	maʎaʁ
malho	maʎu
maligno	maliɡnu
malina	malinɐ
malinha	maliɲɐ
malinhas	maliɲɐs
maloca	malɔka
malograr	maloɡɾar
malograr	maloɡɾaʁ
maloqueiro	malokejɾu
malsã	mawsɐ̃
maltês	mawtejs
maltês	mawtejʃ
malva	mawvɐ
malvão	mawvɐ̃w̃
malásia	malazjɐ
malévola	malɛvolɐ
malévolo	malɛvolu
mambembe	mɐ̃bẽjbi
mameluco	mameluku
mamilo	mɐmilʊ
mamute	mɐmut͡ʃi
mamão	mɐmɐ̃w̃
manada	manada
manada	manadɐ
manancial	mɐnɐ̃sjaw
mancar	mɐ̃kaʁ
mancha	mɐ̃ʃa
manche	mɐ̃ʃi
manchester	mɐ̃ʃesteʁ
manchester	mɐ̃ʃɛsteʁ
manchete	mãʃɛtʃi
manchúria	mɐ̃ʃuɾiɐ
manchúria	mɐ̃ʃuɾjɐ
mancomunado	mãkomunadu
mandado	mɐ̃dadu
mandar	mɐ̃daɹ
mandar	mɐ̃daɻ
mandar	mɐ̃daʁ
mandar	mɐ̃daχ
mandarim	mɐ̃daɾĩ
mandato	mɐ̃datu
mandatório	mɐ̃datɔɾiu
mandinga	mãdʒĩɡa
mandingar	mãdʒĩɡaɾ
mandingar	mãdʒĩɡaχ
mandingueiro	mãdʒĩɡejɾu
mando	mɐ̃du
mandorla	mɐ̃dɔɾlɐ
mandíbula	mɐ̃d͡ʒibulɐ
maneira	mɐnejɾɐ
maneira	mɐnɛɾɐ
maneirar	mɐnejɾaɾ
maneirismo	mɐnejɾizmu
maneirismo	mɐnejɾiʒmu
maneiro	mɐnejɾu
maneiro	mɐnɛɾu
manga	mɐ̃ɡɐ
manganela	mɐ̃ɡanɛlɐ
mangra	mɐ̃ɡɾɐ
mangual	mɐ̃ɡwaw
mangue	mɐ̃ɡi
manhoso	mɐɲozu
manhã	mɐɲɐ̃
manicômio	mɐnikomiu
manifestante	mɐnifestɐ̃t͡ʃi
manilha	mɐniʎɐ
manipulação	mɐnipulasɐ̃w̃
manipulável	manipulavew
manjar	mɐ̃ʒax
manjar	mɐ̃ʒaʁ
manjerico	mɐ̃ʒeɾiku
manjericão	mɐ̃ʒeɾikɐ̃w̃
mano	mɐnu
manobra	manɔbɾa
manobra	mɐnɔbɾa
manobra	mɐnɔbɾɐ
mansidão	mɐ̃sidɐ̃w̃
manso	mɐ̃su
mansão	mɐ̃sɐ̃w̃
manter	mɐ̃teʁ
mantém	mɐ̃tẽj̃
mantêm	mɐ̃tẽj̃
manumissão	mɐnumisɐ̃w̃
manuscrito	mɐnuskɾitu
manusear	mɐnuzeaʁ
maori	maoɾi
maoísmo	maoizmu
maoísmo	mawizmu
mapa	mapɐ
maputo	mɐputu
maquete	makɛtʃi
maquiavélico	makiavɛliku
maquiavélico	makjavɛliku
maquilhagem	makiʎaʒẽj̃
maquinaria	makinaɾiɐ
mar	mah
mar	maɹ
mar	maɻ
mar	maɾ
mar	maʁ
mar	maχ
mara	maɾɐ
maraca	maɾakɐ
maracanaço	maɾakɐnasu
maracanaço	mɐɾakɐnasu
maracanã	maɾakɐnɐ̃
maracanã	mɐɾakɐnɐ̃
maracujá	maɾakuʒa
marambaia	maɾɐ̃bajɐ
maratona	maɾatonɐ
maravilha	maɾaviʎa
maravilha	maɾɐviʎɐ
maravilhoso	maɾaviʎozu
marca	maʁkɐ
marcar	maʁkaʁ
marcelo	maʁsɛlu
marcha	maʁʃɐ
marchar	maɾʃaʁ
marco	maʁku
marcos	maʁkus
marga	maʁɡɐ
margarida	mahɡaɾidɐ
margarida	maɻɡaɾida
margarida	maɾɡaɾidɐ
margarida	maʁɡaɾidɐ
margarida	maχɡaɾidɐ
margarina	maʁɡaɾina
margarina	maʁɡaɾinɐ
marginal	maɾʒinaw
maria	maɾiɐ
marido	maɾido
marido	maɾidu
marina	maɾinɐ
marinheiro	maɾiɲejɾu
marinho	maɾiɲu
marionete	maɾionɛt͡ʃi
marionete	maɾjonɛt͡ʃi
marketing	maɹketʃĩ
marketing	maʁketʃĩ
marmita	maʁmitɐ
maromba	maɾõba
marquês	maɾkeis
marquês	maɾkeiʃ
marra	maʁa
marrano	maʁɐnu
marreca	mɐʁɛku
marreco	mɐʁɛku
marrento	maʁẽtu
marreta	maʁetɐ
marreta	maʁɛtɐ
marretada	maʁetadɐ
marretar	maʁetaʁ
marretinha	maʁet͡ʃiɲɐ
marretão	maʁetɐ̃w̃
marrom	maʁõ
marta	maʁtɐ
marte	maɾtʃi
martelo	maʁtɛlu
martim	maʁt͡ʃĩ
martinho	maʁt͡ʃiɲu
marujo	maɾuʒu
marxista	maɾksista
março	maɹsu
março	maɾsu
março	maʁsu
março	maχsu
maré	maɾɛ
mas	majs
mas	mɐs
masculino	maskulinu
massa	masa
massa	masɐ
massachusetts	masaʃusets
massificar	masifikaʁ
massificação	masifikasɐ̃w̃
mastro	mastɾu
mastro	maʃtɾu
masturbação	mastuʁbasɐ̃w̃
mata	matɐ
matador	matadoʁ
matamatá	matamata
matar	mataʁ
matear	mateaʁ
matear	mat͡ʃjaʁ
matei	matej
material	mateɾiaw
material	mateɾjaw
mateus	matews
matias	mat͡ʃiɐs
matilda	mat͡ʃiwdɐ
matilde	mat͡ʃiwd͡ʒi
matinê	mat͡ʃine
matiz	mat͡ʃis
mato	matu
matriz	matɾis
matéria	matɛɾjɐ
mau	maw
mauritânia	mawɾitɐniɐ
mavioso	maviozu
maxila	maksila
mazela	mazɛlɐ
maça	masɐ
maço	masu
maçã	masɐ̃
mc	mɛki
me	mi
meação	miasɐ̃w̃
mec	mɛki
meca	mɛkɐ
medalha	medaʎa
medalha	medaʎɐ
medicina	medsina
medicina	med͡ʒisina
medicina	med͡ʒisinɐ
medida	midʒidɐ
medir	med͡ʒiʁ
medir	mid͡ʒiʁ
mediterrâneo	med͡ʒiteʁɐnju
medo	medu
medonho	medoɲu
medrica	medɾika
medricas	medɾikas
medrincas	medɾĩkas
medronho	medɾoɲu
medroso	medɾozu
medíocre	med͡ʒiokɾi
medíocre	med͡ʒiwkɾi
mega	mɛɡa
megabit	mɛɡabiti
megabit	mɛɡabit͡ʃi
megabyte	mɛɡabajtʃi
meia	mejjɐ
meigo	mejɡu
meio	meju
mel	mɛw
melancia	melɐ̃siɐ
melecar	melekaɾ
melecar	melekaχ
melhor	meʎɔɹ
melhor	meʎɔɻ
melhor	meʎɔɾ
melhor	meʎɔʁ
melhor	miʎɔ
melhor	mɛʎɔh
melhorar	meʎoɾaʁ
melhores	meʎɔɾis
melhores	meʎɔɾiʃ
melhorzinho	meʎɔʁziɲu
meliante	meliãtʃi
melindre	melĩdɾi
melindroso	melĩdɾozu
melissa	melisɐ
melodia	melod͡ʒia
melodia	melod͡ʒiɐ
melro	mɛwʁu
membrana	mẽbɾɐnɐ
membro	mẽbɾo
membro	mẽbɾu
meme	memi
memória	memɔɾjɐ
mencionar	mẽsjonaʁ
mendaz	mendajs
mendaz	mendajʃ
mendigo	mĩd͡ʒiɡu
mendigo	mĩd͡ʒĩɡu
mendigo	mẽd͡ʒiɡu
mene	meni
mengão	mẽɡɐ̃w̃
menina	meninɐ
menina	mininɐ
menino	meninu
menor	menɔʁ
menores	menɔɾis
menores	menɔɾiʃ
menos	menos
menos	menus
mensagem	mẽsaʒẽj̃
mensalidade	mẽsalidadʒi
mensuração	mẽsuɾasɐ̃w̃
menta	mẽtɐ
mental	mẽtaw
mentalidade	mẽtalidad͡ʒi
mente	mẽte
mente	mẽt͡ʃi
mentecapto	mẽtekaptu
mentir	mẽt͡ʃiʁ
mentira	mĩtiɾɐ
mentira	mĩt͡ʃiɾɐ
mentira	mẽt͡ʃiɾɐ
mentiroso	mẽt͡ʃiɾozu
mera	mɛɾa
mercado	meʁkadu
mercadologicamente	meʁkadolɔʒikɐmẽt͡ʃi
mercadológico	meʁkadolɔʒiku
merchan	meɾʃã
merchan	meʁʃã
merda	mɛʁdɐ
merecer	meɾeseʁ
meristema	meɾistemɐ
merlin	meʁlĩ
merlin	mɛʁlĩ
merluza	meʁluzɐ
merreca	meʁɛka
mesa	mezɐ
mesmo	mehmu
mesmo	memu
mesmo	mezmo
mesmo	mezmu
mesmo	meʒmu
mesona	mezonɐ
mesopotâmia	mezopotɐmiɐ
mesosfera	mezojʃfɛɾa
mesosfera	mezosfɛɾa
messina	mesinɐ
mestra	mɛstɾɐ
mestre	mɛstɾi
mestre	mɛʃtɾi
mesóclise	mezɔklizi
meta	metɐ
meta	mɛtɐ
metacarpal	mɛtakaɻpaw
metade	metade
metade	metad͡ʒi
metafisicamente	mɛtafizikɐmẽt͡ʃi
metal	metaw
metaleiro	metalejɾu
mete	mɛtʃi
metido	metʃidu
metodicamente	metɔd͡ʒikɐmẽt͡ʃi
metodista	metodʒistɐ
metodologia	mɛtodoloʒia
metodologia	mɛtodoloʒiɐ
metralhadora	metɾaʎadoɾa
metrô	metɾo
metálica	metalikɐ
meu	mew
meus	mews
mexer	meʃeʁ
mezinha	mɛziɲɐ
meã	meɐ̃
meço	mɛsu
mi	mi
miami	majɐmi
miasma	miazmɐ
miasma	mjazmɐ
micaías	mikaiɐs
micho	miʃu
mico	miku
micáceo	mikasiu
migalha	miɡaʎa
migalha	miɡaʎɐ
migrante	miɡɾɐ̃t͡ʃi
migrar	miɡɾaʁ
migratório	miɡɾatɔɾiu
migração	miɡɾasɐ̃w̃
miguel	miɡɛw
migué	miɡɛ
mil	miw
milagre	milaɡɾi
milha	miʎa
milha	miʎɐ
milhares	miʎaɾis
milho	miʎu
milhão	miʎɐ̃w̃
milhões	miʎõj̃s
miliciano	milisiɐnu
miliciano	milisjɐnu
militar	militaʁ
milkshake	miwkiʃejki
milkshake	miwkʃejk
milão	milɐ̃w̃
mim	mĩ
mimimi	mimimi
mimosa	mimɔzɐ
mina	minɐ
minar	minaʁ
mineiro	minejɾu
minerva	minɛʁvɐ
mingau	mĩɡaw
minha	miɲɐ
minhas	miɲɐs
minho	miɲu
minhoca	mĩj̃ɔkɐ
ministro	ministɾo
ministro	ministɾu
ministro	miniʃtɾu
ministério	ministɛɾju
minnesota	minesotɐ
minsk	mĩsk
minuto	minutu
minúcia	minusja
minúsculo	minuskulu
miolo	miolu
miolo	mjolu
miopia	miopia
miopia	miopiɐ
miosótis	miosɔt͡ʃis
miraculoso	miɾɐkulozu
miragem	miɾaʒẽj̃
miranda	miɾɐ̃dɐ
mirandês	miɾɐ̃dejs
mirandês	miɾɐ̃dejʃ
miriam	miɾiɐ̃
miriam	miɾjɐ̃
mirra	miʁɐ
mirrar	miʁaʁ
miráculo	miɾakulu
miríade	miɾiad͡ʒi
miscigenação	misiʒenasɐ̃w̃
miserrimamente	mizɛʁimɐmẽt͡ʃi
missa	misa
missa	misɐ
missionária	misjonaɾjɐ
missouri	mizuɾi
missão	misɐ̃w̃
mister	mistɛɾ
mistura	mijʃtuɾɐ
mistura	mistuɾɐ
misturar	mistuɾaʁ
misturo	mistuɾu
misturo	miʃtuɾu
misérrimo	mizɛʁimu
mito	mitu
mitocôndria	mitokõdɾia
mitocôndria	mitokõdɾiɐ
mitocôndria	mitokõdɾja
mitocôndria	mitokõdɾjɐ
mixe	miʃi
mixuruca	miʃuɾuka
miúdo	miudu
mnemosine	mnemozini
mobelha	mobeʎɐ
mobilidade	mobilidad͡ʒi
mobilizador	mobilizadoɾ
mocho	moʃu
mocidade	mosidad͡ʒi
moda	mɔda
moda	mɔdɐ
modalidade	modalidad͡ʒi
modelo	modelu
modem	modẽj̃
moderar	modeɾaʁ
moderno	modɛɻno
moderno	modɛʁnu
modo	mɔdu
moeda	moɛdɐ
moeda	muɛdɐ
moeda	mwɛdɐ
moela	moɛlɐ
moer	moeʁ
mofo	mofu
mogadishu	moɡad͡ʒiʃu
moinha	moiɲa
moinho	muiɲu
moirama	mojɾɐmɐ
moisés	mojzɛjs
moita	mojta
moita	mojtɐ
mol	mɔw
mola	mɔlɐ
molde	mɔwdʒi
moldura	mowduɾɐ
moldávia	mɔwdavja
mole	mɔli
moleque	mulɛki
molequinho	mulɛkiɲu
moletom	moletõ
moleza	molezɐ
molhada	moʎada
molhada	moʎadɐ
molhadela	moʎadɛla
molhadela	moʎadɛlɐ
molhadura	moʎaduɾa
molhadura	moʎaduɾɐ
molhagem	moʎaʒẽj̃
molhamento	moʎamẽtu
molho	moʎo
molho	moʎu
molho	mɔʎo
molho	mɔʎu
molhável	moʎavew
molosso	molosu
momento	momẽtu
momice	momisi
mona	mona
monarquia	monaʁkiɐ
mongol	mõɡɔw
mongoloide	mõɡolɔjd͡ʒi
mongólia	mõɡɔljɐ
monitorar	monitoɾaʁ
monja	mõʒa
monja	mõʒɐ
monogamia	monoɡɐ̃mia
monogâmico	monoɡɐ̃miku
monotonia	monotonia
monstruoso	mõstɾuozu
montanha	mõtɐ̃j̃ɐ
montante	mõtɐ̃t͡ʃi
montar	mõtaʁ
monte	mõte
monte	mõt͡ʃi
montenegro	mõteneɡɾu
montenegro	mõt͡ʃineɡɾu
monturo	mõtuɾu
monumento	monumẽtu
monádico	monad͡ʒiku
monárquico	monaʁkiku
monção	mõsɐ̃w̃
moqueca	mukɛka
moqueca	mukɛkɐ
mora	mɔɾa
mora	mɔɾɐ
morada	moɾada
morada	moɾadɐ
moraes	moɾajs
morais	moɾajs
moral	moɾaw
moranga	muɾɐ̃ɡɐ
morango	moɾɐ̃ɡu
morar	moɾaʁ
moratória	moɾatɔɾia
moratória	moɾatɔɾiɐ
moratória	moɾatɔɾja
moratória	moɾatɔɾjɐ
morder	moɾdeɾ
morder	moʁdeʁ
mordóvia	moʁdɔviɐ
more	mɔɾe
more	mɔɾi
moreno	moɾenu
mormente	mɔʁmẽt͡ʃi
morre	mɔʁi
morrendo	moʁẽdu
morrer	moʁeʁ
morrinhenta	moʁiɲẽta
morrinhento	moʁiɲẽtu
morro	moʁu
morte	mɔhti
morte	mɔht͡ʃ
morte	mɔht͡ʃi
morte	mɔɹt͡ʃi
morte	mɔɻt͡ʃi
morte	mɔɾte
morte	mɔɾti
morte	mɔɾt͡ʃi
morte	mɔʁt͡ʃi
morte	mɔχt͡ʃi
mortiça	moʁt͡ʃisɐ
morto	moʁtu
mosca	moska
mosca	moʃka
moscou	moskow
moscou	moʃkow
mosquito	muskitʊ
mosquito	muʃkitʊ
mosteiro	mostejɾo
mosteiro	mostejɾu
mostra	mɔstɾɐ
mostram	mɔstɾɐ̃w̃
mostrar	mostɾaʁ
moto	mɔtu
motor	motoʁ
motorista	motoɾistɐ
mouco	mowku
moura	mowɾa
moura	mowɾɐ
mourama	mowɾɐmɐ
mouro	mowɾu
mourão	mowɾɐ̃w
mouse	mawz
mouse	mawzi
move	mɔvi
mover	moveɹ
mover	moveɻ
mover	moveʁ
movimento	movimẽto
movimento	movimẽtu
moça	mosɐ
moçambique	mosɐ̃biki
moço	mosu
moção	mosɐ̃w̃
moésia	moɛzjɐ
muamba	muãba
muda	mudɐ
mudança	mudɐ̃sɐ
mudar	mudaɹ
mudar	mudaɻ
mudar	mudaʁ
mudo	mudu
mufti	muft͡ʃi
mui	muj
mui	mũj̃
muita	mũj̃tɐ
muito	mũj̃tu
muitos	mũj̃tus
mula	mula
mula	mulɐ
mulato	mulatu
mulher	muʎɛʁ
mulherengo	muʎɛɾẽɡu
mulherão	muʎɛɾɐ̃w̃
multa	muwtɐ
multar	muwtaʁ
multidão	muwt͡ʃidɐ̃w̃
multilíngue	muwt͡ʃilĩɡwi
multiúso	muwtʃiuzu
mundial	mũd͡ʒiaw
mundo	mũdo
mundo	mũdu
munir	muniɾ
muralha	muɾaʎɐ
murcho	muʁʃu
muro	muɾu
musa	muza
musa	muzɐ
museu	muzew
musgo	muzɡu
musical	muzikaw
musicista	muzisiʃtɐ
mussumê	musume
mustafá	mustafa
mutar	mutaɾ
mutação	mutasɐ̃w̃
mutuamente	mutuɐmẽt͡ʃi
muçununga	musunũɡɐ
muçuã	musuɐ̃
má	ma
mácula	makulɐ
máfia	mafjɐ
mágoa	maɡwɐ
málaga	malaɡɐ
máquina	makina
máquina	makinɐ
mártir	maʁt͡ʃiʁ
máscara	maskɐɾɐ
máscara	maʃkaɾɐ
máximo	masimu
mântua	mɐ̃tuɐ
mãe	mɐ̃j̃
mães	mɐ̃j̃s
mão	mɐ̃w̃
mãos	mɐ̃w̃s
média	mɛd͡ʒia
média	mɛd͡ʒiɐ
média	mɛd͡ʒja
média	mɛd͡ʒjɐ
médici	mɛd͡ʒisi
médico	mɛd͡ʒiku
médio	mɛdʒiw
médio	mɛd͡ʒiu
médio	mɛd͡ʒju
médium	mɛd͡ʒiũ
médium	mɛd͡ʒjũ
mésia	mɛziɐ
método	mɛtodu
méxico	mɛʃiku
mês	mejs
mínimo	minimu
míssil	misiw
míster	misteɹ
mó	mɔ
mô	mo
música	muzikɐ
músico	muziku
na	na
nababesco	nababejʃku
nababesco	nababesku
nababo	nababu
nabo	nabu
nabucodonosor	nabukodonozoʁ
nachos	nat͡ʃus
nachos	nat͡ʃuʃ
nacional	nasjonaw
nada	nadɐ
nadar	nadaʁ
nadir	nad͡ʒiʁ
nado	nadu
nagasaki	naɡazaki
naipe	najpi
nairobi	najɾɔbi
naja	naʒa
namespace	nejmspejs
namespace	nejmspejsi
namoro	namoɾu
namoro	namɔɾu
nanquim	nɐ̃kĩ
napolitano	napulitɐnu
naquela	nakɛlɐ
naquelas	nakɛlɐs
naquele	nakele
naquele	nakeli
naqueles	nakeles
naqueles	nakelis
naquilo	nakilo
naquilo	nakilu
narciso	naʁsizu
narguilé	narɡilɛ
narina	naɾina
narina	naɾinɐ
nariz	naɾis
narrativa	naʁat͡ʃiva
narrativa	naʁat͡ʃivɐ
narval	naɾval
nas	nas
nascente	nasẽt͡ʃi
nascença	nasẽsɐ
nascer	najsex
nascer	naseh
nascer	naseɹ
nascer	naseɻ
nascer	naseʁ
nascimento	nasimẽtu
nascituro	nasituɾu
nassau	nasaw
nasça	nasɐ
nasço	nasu
nata	natɐ
natal	nataw
natalino	natalinu
natasha	nataʃɐ
nativo	nat͡ʃivu
nato	natu
natural	natuɾaw
naturalidade	natuɾalidad͡ʒi
natureza	natuɾezɐ
natália	nataljɐ
natã	natɐ̃
naufrágio	nɐufraʒju
nauseabunda	nawzjabũdɐ
navajo	navaʒu
navalha	navaʎa
navio	naviju
navio	naviw
naxos	naksus
nazca	naskɐ
nazi	nazi
nazismo	nazizmu
nação	nasɐ̃w̃
neandertal	neɐ̃deʁtaw
neandertal	njɐ̃deʁtaw
neblina	neblina
neblina	neblinɐ
necessidade	nesesidad͡ʒi
necessitar	nesesitaʁ
necessário	nesesaɾju
neerlândia	neeʁlɐ̃d͡ʒjɐ
nefelibata	nefelibatɐ
nega	neɡɐ
nega	nɛɡɐ
negar	neɡaʁ
negativo	neɡatʃivu
negação	neɡasɐ̃w̃
negligenciável	neɡliʒẽsiavew
negligenciável	neɡliʒẽsjavew
nego	neɡu
nego	nɛɡu
negociar	neɡosiaʁ
negro	neɡɾu
negus	nɛɡus
negão	neɡɐ̃w̃
negócio	neɡɔsjo
negócio	neɡɔsju
nela	nɛlɐ
nelas	nɛlɐs
nele	nele
nele	neli
neles	neles
neles	nelis
nelson	nɛwsõ
nem	nẽj̃
nenenzinho	nenẽj̃ziɲu
nenhum	neɲũ
nenhuma	neɲumɐ
nenhuma	neɲũɐ
neném	nenẽj̃
neozelandês	nɛwzelɐ̃dejs
nepal	nepaw
nepotismo	nepot͡ʃizmu
nerd	nɛʁd͡ʒ
nerd	nɛʁd͡ʒi
neri	neɾi
nero	nɛɾu
nervosa	neʁvɔzɐ
nervoso	neʁvozu
nervosos	neʁvɔzus
nessa	nɛsɐ
nessas	nɛsɐs
nesse	nesi
nesses	nesis
nesta	nɛstɐ
nestas	nɛstɐs
neste	nest͡ʃi
nestes	nest͡ʃis
net	nɛtʃi
netuno	netunu
neurocirurgia	newɾosiɾuʁʒiɐ
neurológica	newɾolɔʒikɐ
neurológico	newɾolɔʒiku
neurónio	newɾoniu
neurónio	newɾonju
nevada	nevada
neve	nɛvi
nevrálgico	nevɾawʒiku
newcastle	niwkɛsow
nhaca	ɲaka
nhanhanhã	ɲɐɲɐɲɐ̃
nheengatu	j̃ẽɡatu
nheengatu	ɲẽɡatu
nicarágua	nikaɾaɡwɐ
nicho	niʃu
night	najt͡ʃ
nigérrimo	niʒɛʁimu
nilo	nilu
nim	nĩ
nimbo	nĩbu
nina	ninɐ
ninfa	nĩfɐ
ninguém	nĩɡẽj̃
ninho	niɲu
ninjete	nĩʒɛtʃi
nipófilo	nipɔfilu
nisso	nisu
nisto	nisto
nisto	nistu
nix	niks
no	nu
nobre	nɔbɾi
nobélio	nobɛliu
nocautear	nokawt͡ʃiaʁ
noemi	noemi
noia	nɔjɐ
noite	nojte
noite	nojtɪ
noite	nojt͡ʃi
noiva	nojva
noiva	nojvɐ
noivinha	nojviɲɐ
noivo	nojvu
nojeira	noʒejɾa
nome	nome
nome	nomi
nomear	nomeaʁ
nomear	nomiaʁ
nominal	nominaw
nominativo	nominat͡ʃivu
nona	nona
nona	nonɐ
nono	nonu
nop	nɔp
nora	nɔɾɐ
nordeste	noɹdɛst͡ʃi
nordeste	noɻdɛste
nordeste	noɾdɛst͡ʃi
nordeste	noʁdɛʃt͡ʃi
nordeste	nɔxdɛʃti
nordeste	nɔɦdɛʃtɪ
norma	nɔʁmɐ
normal	noʁmaw
normalmente	noʁmawmẽt͡ʃi
norte	nɔhti
norte	nɔʁt͡ʃi
nortúmbria	noʁtũbɾiɐ
noruega	noɾuɛɡɐ
norueguês	noɾueɡejs
norueguês	noɾueɡejʃ
nos	nus
nosocômio	nɔzɔkomiu
nossa	nɔsɐ
nossas	nɔsɐs
nosso	nɔsu
nossos	nɔsus
nota	nɔtɐ
notar	notaʁ
notação	notasɐ̃w̃
note	nowt͡ʃ
note	nɔt͡ʃ
note	nɔt͡ʃi
notebook	nowt͡ʃibuki
notebook	nɔt͡ʃibuki
noticiário	not͡ʃisiaɾju
noturno	notuʁnu
notícia	not͡ʃisjɐ
noutro	nowtɾu
novaes	novajs
novais	novajs
novamente	nɔvamẽt͡ʃi
novato	novatu
nove	nɔvi
novecentos	nɔvisẽtus
novela	novɛla
novela	novɛlɐ
noveleiro	novelejɾu
novembro	novẽbɾu
novembro	nɔvẽbɾu
noventa	novẽtɐ
noventa	nɔvẽtɐ
novidade	novidadʒi
novinho	noviɲu
noviço	novisu
novo	novo
novo	novu
noção	nosɐ̃w̃
noé	noɛ
nu	nu
nua	nua
nuca	nuka
nuca	nukɐ
nuclear	nukleaʁ
nulidade	nulidadʒi
num	nũ
numa	numɐ
numas	numɐs
numera	numɛɾa
numero	numɛɾu
numeroso	numeɾozu
nunca	nũkɐ
nuns	nũs
nupcial	nupisjaw
nupcial	nupsiaw
nupcial	nupsjaw
nutella	nutɛlɐ
nuvem	nuvẽj̃
nylon	najlõ
nádia	nad͡ʒjɐ
nágua	naɡwa
náiade	najad͡ʒi
nápoles	napolis
náufrago	nawfɾaɡu
não	nũ
não	nɐ̃w̃
nè	nɛ
né	nɛ
néscio	nɛsju
névoa	nɛvwɐ
níquel	nikew
nível	nivew
nóbrega	nɔbɾeɡa
nós	nɔjs
nós	nɔs
núbil	nubiw
número	numeɾu
obediência	obed͡ʒjẽsiɐ
objete	obʒɛtʃi
objetividade	obiʒet͡ʃividad͡ʒi
objetividade	obʒet͡ʃividad͡ʒi
objetivo	obʒetʃivu
objeto	obiʒɛto
objeto	obiʒɛtu
objeto	obʒɛto
objeto	obʒɛtu
objeção	obiʒesɐ̃w̃
obnubilado	obnubiladu
oboé	oboɛ
obra	ɔbɾɐ
obrigada	obɾiɡadɐ
obrigado	obɾiɡado
obrigado	obɾiɡadu
obrigatoriedade	obɾiɡatoɾiedad͡ʒi
obsceno	ɔpsenu
obscuro	obskuɾu
obsequiar	obzekiaɾ
obsequiar	obzekiaχ
observar	obiseχvaχ
observar	obseɹvaɹ
observar	obseɻvaɻ
observar	obseʁvaʁ
observar	ɔbsɛɦvah
obsessão	obisesɐ̃w̃
obsessão	obsesɐ̃w̃
obstante	ɔpstɐ̃t͡ʃi
obstinada	obst͡ʃinadɐ
obséquio	obzɛkju
obter	obiteʁ
obter	obteʁ
obtuso	obtuzu
oca	okɐ
oca	ɔkɐ
ocarina	okɐɾinɐ
ocasião	okaziɐ̃w̃
occipital	oksipitaw
occitano	oksitɐnu
oceano	osiɐnu
oceânico	oseɐniku
oceânico	osiɐniku
ocidental	osidẽtaw
ocidente	osidẽt͡ʃi
ocioso	osiozu
ocioso	osjozu
oclusão	okluzɐ̃w̃
ocorrer	okoheɻ
ocorrer	okoʁeʁ
ocupado	okupadu
ocupação	okupasɐ̃w̃
odeiam	odejɐ̃
odeiam	odejɐ̃w̃
odiar	odʒiaʁ
odin	od͡ʒĩ
odisseu	od͡ʒisew
odor	odoɾ
odor	odoʁ
odre	odɾi
oeste	oɛst͡ʃi
oeste	ɔɛʃti
ofensa	ofẽsa
ofensa	ofẽsɐ
ofensiva	ofẽsivɐ
ofensivas	ofẽsivɐs
oferecer	ofeɾeseʁ
oferta	ofɛʁtɐ
oficial	ofisiaw
oficina	ofisinɐ
oftalmo	oftawmu
oftalmologista	oftawmoloʒistɐ
oftalmologistas	oftawmoloʒistɐs
ofuscante	ofuskɐ̃t͡ʃi
ofídio	ofid͡ʒio
ofídio	ofid͡ʒjo
ofídio	ofid͡ʒo
ogro	oɡɾu
oi	oj
oitavo	ojtavu
oitenta	ojtẽtɐ
oito	ojtu
oitocentos	ojtusẽtus
ok	okej
ok	ukej
ok	ɔkej
ola	ola
ola	olɐ
olfato	owfatu
olga	ɔwɡɐ
olha	oʎɐ
olha	ɔʎɐ
olhada	oʎadɐ
olhar	oʎaʁ
olho	oʎu
olho	ɔʎu
olhos	ɔʎus
oliveira	olivejɾɐ
olivina	olivinɐ
olivério	olivɛɾju
olmo	owmu
olá	ola
olá	ɔla
olívia	olivjɐ
omaha	omahɐ
omar	oma
omar	omaɾ
omar	omaʁ
ombro	õbɾu
omoplata	omoplata
onda	õda
onda	õdɐ
onde	õde
onde	õdi
onde	õd͡ʒ
onde	õd͡ʒi
onera	onɛɾa
ong	õɡ
ong	õɡi
onisciência	onisiẽsiɐ
online	õlajni
onomástico	onomast͡ʃiku
ontem	õtẽj̃
onu	onu
onze	õzi
onça	õsɐ
opala	opala
opala	opalɐ
opera	opɛɾa
operar	opeɾaʁ
operação	opeɾasɐ̃w̃
operário	opeɾaɾjo
operário	opeɾaɾjʊ
operário	ɔpɛɾaɾju
opinião	opiniɐ̃w̃
oportunidade	opoʁtunidad͡ʒi
oposição	opozisɐ̃w̃
opressor	opɾesoʁ
opressores	opɾesoɾis
opressão	opɾesɐ̃w̃
opróbrio	opɾɔbɾju
opulento	opulẽtu
opulência	opulẽsja
opção	opisɐ̃w̃
opção	opsɐ̃w̃
ora	ɔɾɐ
orar	oɾaʁ
oração	oɾasɐ̃w̃
orca	ɔʁkɐ
ordem	ɔɦdẽj̃
ordem	ɔɹdẽj̃
ordem	ɔɻdẽj̃
ordem	ɔʁdẽj̃
ordenar	oɹdenaɹ
ordenar	oɻdenaɻ
ordenar	oʁdenaʁ
ordenar	ɔɦdẽnah
ordenhar	oɾdẽɲaɾ
ordinário	oʁdʒinaɾju
orelha	oɾeʎɐ
orelhão	oɾeʎɐ̃w̃
organizar	oʁɡɐnizaʁ
organizaremos	oɾɡanizaɾemus
organização	oʁɡɐnizasɐ̃w̃
orgia	oɾʒia
orgia	oʁʒia
orgulho	oɾɡuʎu
orientação	oɾiẽntasɐ̃w̃
oriente	oɾiẽt͡ʃi
original	oɾiʒinaw
originário	oɾiʒinaɾju
origâmi	oɾiɡɐmi
oriundo	oɾiũdu
oriundo	oɾjũdu
orkuteiro	oʁkutejɾu
orlando	oʁlɐ̃du
ornitorrinco	oʁnitoʁĩku
orquídea	ɔʁkidiɐ
orvalho	oɾvaʎu
oráculo	oɾakulu
orçamento	oʁsamẽtu
orégano	oɾɛɡɐnu
os	os
os	us
osaka	osakɐ
osaka	ozakɐ
osasquense	ozaskẽsi
oscular	oskulaɾ
oslo	ɔzlu
osso	osu
ossículo	osikulo
ostra	ostɾɐ
ostracize	ostɾasizi
osíris	oziɾis
otaku	otaku
otan	otɐ̃
otava	otavɐ
otimista	ot͡ʃimista
otimista	ot͡ʃimistɐ
otimista	ot͡ʃimiʃtɐ
oto	ɔtu
otorrino	otoʁinu
otorrinolaringologista	otoʁĩnolaɾĩɡoloʒistɐ
otorrinolaringologista	otoʁĩnolaɾĩɡoloʒiʃtɐ
ottawa	otawɐ
otário	otaɾju
otávio	otavju
ou	ow
ourela	owɾɛla
ourives	owɾivis
ouriço	owɾisu
ouro	owɾu
ouros	owɾus
ouros	owɾuʃ
ousar	owzaʁ
outdoor	awt͡ʃdɔɹ
outono	owtonu
outra	owtɾɐ
outras	owtɾɐs
outrem	owtɾẽj̃
outro	owtɾu
outros	owtɾus
outubro	owtubɾu
ouvi	owvi
ouvido	owvidu
ouvidoria	owvidoɾiɐ
ouvir	owviʁ
ouviu	owviw
ova	ɔvɐ
ovacionar	ovasjonaɹ
ovar	ovaɹ
ovação	ovasɐ̃w̃
ovelha	oveʎɐ
ovnilogia	ɔviniloʒia
ovnilogia	ɔvniloʒia
ovo	ovu
ovárico	ovaɾiku
ovário	ovaɾju
oxe	oʃ
oxe	oʃe
oxe	oʃi
oxford	ɔksfɔʁd͡ʒ
oxigénio	ɔksiʒenju
oásis	oazis
pabulagem	pabulaʒẽj̃
pacas	pakɐs
pacheco	paʃeku
paciente	pasiẽtʃi
paciente	pasjẽt͡ʃi
pacientes	pasjẽt͡ʃis
pacote	pakɔtʃi
pacotilha	pakot͡ʃiʎɐ
pacu	paku
pacóvio	pakɔvju
padaria	padaɾia
padaria	padɐɾiɐ
padecer	padeseʁ
padecestes	padesest͡ʃis
padeiro	padejɾo
padeiro	padejɾu
padilha	pad͡ʒiʎɐ
padoca	padɔka
padre	padɾe
padre	padɾi
padrinho	padɾiɲu
padrão	padɾɐ̃w̃
pagamento	paɡamẽtu
pagando	paɡɐ̃du
pagar	paɡaʁ
pago	paɡu
pagode	paɡɔd͡ʒi
pagão	paɡɐ̃w̃
pai	paj
pais	pajs
paisagem	pajzaʒẽj̃
paitrocínio	pajtɾosinju
paixão	pajʃɐ̃w̃
pajubá	paʒuba
pajé	paʒɛ
paladino	palad͡ʒinu
palanca	palɐ̃kɐ
palanquim	palɐ̃kĩ
palato	palatu
palavra	palavɾɐ
palco	pawko
palco	pawku
palermo	palɛʁmu
palestina	palest͡ʃina
palestina	palest͡ʃinɐ
palestina	paleʃt͡ʃinɐ
palestra	palɛstɾɐ
paletó	palitɔ
palha	paʎa
palha	paʎɐ
palhaço	paʎasu
paliativo	paliat͡ʃivu
paliativo	paljat͡ʃivu
palito	palitu
palmeira	pawmejɾa
palmeira	pawmejɾɐ
palmira	pawmiɾɐ
palmiteiro	pawmitejɾu
palmou	pawmow
palácio	palasiu
palácio	palasju
paládio	palad͡ʒiu
paládio	palad͡ʒju
palíndromo	pɐlĩdrumu
pamonha	pamoɲa
pancada	pɐ̃kada
panda	pãdɐ
pandeiro	pɐ̃dejɾu
pandeísta	pɐ̃deistɐ
panela	pɐnɛlɐ
panetone	pɐnetoni
panfleto	pɐ̃fletu
pano	pɐnu
panqueca	pɐ̃kɛkɐ
pantera	pɐ̃tɛɾa
panteísta	pɐ̃teistɐ
pantomima	pɐ̃tumimɐ
panturrilha	pɐ̃tuʁiʎɐ
pança	pɐ̃sa
pança	pɐ̃sɐ
panónia	panoniɐ
papa	papɐ
papagaio	papaɡaju
papai	papaj
paparazzo	papaɾatsu
paparicho	papaɾiʃu
paparrotão	papaʁotɐ̃w̃
papel	papɛw
papelão	papilɐ̃w̃
papila	papilɐ
papo	papu
papoula	papowla
papoula	papowlɐ
papão	pɐpɐ̃w̃
paquera	pakɛɾa
paquerar	pakeɾaɾ
paquerar	pakeɾaʁ
paquistão	pakistɐ̃w̃
par	paʁ
para	paɾɐ
parabéns	paɾabẽj̃s
parabéns	paɾabẽj̃ʃ
paracelso	paɾasɛwsu
paracetamol	paɾasetamɔw
paradigma	paɾad͡ʒiɡima
paradigma	paɾad͡ʒiɡimɐ
paradigma	paɾad͡ʒiɡma
paradigma	paɾad͡ʒiɡmɐ
parado	paɾadu
parafusado	paɾafuzadu
parafuso	paɾafuzu
parapeito	paɾapejtu
paraquedas	paɾakɛdɐs
parar	paɾaʁ
paraíba	paɾaibɐ
paraíso	paɾaizu
parceiro	paʁsejɾu
parcelar	paʁselaʁ
parcial	paʁsiaw
parcialmente	paʁsiawmẽt͡ʃi
pardal	paɾdaw
pardo	paʁdu
pare	paɾi
parece	paɾɛsi
parecer	paɾeseʁ
parecido	paɾesidu
parede	paɾedɪ
parede	paɾed͡ʒi
paredão	paɾedɐ̃w̃
parente	paɾẽte
parente	paɾẽti
parente	paɾẽt͡ʃi
parentela	paɾẽtɛlɐ
parestesia	paɾestezia
parestesia	paɾeʃtezia
pareço	paɾesu
parideira	paɾidejɾɐ
parietal	paɾietaw
parietal	paɾjetaw
parir	paɾiʁ
paris	paɾis
paritária	paɾitaɾiɐ
parkour	paʁkuʁ
parlamento	paʁlamẽtu
parlapatice	paɾlapatʃisi
parlapatão	paɾlapatɐ̃w̃
parque	paʁki
parra	paʁa
parrudo	paʁudu
parte	pahti
parte	paʁt͡ʃi
participar	paʁt͡ʃisipaʁ
particular	paʁt͡ʃikulaʁ
particularmente	paʁtikulaʁmẽt͡ʃi
particípio	paʁt͡ʃisipiu
partida	paɹt͡ʃida
partida	paɹt͡ʃidɐ
partida	paɻt͡ʃida
partida	paʁtʃidɐ
partido	paɹt͡ʃidu
partido	paɻt͡ʃido
partido	paʁt͡ʃidu
partidário	paʁt͡ʃidaɾiu
partilhar	paɹt͡ʃiʎaɹ
partilhar	paɻt͡ʃiʎaɻ
partilhar	paʁt͡ʃiʎaʁ
partir	pahtih
partir	paʁt͡ʃiʁ
partirmos	paʁt͡ʃiʁmus
parténope	paʁtenopi
paróquia	paɾɔkiɐ
paróquia	paɾɔkjɐ
pascácio	pajʃkasju
pascácio	paskasju
paspalho	paspaʎu
passa	pasa
passa	pasɐ
passado	pasadu
passagem	pasaʒẽj̃
passar	pasaʁ
passaralho	pasaraʎu
passaralho	pɐsɐrɐʎu
passaram	pasaɾɐ̃w̃
passe	pasi
passeata	paseata
passeata	pasiatɐ
passeio	paseju
passo	pasu
passou	pasow
pastando	pastɐ̃du
pastel	pastɛw
pastelaria	pastelaɾia
pastelaria	paʃtelaɾia
pasto	pastu
pasto	paʃtu
pastor	pastoʁ
pasárgada	pazaʁɡadɐ
pata	pata
patada	patadɐ
patas	patɐs
patela	patɛla
patesca	pateskɐ
patinete	patʃinɛtʃi
pato	patu
patológica	patolɔʒikɐ
patológicas	patolɔʒikɐs
patológico	patolɔʒiku
patológicos	patolɔʒikus
patopolitano	patopolitɐnu
patota	patɔtɐ
patrazana	patɾazɐ̃na
patriarca	patɾiaʁkɐ
patriarcado	patɾiaʁkadu
patrimônio	patɾimõnju
patrocínio	patɾosinju
patrola	patɾɔlɐ
patrono	patɾonu
patrulha	patɾuʎɐ
patrícia	patɾisjɐ
patrício	patɾisju
patético	patɛt͡ʃiku
patópolis	patɔpolis
pau	paʊ
paula	pawlɐ
paulada	pawladɐ
paulete	pawlɛt͡ʃi
paulista	pawlistɐ
paulo	pawlu
paupérrimo	pawpɛʁimu
pausa	pawza
pausa	pawzɐ
pavê	pave
pavês	paves
paz	pajs
pazes	pazis
pazes	paziʃ
paço	pasu
país	pais
pc	pese
pebol	pɛbɔw
pec	pɛki
pedacinho	pedasiɲu
pedagogia	pedaɡoʒia
pedagogia	pedaɡoʒiɐ
pedaço	pedasu
pedem	pɛdẽj̃
pedido	ped͡ʒido
pedido	ped͡ʒidu
pedido	pid͡ʒido
pedido	pid͡ʒidu
pedir	ped͡ʒiʁ
pedonal	pedonaw
pedra	pɛdɾɐ
pedreira	pedrejɾɐ
pedreiro	pedɾejɾu
pedro	pedɾu
pega	peɡɐ
pega	pɛɡɐ
pegajosa	peɡaʒɔzɐ
pegar	peɡaʁ
pego	peɡu
pego	pɛɡu
peguete	peɡɛtʃi
peitinho	pejt͡ʃiɲu
peito	pejtu
peitudo	pɐjtudu
peixe	pejʃe
peixe	pejʃi
pela	pelɐ
pela	pɛlɐ
pelas	pelɐs
pele	pɛli
pelicano	pelikɐnu
pelo	pelo
pelo	pelu
pelo	pɛlu
pelos	pelus
pelourinho	pelowɾiɲu
pelouro	pelowɾu
pelve	pɛwvi
película	pelikulɐ
pelúcia	pelusja
penal	penaw
pendurar	pĩduɾaʁ
pendão	pẽdɐ̃w̃
penicilina	penisilina
penicilina	penisilinɐ
penico	piniku
peninsular	penĩsulaɾ
penitência	penitẽsiɐ
penosa	penɔzɐ
pensador	pẽsadoʁ
pensamento	pẽsamẽtu
pensamento	pẽsɐmẽtu
pensar	pẽsaʁ
pensativo	pẽsat͡ʃivu
pense	pẽsi
pensilvânia	pẽsiwvɐniɐ
pensoso	pẽsozu
pensão	pẽsɐ̃w̃
pente	pẽte
pente	pẽti
pente	pẽt͡ʃi
penteado	pẽt͡ʃiadu
penteado	pẽt͡ʃjadu
península	penĩsulɐ
penúltimo	penuwt͡ʃimu
pepineiro	pepinejɾu
pepino	pepinu
pepino	pipinu
pequeno	pekenu
pera	peɾɐ
pera	pɛɾɐ
perambulava	peɾɐ̃bulava
peraí	pɛɾai
perca	peɾkɐ
perca	pɛɾkɐ
percebe	peʁsebi
percebe	peʁsɛbi
percebem	peʁsɛbẽj̃
perceber	peʁsebeʁ
percorrer	peʁkoʁeʁ
perda	peɹdɐ
perda	peɻda
perda	peɾda
perda	peɾdɐ
perda	peʁdɐ
perder	peʁdeʁ
perdiz	pɛʁd͡ʒis
perdiz	pɛʁd͡ʒiʃ
perdição	peɹdʒisɐ̃w̃
perdição	peʁdʒisɐ̃w̃
perdoar	peʁdoaʁ
perdulário	peɾdulaɾju
perdão	peʁdɐ̃w̃
pereba	peɾɛbɐ
perecibilidade	peresibilidadʒi
perene	peɾeni
perfeito	peʁfejtu
perfilar	peʁfilaʁ
performance	peʁfɔʁmɐ̃si
pergunta	peʁɡũtɐ
perguntar	peɹɡũtaɹ
perguntar	peɻɡũtaɻ
perguntar	peʁɡũtaʁ
perguntar	pɛhɡũtah
periférica	peɾifɛɾikɐ
perigo	peɾiɡo
perigo	peɾiɡu
perigosas	peɾiɡɔzas
perigoso	peɾiɡozu
perito	peɾitu
permanecer	peʁmɐneseʁ
permanente	peʁmɐnẽtʃi
permitir	peɹmit͡ʃiɹ
permitir	peɻmit͡ʃiɻ
permitir	peɾmit͡ʃiɾ
permitir	peʁmit͡ʃiʁ
permitir	peχmitiχ
permitir	peχmit͡ʃiχ
perna	pɛʁnɐ
pernambucano	peʁnɐ̃bukɐnu
pernambuco	peʁnɐ̃buku
pernóstico	peɾnɔstʃiku
perplexo	peɾplɛksu
perplexo	peʁplɛksu
perro	peʁu
perscrutar	peχskɾutaʁ
perseguir	peʁseɡiʁ
perseu	peʁsew
personagem	peʁsonaʒẽj̃
persuadir	peʁswadʒiʁ
persépolis	peʁsɛpolis
pertencer	peʁtẽseʁ
pertinente	peʁtʃinẽtʃi
perto	pɛhtʊ
perto	pɛɾto
perto	pɛɾtu
perto	pɛʁtu
perto	pɛχtu
perturbador	peʁtuʁbadoʁ
perturbar	perturbar
peru	peɾu
peru	piɾu
perversão	peʁveʁsɐ̃w̃
período	peɾiwdu
pesa	pɛzɐ
pesado	pezadu
pesagem	pezaʒẽj̃
pesca	pɛskɐ
pescador	peskadoʁ
pescador	peʃkadoʁ
pescoço	peskosu
pescoço	peʃkosu
peshmerga	pɛʃimɛʁɡɐ
peso	peso
peso	pesu
peso	pezu
peso	pɛzu
pesquisa	peskiza
pesquisa	peskizɐ
pesquisar	peskizaʁ
pessoa	pesowɐ
pessoa	pesoɐ
pessoas	pesoɐs
pessoas	pesoɐʃ
pestana	pestɐna
pestana	pestɐnɐ
pestana	peʃtɐnɐ
peste	pɛst͡ʃi
pet	pɛt͡ʃ
peteminion	peteminiõ
peteminion	peteminjõ
petista	petiʃta
petista	pet͡ʃijʃta
petista	pet͡ʃista
petróleo	petɾɔljo
petróleo	petɾɔlju
petróleo	petɾɔʎo
petróleo	petɾɔʎu
petúnia	petunia
petúnia	petunja
pevide	pevid͡ʒi
pezinho	peziɲu
pezinho	pɛziɲu
peão	peɐ̃w̃
peão	pjɐ̃w̃
peça	pɛsɐ
pi	pi
pianinho	piɐniɲu
pianista	piɐnista
pianista	piɐnistɐ
pianista	piɐniʃtɐ
piauí	piawi
piaçaba	piasabɐ
piaçaba	pjasabɐ
picadeiro	pikadejɾu
picadilha	pikad͡ʒiʎɐ
picante	pikɐ̃t͡ʃi
picar	pikaʁ
picardia	pikaʁd͡ʒiɐ
picareta	pikaɾetɐ
pichação	piʃasɐ̃w̃
piche	piʃi
picho	piʃu
pico	piku
picolé	pikolɛ
piedade	pjedadʒi
piemonte	piemõt͡ʃi
piercing	piʁsĩ
pierre	piɛʁi
pierre	pjɛʁi
pietista	piet͡ʃistɐ
pijama	piʒɐma
pijama	piʒɐmɐ
pilantra	pilɐ̃tɾa
pilar	pilaʁ
pilha	piʎɐ
pilo	pilu
piloto	pilotu
piloto	pilɔtu
pilsen	piwsẽj̃
pimenta	pimẽta
pimenta	pimẽtɐ
pimenteiro	pimẽtejɾu
pimento	pimẽtu
pimentão	pimẽtɐ̃w̃
pimpão	pĩpɐ̃w̃
pinball	pĩbɔw
pincel	pĩsɛw
pindaíba	pindaibɐ
pingo	pĩɡu
pingolim	pĩɡulĩ
pinguim	pĩɡwĩ
pinheiro	piɲejɾu
pinoia	pinɔja
pinote	pinɔt͡ʃi
pinotes	pinɔt͡ʃis
pinque	pĩki
pinta	pĩtɐ
pintada	pĩtadɐ
pintar	pĩtaʁ
pintassilgo	pĩtasiwɡu
pintassilgos	pĩtasiwɡus
pinto	pĩtu
pináculo	pinakulu
pinóquio	pinɔkju
piolho	pioʎu
pior	piɔʁ
pior	pjɔʁ
pipa	pipa
pipa	pipɐ
pipe	pajp
pipe	pajpi
pipi	pipi
pipoca	pipɔkɐ
pique	piki
pira	piɾa
piranha	piɾɐ̃ɲa
pirata	piɾatɐ
pires	piɾis
piriguete	peɾiɡɛtʃi
piriguete	piɾiɡɛtʃi
pirilampo	piɾilɐ̃pu
piroxena	piɾokisenɐ
pirralho	piʁaʎu
pirulito	piɾulitu
pirão	piɾɐ̃w̃
pirólise	piɾɔlizi
pisar	pizaʁ
piscar	piskaʁ
piscina	pisina
piscina	pisinɐ
piso	pizu
pista	pistɐ
pitaco	pitaku
pitanga	pitɐ̃ɡɐ
pito	pitu
pitéu	pitɛw
pivete	pivɛtʃi
pizza	pitsɐ
pizza	pitʃisɐ
pizzaiolo	pitsajolu
piá	pia
placa	plaka
placa	plakɐ
placar	plakar
placar	plɐkar
placebo	plasebu
placenta	plasẽtɐ
plaina	plɐjnɐ
planalto	planawtu
planalto	plɐnawtu
planejar	plɐneʒah
planejar	plɐneʒaɹ
planejar	plɐneʒaɻ
planejar	plɐneʒaʁ
plangente	plɐ̃ʒẽt͡ʃi
plano	plɐno
plano	plɐnu
planta	plɐ̃tɐ
plateia	platɛjɐ
platão	platɐ̃w̃
platô	plato
plausível	plawzivew
player	plejeʁ
playground	plejɡɾaw̃d͡ʒ
plebeiamente	plebɛjɐmẽt͡ʃi
pleitear	plejtʃiaɹ
pleito	plejtu
pleno	plenu
pleonástico	pleonast͡ʃiku
pleonástico	pleonaʃt͡ʃiku
plotador	plotadoɾ
plotador	plotadoʁ
plotadora	plotadoɾa
plotagem	plotaʒi
plotagem	plotaʒɐ̃
plotar	plotaɾ
plotar	plotaʁ
plural	pluɾaw
plutarco	plutaʁku
plutão	plutɐ̃w̃
plutónio	plutɔniu
plástico	plast͡ʃiku
plástico	plaʃt͡ʃiku
plátano	platɐnu
plínio	plinju
pneu	penew
pneu	pinew
pneu	pnew
pneumoconiose	pinewmukoniɔzi
pneumoconiose	pnewmukoniɔzi
pneumonia	pinewmoniɐ
pneumonia	pnewmoniɐ
poaense	poaẽsi
pobre	pɔbɾi
pobreza	pobɾeza
pobreza	pobɾezɐ
pode	pɔd͡ʒi
podendo	podẽdu
poder	podeɹ
poder	podeɾ
poder	podeʁ
poderia	podeɾiɐ
poderoso	podeɾozu
podes	pɔd͡ʒis
podre	podɾi
podrão	podɾɐ̃w̃
poema	poemɐ
poema	pɔẽmɐ
poesia	poezia
poetisa	poet͡ʃiza
poetisa	poet͡ʃizɐ
point	põj̃t͡ʃi
poio	poju
pois	pojs
polaco	polaku
polegada	poleɡada
polegada	poleɡadɐ
poliandria	poliɐ̃dɾia
poliban	pɔlibɐ̃
polichinelo	poliʃinɛlu
policial	pulisiaw
poligamia	poliɡɐ̃mia
poliginia	poliʒinia
poligâmico	poliɡɐ̃miku
poliuria	pɔliuɾia
polivalente	polivalẽtʃi
poliúria	pɔliuɾja
polução	polusɐ̃w̃
polvilho	pɔwviʎu
polvo	powvu
polícia	polisjɐ
política	polit͡ʃikɐ
política	pulitikɐ
política	pulitkɐ
política	pulit͡ʃikɐ
político	polit͡ʃiku
político	pulit͡ʃiku
polónio	poloniu
polónio	polonju
pomada	pomadɐ
pomba	põba
pomba	põbɐ
pomerânia	pomeɾɐniɐ
pompom	põpõ
pondera	põdɛɾa
pondo	põdu
ponhar	põɲa
ponhar	põɲaɾ
ponhar	põɲaχ
ponta	põtɐ
pontapé	põtapɛ
ponte	põt͡ʃi
ponteira	põtejɾa
ponteiro	põtejɾo
ponteiro	põtejɾu
ponto	põto
ponto	põtu
pontualidade	põtualidad͡ʒi
pontualidade	põtwalidad͡ʒi
pontuar	põtuaʁ
pontuação	põtuasɐ̃w̃
popular	populaʁ
popularizar	populaɾizaʁ
população	populasãw
por	poɹ
por	poɻ
por	poɾ
por	poʁ
por	puɹ
por	puɻ
por	puɾ
por	puʁ
porcaria	poxkaɾiɐ
porcaria	poɾkaɾiɐ
porco	pohkʊ
porco	poɹku
porco	poɻko
porco	poʁku
pormenor	poʁmenɔʁ
pormenores	poʁmenɔɾis
pornografia	poʁnoɡɾafiɐ
porongo	poɾõɡu
porque	poɹke
porque	poɾke
porque	puɻke
porque	puʁke
porquê	puʁke
porrete	poʁetʃi
porta	pɔhtɐ
porta	pɔɹtɐ
porta	pɔʁtɐ
portal	poɾtaw
portanto	poɻtɐ̃to
portanto	puɹtɐ̃tu
portanto	puʁtɐ̃tu
portar	poʁtaʁ
porto	pohtu
porto	poɾtu
porto	poχtu
porto	pɔhtu
porto	pɔɾtu
porto	pɔχtu
portugal	poɾtuɡaw
portugal	poχtuɡaw
portuguesismo	poʁtuɡezizmu
portão	pohtɐ̃w̃
portão	poɹtɐ̃w̃
portão	poɻtɐ̃w̃
portão	poɾtɐ̃w̃
portão	poχtɐ̃w̃
portão	pɔhtɐ̃w̃
porão	porɐ̃w̃
porém	poɾẽj̃
positivismo	pozit͡ʃivismu
positivismo	pozit͡ʃiviʃmu
positivista	pozit͡ʃivista
positivista	pozit͡ʃivistɐ
positivista	pozit͡ʃiviʃtɐ
positivo	pozit͡ʃivu
posição	pozisɐ̃w̃
possa	pɔsa
possa	pɔsɐ
posse	pɔsi
posseiro	posejɾu
possessivo	posesivu
possibilidade	posibilidadʒi
possibilitar	posibilitaʁ
posso	pɔsu
possuir	posuiʁ
possível	posivew
post	post͡ʃ
post	powst͡ʃ
postal	postaw
poste	pɔst͡ʃi
postergar	posteʁɡaʁ
posterioridade	posteɾjoɾidad͡ʒi
posteriormente	posteɾjoʁmẽt͡ʃi
posto	postu
posto	pɔstu
pote	pɔt͡ʃi
potencial	potẽsiaw
potencialidade	potẽsjalidadʒi
potro	potɾu
potência	potẽsjɐ
pouca	powkɐ
poucas	powkɐs
pouco	powku
poucos	powkus
poupa	powpɐ
poupança	powpɐ̃sɐ
pouquinho	powkiɲu
pousada	powzada
pousada	powzadɐ
povo	povu
povoar	povoaʁ
povoação	povoasɐ̃w̃
povos	pɔvus
powerpoint	paweʁpɔj̃t͡ʃ
poça	posɐ
poça	pɔsɐ
poço	posu
pra	pɾa
praga	pɾaɡa
praia	pɾajɐ
prancha	pɾɐ̃ʃɐ
pranto	pɾɐ̃tu
pras	pɾas
praseodímio	pɾaziud͡ʒimiu
praseodímio	pɾazjud͡ʒimju
prata	pɾatɐ
prataria	pɾataɾia
prataria	pɾataɾiɐ
praticabilidade	pratʃikabilidadʒi
praticar	pɾatʃikaʁ
prato	pɾatu
prazer	pɾazeʁ
prazo	pɾazu
prece	pɾɛsi
precedente	pɾesedẽt͡ʃi
preceito	pɾesejtu
precisando	pɾesizɐ̃du
precisar	pɾesizaʁ
preciso	pɾesizu
preciso	pɾisizu
precoce	pɾekɔsi
preconceito	pɾekõsejtu
preconceito	pɾɛkõsejtu
predial	pɾed͡ʒiaw
predial	pɾed͡ʒjaw
preeminência	preeminẽsja
preencher	pɾeĩʃeʁ
preferido	prefeɾidu
preferir	pɾefeɾiʁ
prefixo	pɾefiksu
prega	pɾɛɡɐ
preguicite	pɾeɡisit͡ʃi
preguiça	pɾeɡisɐ
preguiça	pɾiɡisɐ
preguiça	pɾɛɡisa
preju	pɾeʒu
prejudicar	pɾeʒudʒikaʁ
prejuízo	pɾeʒwizu
prelado	pɾeladu
prelibar	pɾelibaʁ
prelibava	pɾelibavɐ
premente	pɾemẽtʃi
premiar	pɾemiaʁ
premiar	pɾimiaʁ
premiu	pɾemiw
prensa	pɾẽsɐ
preocupar	pɾeokupaʁ
preocupar	pɾewkupaʁ
preocupação	pɾewkupasɐ̃w̃
preparado	pɾepaɾadu
preparar	pɾepaɾaʁ
preparação	pɾepaɾɐsɐ̃w̃
preplexa	peʁplɛksɐ
preponderância	pɾɛpõderãsja
preposição	pɾepozisɐ̃w̃
prepotência	pɾɛpotẽsja
prerrogativa	pɾeʁoɡɐt͡ʃivɐ
presa	pɾeza
presa	pɾezɐ
prescritível	pɾeskritʃivew
presente	pɾezẽt͡ʃi
presentear	pɾezẽt͡ʃiaʁ
presença	pɾezẽsɐ
presepada	pɾezepada
preservar	pɾezeʁvaʁ
preservação	pɾezeʁvasɐ̃w̃
presidente	pɾezidẽt͡ʃi
presidiário	pɾezid͡ʒiaɾiu
presilha	pɾiziʎɐ
pressentimento	pɾesẽt͡ʃimẽtu
pressão	pɾesɐ̃w̃
prestar	pɾestaʁ
presumir	pɾezumiʁ
presunto	pɾezũtu
presunçoso	pɾezũsozu
presépio	pɾezɛpju
preta	pɾetɐ
pretender	pɾetẽdeʁ
pretinho	pɾet͡ʃij̃ʊ
preto	pɾetu
prevaricador	pɾevaɾikadoʁ
prevenir	pɾeveniʁ
prevenção	pɾevẽsɐ̃w̃
prever	pɾeveʁ
previamente	pɾɛviamẽt͡ʃi
previamente	pɾɛvjɐmẽt͡ʃi
previsto	pɾevistu
previsto	pɾeviʃtu
previsão	pɾevizɐ̃w̃
preço	pɾeso
preço	pɾesu
prima	pɾima
prima	pɾimɐ
primata	pɾimata
primata	pɾimatɐ
primavera	pɾimavɛɾɐ
primeiro	pɾimejɾo
primeiro	pɾimejɾu
primário	pɾimaɾju
principal	pɾĩsipaw
principalmente	pɾĩsipawmẽt͡ʃi
principiar	pɾĩsipiaʁ
principiou	pɾĩsipiow
princípio	pɾĩsipiw
princípio	pɾĩsipju
princípios	pɾĩsipjus
print	pɾĩtʃi
prisioneiro	pɾizionejɾu
prisioneiro	pɾizjonejɾu
prisão	pɾizɐ̃w
privado	pɾivadu
privatizar	pɾivatizaʁ
privilégio	pɾivilɛʒiu
privilégio	pɾivilɛʒju
pro	pɾu
proa	proɐ
probidade	pɾobidad͡ʒi
problema	pɾoblemɐ
problema	pɾɔblẽmɐ
proceder	pɾosedeʁ
procedimento	pɾosed͡ʒimẽtu
procedência	pɾosedẽsiɐ
processar	pɾosesaʁ
processo	pɾosɛso
processo	pɾosɛsu
procissão	pɾosisɐ̃w̃
procura	pɾokuɾa
procura	pɾokuɾɐ
procura	pɾukuɾɐ
procurando	pɾokuɾɐ̃du
procurar	pɾokuɾaɹ
procurar	pɾokuɾaɻ
procurar	pɾokuɾaʁ
procurar	pɾukuɾaɹ
procuro	pɾokuɾu
produto	pɾoduto
produto	pɾodutu
produz	pɾodujs
produz	pɾodujʃ
produzir	pɾoduziɹ
produzir	pɾoduziɻ
produzir	pɾoduziɾ
produzir	pɾoduziʁ
produzir	pɾoduziχ
produzir	pɾɔduzih
produção	pɾodusɐ̃w̃
proeminência	proeminẽsja
profano	pɾofɐnu
profecia	pɾofesiɐ
proferida	pɾofeɾidɐ
professor	pɾofesoʁ
profeta	pɾufɛtɐ
profissional	pɾofisjonaw
profunda	pɾofũdɐ
profundamente	pɾofũdɐmẽt͡ʃi
profundo	pɾofũdu
profícuo	pɾofikwu
programa	pɾoɡɾɐmɐ
programador	pɾoɡɾamadoʁ
programador	pɾoɡɾɐmadoʁ
programação	pɾoɡɾamasɐ̃w̃
progressiva	pɾoɡɾesivɐ
progresso	pɾoɡɾɛsu
progresso	pɾɔɡɾɛsu
proibição	pɾoibisɐ̃w̃
proibição	pɾojbisɐ̃w̃
projete	pɾoʒɛtʃi
projeto	pɾoʒɛto
projeto	pɾoʒɛtu
projeção	pɾoʒesɐ̃w̃
promessa	pɾomɛsa
promessa	pɾomɛsɐ
promete	pɾomɛtʃi
prometer	pɾometeʁ
promontório	pɾomõtɔɾiu
promontório	pɾomõtɔɾju
promover	pɾomoveʁ
promécio	pɾomɛsiu
promécio	pɾomɛsju
pronome	pronomi
pronto	pɾõtu
prontuário	pɾõtuaɾiu
pronuncia	pɾunũsiɐ
pronunciar	pɾonũsjaʁ
pronunciar	pɾunũsjaɾ
pronúncia	pɾunũsjɐ
propor	pɾopoʁ
proporcionar	pɾopoʁsjonaʁ
proporção	pɾopoʁsɐ̃w̃
proposição	pɾopozisɐ̃w̃
proposta	pɾopɔstɐ
propriedade	pɾopɾiedade
propriedade	pɾopɾiedad͡ʒi
propriedade	pɾopɾjedade
propriedade	pɾopɾjedad͡ʒi
propriedade	pɾɔpɾiɛdadɪ
propriedade	pɾɔpɾjɛdadɪ
proprietário	pɾopɾietaɾiu
proprietário	pɾopɾjetaɾju
propósito	pɾopɔzitu
pros	pɾus
prosa	pɾɔza
prosa	pɾɔzɐ
prosaico	pɾozajku
prosseguir	pɾoseɡiʁ
prostituta	pɾost͡ʃitutɐ
prostituta	pɾɔʃtitutɐ
prostitutas	pɾost͡ʃitutɐs
prostrar	pɾostɾaɾ
prostração	pɾostrasɐ̃w̃
protactínio	pɾotakit͡ʃinju
protactínio	pɾotakt͡ʃiniu
protactínio	pɾotakt͡ʃinju
proteger	pɾoteʒeʁ
protelar	pɾotelaɾ
protelar	pɾotelaχ
protestante	pɾotestɐ̃t͡ʃi
protestante	pɾoteʃtɐ̃t͡ʃi
proteção	pɾotesɐ̃w̃
proteína	pɾoteinɐ
protista	pɾot͡ʃistɐ
protuberância	pɾotubeɾɐ̃sia
protuberância	pɾotubeɾɐ̃siɐ
protuberância	pɾotubeɾɐ̃sja
protuberância	pɾotubeɾɐ̃sjɐ
protótipo	pɾotɔt͡ʃipu
prova	pɾɔvɐ
provar	pɾovaʁ
prover	pɾoveʁ
providenciar	pɾovidẽsiaʁ
provir	pɾoviʁ
provisão	pɾovizɐ̃w̃
provocadora	pɾovokadoɾɐ
provocar	pɾovoka
provável	pɾovavew
proxeneta	pɾokseneta
proxeneta	pɾoksenetɐ
proximidade	pɾosimidad͡ʒi
proxy	pɾɔksi
prum	pɾũ
pruma	pɾumɐ
prumas	pɾumɐs
pruns	pɾũs
prácrito	pɾakɾitu
prática	pɾat͡ʃikɐ
prático	pɾat͡ʃiku
prédio	pɾɛd͡ʒiu
prémio	pɾemio
prémio	pɾemiu
prémio	pɾemjo
prémio	pɾemju
príapo	pɾiapu
príncipe	pɾĩsipi
pró	pɾɔ
próclise	pɾɔklizi
própria	pɾɔpɾia
própria	pɾɔpɾiɐ
própria	pɾɔpɾja
própria	pɾɔpɾjɐ
próprio	pɾɔpjo
próprio	pɾɔpju
próprio	pɾɔpɾio
próprio	pɾɔpɾiu
próprio	pɾɔpɾjo
próprio	pɾɔpɾju
próxima	pɾɔsimɐ
próximo	pɾɔsimu
prússia	pɾusja
pseudociência	psewdosiẽsiɐ
psicanálise	pisikanalizi
psicanálise	pisikɐnalizi
psicanálise	psikanalizi
psicanálise	psikɐnalizi
psicologia	pisikoloʒiɐ
psicológica	psikolɔʒikɐ
psicológico	psikolɔʒiku
psicopata	pisikopatɐ
psicopata	psikopatɐ
psicóloga	psikɔloɡa
psicólogo	psikɔloɡu
psiquiatra	pisikiatɾɐ
psiquiatra	pisikjatɾɐ
psiquiatra	psikiatɾɐ
psiquiatra	psikjatɾɐ
psiquiatria	psikiatɾia
psíquica	pisikikɐ
psíquica	psikikɐ
psíquico	pisikiku
psíquico	psikiku
publicano	publikɐnu
publicar	publikaʁ
publicidade	publisidad͡ʒi
publicitado	publisitadu
pudera	pudɛɾa
pugnar	puɡinaʁ
pular	pulaʁ
pulcro	puɫkrʊ
pulga	puwɡa
pulga	puwɡɐ
pulquérrimo	puwkɛʁimu
pulso	puwsu
puma	pumɐ
punhal	puɲaw
punheta	puɲetɐ
punhete	puɲɛtʃi
punho	puɲu
punk	pɐ̃k
pupila	pupilɐ
pureza	puɾeza
pureza	puɾezɐ
purga	puʁɡɐ
purificar	puɾifikaɾ
puro	puɾu
purulento	puɾulẽtu
pus	pujs
pus	pus
pusilanimidade	puzilãnimidadʒi
pusilânime	puzilɐnimi
putz	puts
puxa	puʃɐ
puxar	puʃaɹ
puxar	puʃaɻ
puxar	puʃaʁ
pá	pa
página	paʒinɐ
páli	pali
páris	paɾis
pártia	paʁt͡ʃiɐ
páscoa	paskwɐ
pássaro	pasaɾo
pássaro	pasɐɾu
pátio	pat͡ʃju
pátria	patɾia
pátria	patɾiɐ
pátria	patɾja
pátria	patɾjɐ
pânico	pɐniku
pã	pɐ̃
pães	pɐ̃j̃s
pães	pɐ̃j̃ʃ
pão	pɐ̃w̃
pé	pɛ
pégaso	pɛɡazu
pérgamo	pɛʁɡɐmu
pérola	pɛɾula
pérola	pɛɾulɐ
péssimo	pɛsimu
pê	pe
pêssanka	pesɐ̃kɐ
pílula	pilulɐ
pó	pɔ
póvoa	pɔvwɐ
pô	po
pôde	pod͡ʒi
pôr	poʁ
pôs	pojs
põem	põj̃
púbis	pubis
público	publiko
público	publiku
púcaro	pukaɾu
pústula	pustulɐ
q	ke
quadra	kwadɾɐ
quadrada	kwadɾada
quadrado	kwadɾadu
quadragésimo	kwadɾaʒɛzimu
quadrilha	kwadɾiʎɐ
quadro	kwadɾu
quais	kwajs
qual	kwaw
qualidade	kwalidad͡ʒi
qualificar	kwalifikaʁ
qualitativa	kwalitat͡ʃivɐ
qualquer	kwawkɛɹ
qualquer	kwawkɛɻ
qualquer	kwawkɛɾ
qualquer	kwawkɛʁ
quando	kwɐ̃du
quantia	kwɐ̃t͡ʃiɐ
quantidade	kwɐ̃t͡ʃidad͡ʒi
quantitativa	kwɐ̃t͡ʃitat͡ʃivɐ
quantitativas	kwɐ̃t͡ʃitat͡ʃivɐs
quantitativo	kwɐ̃t͡ʃitat͡ʃivu
quantitativos	kwɐ̃t͡ʃitat͡ʃivus
quanto	kwɐ̃tu
quarenta	kwaɾẽtɐ
quaresma	kwaɾɛzmɐ
quaresma	kwaɾɛʒmɐ
quarta	kwaʁtɐ
quarto	kwaʁtu
quase	kwazi
quati	kwatʃi
quatro	kwatɾu
quatrocentos	kwatɾusẽtus
que	ki
quebec	kebɛk
quebec	kebɛki
quebra	kɛbɾɐ
quebracho	kebɾaʃu
quebradeira	kebɾadejɾɐ
quebrantamento	kebɾɐ̃tamẽtu
quebrar	kebɾaɹ
quebrar	kebɾaɻ
quebrar	kebɾaʁ
queda	kɛdɐ
quedar	kedaʁ
quedival	ked͡ʒivaw
quedo	kedu
quedo	kɛdu
queijo	kejʒu
queimadura	kejmaduɾɐ
queimadura	kẽmaduɾɐ
queimar	kejmaʁ
queixa	kejʃɐ
queixada	keiʃada
queixar	kejʃaʁ
queixo	kejʃu
quelónio	keloniu
quelónio	kelonju
quem	kẽj̃
quente	kẽte
quente	kẽtɪ
quente	kẽt͡ʃi
quer	kɛʁ
quera	kwɛɾa
querem	kɛɾẽ
querem	kɛɾẽj̃
querer	keɾeʁ
queria	kiɾia
queria	kiɾiɐ
querido	keɾidu
querido	kiɾidu
quero	kɛɾu
querubim	keɾubĩ
questionar	kestʃjonaʁ
questionar	kestʃonaʁ
questionar	kwestʃjonaʁ
questionar	kwestʃonaʁ
questão	kestɐ̃w̃
questão	kwestɐ̃w̃
quiabeiro	kiabejɾu
quieto	kjɛto
quieto	kjɛtu
quieto	kɛto
quilha	kiʎɐ
quilo	kilu
quilowatt	kilovat͡ʃ
quimera	kimɛɾa
quina	kinɐ
quinar	kinaɾ
quinhentos	kiɲẽtus
quinhão	kiɲɐ̃w̃
quinquagésimo	kĩkwaʒɛzimu
quinta	kĩtɐ
quintal	kĩtaw
quintino	kĩt͡ʃinu
quinto	kĩtu
quinze	kĩzi
quiprocó	kipɾokɔ
quiproquó	kipɾokwɔ
quiproquó	kwipɾokwɔ
quipá	kipa
quis	kis
quisto	kijʃtu
quisto	kistu
quitanda	kitãda
quite	kit͡ʃi
quitinete	kitʃinɛtʃi
quitute	kituti
quitute	kitutʃi
quiçá	kisa
quociente	kosiẽti
quociente	kwosiẽti
quotidiano	kot͡ʃid͡ʒiɐnu
quão	kwɐ̃w̃
quê	ke
quíchua	kiʃua
quíchua	kiʃuɐ
química	kimika
químico	kimiku
quíton	kitõ
quórum	kɔɾũ
qüiproquó	kwipɾokwɔ
rabanete	ʁabanet͡ʃi
rabanete	ʁabɐnet͡ʃi
rabeca	ʁabɛkɐ
rabicho	ʁabiʃu
rabino	ʁabinu
rabo	ʁabu
rabugento	ʁabuʒẽtu
racha	ʁaʃɐ
racial	ʁasjaw
racional	ʁasionaw
racionalizada	ʁasjonalizadɐ
radar	ʁadaʁ
radical	ʁad͡ʒikaw
ragu	ʁaɡu
raiano	ʁajɐnu
raimundo	ʁajmũdu
rainha	ʁaiɲɐ
raio	ɦaju
raio	ʁaju
raiva	ʁajva
raiva	ʁajvɐ
raiz	ʁais
raiz	ʁaiʃ
rajada	ʁaʒada
rajada	ʁaʒadɐ
rajastão	ʁaʒastɐ̃w̃
ralé	ʁalɛ
rama	ʁɐmɐ
ramiro	ʁamiɾu
rampa	ʁɐ̃pa
rampa	ʁɐ̃pɐ
rancor	ʁɐ̃koʁ
ranger	ʁɐ̃ʒeɾ
rango	rɐ̃ɡu
rango	ʁɐ̃ɡu
rangum	ʁɐ̃ɡũ
ranqueada	ʁɐ̃keadɐ
ranqueada	ʁɐ̃kiadɐ
ranqueada	ʁɐ̃kjadɐ
ranqueado	ʁɐ̃keadu
ranqueado	ʁɐ̃kiadu
ranqueado	ʁɐ̃kjadu
ranço	ʁɐ̃su
rap	ʁɛpi
rapadura	ʁapaduɾɐ
rapariga	ʁapaɾiɡɐ
rapaz	ʁapajs
rapel	ʁapɛw
raposa	hapozɐ
raposa	ʁapozɐ
rapunzel	ʁapũzɛw
rapé	ʁapɛ
raquete	ʁakɛt͡ʃi
rara	ʁaɾɐ
raro	ʁaɾu
rasgo	ʁasɡu
rasgo	ʁazɡu
rastejante	ʁasteʒɐ̃t͡ʃi
rastro	ʁastɾu
rasuro	ʁazuɾu
ratazana	ʁatazɐna
ratazana	ʁatɐzɐnɐ
rateadora	ʁat͡ʃjadoɾɐ
ratinho	ʁat͡ʃiɲu
ratoeira	ʁatuejɾɐ
raul	ʁauw
ravina	ʁavina
ravina	ʁavinɐ
razoável	ʁazoavew
razão	ɦazɐ̃w̃
razão	ʁazɐ̃w̃
raça	ʁasɐ
reagir	χeɐʒiχ
reais	heajs
reais	xeajs
reais	ɾeajs
real	ʁeaw
realidade	ʁealidad͡ʒi
realizar	ʁealizaʁ
realmente	ʁeawmẽt͡ʃi
reação	ʁeasɐ̃w̃
rebanho	ʁebɐɲu
rebelde	ʁebɛwd͡ʒi
rebite	ʁebit͡ʃi
rebite	ʁibit͡ʃi
rebobinar	ʁebobinaʁ
recado	ʁekadu
recalculação	ʁekawkulasɐ̃w̃
recato	ʁikatu
receber	hesebeɻ
receber	ʁesebeɹ
receber	ʁesebeʁ
recebo	ʁesebu
receita	ʁesejta
receita	ʁesejtɐ
recente	ʁesẽt͡ʃi
recentíssima	ʁesẽt͡ʃisimɐ
recentíssimo	ʁesẽt͡ʃisimu
recibo	ʁesibu
recife	ʁesifi
recinto	ʁesĩntu
recipiente	ʁesipiẽt͡ʃi
recital	ʁesitaw
reclamar	ʁeklɐmaʁ
reclinar	ʁeklinaʁ
reclinou	ʁeklinow
reco	ʁɛku
recolha	ʁekoʎɐ
recombinação	ʁikõbinasɐ̃w̃
recomendar	ʁekomẽdaʁ
recompensa	ʁekũpẽsa
recompensa	ʁekũpẽsɐ
recompense	ʁekõpẽsi
reconciliar	ʁekõsiliaɹ
reconciliar	ʁekõsiljaɹ
reconhecer	ʁekoɲeseʁ
reconhecimento	ʁekoɲesimẽtu
reconhecimento	ʁekuɲesimẽtu
reconquista	ʁekõkista
reconquista	ʁekõkistɐ
recordar	ʁekoʁdaʁ
recorde	ʁekɔʁd͡ʒi
recorde	ʁɛkoʁd͡ʒi
recordista	ʁekoʁd͡ʒistɐ
recostada	ʁekostadɐ
recostado	ʁekostadu
recostar	ʁekostaʁ
recostou	ʁekostow
recuperar	ʁekupeɾaʁ
recurso	ʁekuʁsu
recusar	ʁekuzaʁ
recíproco	ʁesipɾoku
rede	ɦedɪ
rede	ʁed͡ʒi
redonda	ʁedõdɐ
redondo	ʁedõdu
redundância	ʁedũdɐ̃siɐ
reduz	ʁedujs
reduzir	ʁeduziʁ
redução	ʁedusɐ̃w̃
redário	ʁedaɾju
referir	hefeɾiɻ
referir	ʁefeɾiʁ
referir	ʁefiɾiɹ
referência	ʁefeɾẽjsiɐ
referência	ʁefeɾẽjsjɐ
refletir	ʁeflet͡ʃiʁ
reflexo	ʁeflɛksu
reforma	ʁefɔʁmɐ
reformista	ʁefɔʁmistɐ
refri	ʁefɾi
refrigerante	ʁefɾiʒeɾɐ̃t͡ʃi
refrão	ʁefɾɐ̃w̃
refugiado	ʁefuʒiadu
refúgio	χefuʒju
regalar	ʁeɡalaʁ
regalo	ʁiɡalu
regata	ʁeɡata
regatinho	ʁeɡat͡ʃiɲu
regatinhos	ʁeɡat͡ʃiɲus
regato	ʁeɡatu
regente	ʁeʒẽt͡ʃi
reggae	ʁɛɡi
regimento	ʁeʒimẽtu
regional	ʁeʒjonaw
registro	ʁeʒistɾu
região	ʁeʒiɐ̃w̃
regra	ʁɛɡɾɐ
regrar	ʁeɡɾaʁ
regressar	ʁeɡɾesaʁ
regular	ʁeɡulaʁ
regularmente	ʁeɡulaʁmẽt͡ʃi
regímen	ʁeʒimẽj̃
rei	hej
rei	ʁej
rei	χej
reich	ʁajk
reich	ʁajʃ
reino	ʁejnu
reivindicação	ʁejvĩdʒikasɐ̃w̃
rejeitar	ʁeʒejtaʁ
rejogar	ʁeʒoɡaɾ
relacionado	ʁelasjonadu
relacionamento	helasjonamẽto
relacionamento	ʁelasjonamẽtu
relatar	ʁelataʁ
relativamente	ʁelat͡ʃivɐmẽt͡ʃi
relativismo	ʁelat͡ʃivismu
relativismo	ʁelat͡ʃiviʃmu
relativo	ʁelatʃivu
relato	ʁelatu
relatório	helatɔɾio
relatório	helatɔɾjo
relatório	ʁelatɔɾju
relaxar	ʁelaʃaʁ
relação	ʁelasɐ̃w
releitura	helɐjtuɾɐ
reles	χɛlijʃ
reles	χɛlis
relevante	ʁelevɐ̃tʃi
religiosamente	ʁeʎiʒiɔzamẽj̃tʃi
religioso	ʁeliʒiozu
religião	ʁeliʒiɐ̃w̃
relâmpago	ʁelɐ̃paɡu
relógio	helɔʒjo
relógio	ɦɛlɔʒju
relógio	ʁelɔʒju
remanejamento	ʁemaneʒamẽtu
remanejar	ʁemaneʒaɾ
remanescente	ʁemanesẽt͡ʃi
remanescente	ʁemɐnesẽt͡ʃi
remela	ʁemɛla
remela	ʁemɛlɐ
remendo	ʁemẽdu
remete	ʁemɛtʃi
remexer	ʁemeʃeʁ
remexida	ʁemeʃidɐ
remo	ʁemu
remodelar	ʁemodelaʁ
remover	ʁemoveʁ
remédio	hemɛd͡ʒio
remédio	hemɛd͡ʒjo
remédio	ɦɛmɛdjʊ
remédio	ʁemɛd͡ʒiu
remédio	ʁemɛd͡ʒju
renan	ʁenɐ̃
renano	ʁenɐnu
renascente	ʁenasẽt͡ʃi
renascentista	ʁenasẽt͡ʃistɐ
renascença	ʁenasẽsɐ
renata	ʁenatɐ
renda	ʁẽdɐ
renderizar	ʁẽdeɾizaʁ
rendição	ʁẽdisɐ̃w̃
renhir	reɲiɹ
renhir	reɲiχ
renhir	ʁeɲiɹ
renhir	ʁeɲiχ
reno	ʁenu
renque	ʁẽki
renânia	ʁenɐniɐ
renúncia	ʁenũsia
renúncia	ʁenũsiɐ
renúncia	ʁenũsja
renúncia	ʁenũsjɐ
reparo	ʁepaɾu
repetidamente	ʁepet͡ʃidɐmẽt͡ʃi
repetir	hepet͡ʃiɻ
repetir	ʁepetʃiʁ
repetir	ʁepit͡ʃiɹ
replantais	ʁeplɐ̃tajs
replica	ʁeplikɐ
repor	hepoɾ
reportagem	ʁepoʁtaʒẽj̃
reportar	ʁepoʁtaʁ
repouso	hepowzo
repouso	ʁepowzu
repreensão	hepɾeẽsɐ̃ʊ
represa	ʁepɾeza
represa	ʁepɾezɐ
represa	ʁepɾɛza
represa	ʁepɾɛzɐ
representante	ʁepɾezẽtɐ̃t͡ʃi
representar	ʁepɾezẽtaʁ
representativo	ʁepɾezẽtat͡ʃivu
reprise	reprizi
repugnância	ʁepuɡinɐ̃siɐ
repugnância	ʁepuɡinɐ̃sjɐ
repugnância	ʁepuɡnɐ̃siɐ
repugnância	ʁepuɡnɐ̃sjɐ
repuxada	ʁepuʃadɐ
república	ʁepublika
república	ʁepublikɐ
república	ʁipublika
república	ʁipublikɐ
requeijão	ʁekejʒɐ̃w̃
requerer	ʁekeɾeʁ
requinte	ʁekĩt͡ʃi
requisito	ʁekizitu
rescaldar	ʁɛskawdaʁ
rescaldo	ʁeskawdu
resenha	ʁezeɲɐ
reserva	ʁizɛʁvɐ
reset	ʁezɛtʃi
resetar	rezetaɾ
resetar	rezetaχ
resete	ʁezɛtʃi
resfriado	ʁesfɾiadu
resfriado	ʁeʃfɾiadu
residente	ʁezidẽt͡ʃi
residência	ʁezidẽsia
residência	ʁezidẽsiɐ
residência	ʁezidẽsja
residência	ʁezidẽsjɐ
resignar	ʁeziɡinaʁ
resiliente	ʁeziliẽt͡ʃi
resiliente	ʁeziljẽt͡ʃi
resina	ʁezinɐ
resistir	rezistʃiɹ
resistir	ʁezijʃtʃiχ
resistir	ʁezistʃiɹ
resistir	ʁezistʃiɻ
resistir	ʁezistʃiʁ
resistir	ʁeziʃtiχ
resolver	ʁezowveʁ
respeitadora	ʁespejtadoɾɐ
respeito	ʁespejtu
respeito	ʁeʃpejtu
respirar	ʁespiɾaɾ
respiração	ʁespiɾasɐ̃w̃
responder	hespõdeɻ
responder	ʁespõdeɹ
responder	ʁespõdeʁ
responsável	ʁespõsavew
resposta	ʁespɔstɐ
ressarcimento	ʁessaɾsimẽtu
ressentimento	ʁesẽt͡ʃimẽtu
ressignificar	ʁesiɡnifikaɾ
restar	ʁestaʁ
restaurante	hestawɾɐ̃te
restaurante	ʁestawɾɐ̃t͡ʃi
restaurar	ʁestawɾaʁ
resto	hɛsto
resto	ʁɛstu
restringir	hestɾĩʒiɻ
restringir	ʁestɾĩʒiɹ
restringir	ʁestɾĩʒiʁ
resultado	ʁezuwtadu
resultante	ʁezuwtɐ̃t͡ʃi
resultar	ʁezuwtaʁ
reta	ʁɛta
reta	ʁɛtɐ
retalho	ʁitaʎu
reter	ʁeteʁ
retirante	ʁet͡ʃiɾɐ̃t͡ʃi
retirar	ʁet͡ʃiɾaʁ
reto	ʁɛtu
retornar	ʁetoʁnaʁ
retorno	ʁetoʁnu
retrasado	ʁetɾazadu
retrógrado	ʁitɾɔɡɾadu
retângulo	retɐ̃ɡulʊ
retórica	ʁetɔɾika
retórica	ʁetɔɾikɐ
reunião	heunjɐ̃w̃
reutilizar	ʁeutʃiʎizaɾ
reutilizar	ʁewtʃiʎizaɾ
revanchismo	ʁevɐ̃ʃizmu
revelar	ʁevelaʁ
revelação	ʁevelasɐ̃w̃
revezar	ʁevezaɾ
revezar	ʁevezaχ
revisar	ʁevizaʁ
revista	ʁevistɐ
revisão	ʁevizɐ̃w̃
revisão	ʁivizɐ̃w̃
revolução	ʁevolusɐ̃w̃
revés	ʁivɛs
rezar	ʁezaʁ
rezende	ʁezẽdʒi
ri	ʁi
ria	ʁiɐ
rias	ʁiɐs
ribeiro	ʁibejɾo
ribeiro	ʁibejɾu
ricamente	ʁikɐmẽt͡ʃi
rico	hiku
ridiculamente	ʁidikulɐmẽt͡ʃi
ridículo	ʁidʒikulu
rifa	ʁifɐ
rifle	ʁifli
rim	ʁĩ
rime	ʁimi
ringue	ʁĩɡi
rio	ʁiu
rio	ʁiw
ripostou	ʁipostow
riqueza	ʁikezɐ
rir	ʁiʁ
risada	ʁizadɐ
risco	hisko
risco	ʁisku
ritmo	xitʃmu
rito	ʁitu
ritual	ʁitwaɫ
riu	ʁiw
riável	ɾiavew
robalo	ʁobalu
robô	hobo
robô	ɦobo
robô	ʁobo
robô	χobo
roca	ʁɔkɐ
rocha	ʁɔʃɐ
rocim	ʁosĩ
rock	ʁɔk
rock	ʁɔki
roda	ɦɔdɐ
roda	ʁɔdɐ
rodeado	ʁod͡ʒiadu
rodo	ʁodu
rodo	ʁɔdu
rodolfo	ʁodowfu
rodovia	ʁodovia
rodovia	ʁodoviɐ
rodoviário	ʁodoviaɾiu
rodoviário	ʁodoviaɾju
rodrigo	ʁodɾiɡu
rodrigues	ʁodɾiɡis
rodrigues	ʁodɾiɡiʃ
roem	ʁɔẽj̃
roer	ʁoeʁ
roer	ʁueʁ
roer	χoe
roer	χoeχ
roer	χue
roer	χueχ
rogar	ʁoɡaʁ
rogério	ʁoʒɛɾju
rojão	ʁoʒɐ̃w̃
rola	ʁola
rola	ʁɔla
rolando	ʁolɐ̃du
rolar	ʁolaʁ
roldão	ʁowdɐ̃w̃
rolha	ʁoʎa
rolha	ʁoʎɐ
rolinho	ʁoliɲu
rolo	ʁolu
rom	ʁõ
rom	ʁɔm
roma	ʁomɐ
romaji	ʁomaʒi
romance	ʁomɐ̃si
romanche	ʁomɐ̃ʃi
romano	ʁomɐnu
romantismo	ʁomɐ̃t͡ʃizmu
rombo	rõbu
rombo	ʁõbu
romeno	ʁomenu
romeu	ʁomew
romper	ʁõpeʁ
romã	ʁomɐ̃
romão	ʁomɐ̃w̃
romãzeira	ʁomɐ̃zejɾa
romãzeira	ʁomɐ̃zejɾɐ
ronco	ʁõku
ronda	ʁõdɐ
ronrom	ʁõʁõ
ronrono	ʁõʁonu
ronrons	ʁõʁõjʃ
ronrons	ʁõʁõs
root	ʁut͡ʃ
roqueiro	ʁokejɾu
rosa	ʁɔzɐ
rosca	hoskɐ
rosela	ʁozɛlɐ
rosmaninho	ʁozmɐniɲu
rosto	ʁostu
rostov	ʁostɔv
rota	ʁɔtɐ
rottweiler	ʁɔt͡ʃvajleʁ
roubalheira	ʁowbaʎejɾɐ
rouco	ʁowku
round	raw̃d͡ʒ
roupeiro	ʁowpejɾu
rouquidão	ʁowkidɐ̃w̃
rouxinol	ʁowʃinɔw
rovaniemi	ʁovaniemi
roça	ʁɔsɐ
roídos	ʁoidus
rua	ʁuɐ
ruan	ʁuɐ̃
rubens	ʁubẽj̃s
rubi	hubi
rubéola	ʁubɛula
rubéola	ʁubɛulɐ
rubéola	ʁubɛwla
rubéola	ʁubɛwlɐ
rude	ʁudʒi
rugas	ʁuɡas
rugas	ʁuɡɐs
rugas	ʁuɡɐʃ
rugby	ʁɐɡbi
rugir	ʁuʒiɾ
rugosa	ʁuɡɔzɐ
rui	ʁuj
ruim	ʁuĩ
ruim	ʁũj̃
ruins	ʁuĩs
ruins	ʁũj̃s
rumar	ʁumaɹ
ruminante	ʁuminɐ̃t͡ʃi
rumo	ʁumu
rumor	ʁumoɾ
rumor	ʁumoʁ
rumorosa	ʁumoɾɔzɐ
rural	ʁuɾaw
russo	ʁusu
rutilo	ʁut͡ʃilɐ
rutilância	ʁutʃilãsja
ruténia	ʁuteniɐ
ruço	ʁusu
ruído	ʁuidu
ruína	ʁuina
ruína	ʁuinɐ
ruína	ʁwinɐ
rádio	ʁadʒju
rápido	ʁapidu
rã	ʁɐ̃
ré	ʁɛ
réplica	ʁɛplika
réplica	ʁɛplikɐ
réptil	hɛpt͡ʃiw
réu	ʁɛw
réveillon	ʁevejõw̃
rígido	ʁiʒidu
rítmico	xitʃmiku
rótulo	ʁɔtulu
rúgbi	ɾuɡbi
rúgbi	ʁuɡbi
rússia	rusja
rússia	ʁusja
saara	saaɾɐ
sabe	sabe
sabe	sabi
saber	sabeɹ
saber	sabeɾ
saber	sabeʁ
sabonete	sabonetʃi
sabor	saboʁ
sabre	sabɾi
sabão	sabɐ̃w̃
sacada	sakadɐ
sacana	sakɐ̃nɐ
sacar	sakaʁ
sacarose	sakaɾɔzi
sacarose	sakɐɾɔzi
sacerdote	saseʁdɔti
sacho	saʃu
sachola	saʃɔlɐ
saco	saku
sacola	sakɔlɐ
sacolé	sakolɛ
sacrifício	sakɾifisiu
sacrifício	sakɾifisju
sacro	sakɾu
sacudir	sakudʒiɾ
sadio	sad͡ʒiʊ
safa	safɐ
safadeza	safadezɐ
safar	safaʁ
safista	safista
safista	safistɐ
safista	safiʃtɐ
sagitário	saʒitaɾju
sagu	saɡu
saguão	saɡwɐ̃w̃
sai	saj
saia	saja
saiote	sajɔtʃi
sair	saiʁ
sais	sajs
sais	sajʃ
sal	saw
sala	salɐ
salada	salada
salada	saladɐ
salamaleque	salamaleki
salamandra	salamɐ̃dɾa
salamandra	salɐmɐ̃dɾɐ
salame	salɐmi
saldo	sawdu
salga	sawɡɐ
salgado	sawɡadu
salgueiro	sawɡejɾu
salisburgo	salizbuʁɡu
saliva	saliva
salmo	sawmu
salmoura	sawmowɾɐ
salomão	salomɐ̃w̃
salsa	sawsɐ
salsicha	sawsiʃɐ
salsinha	sawsiɲɐ
saltar	sawtaʁ
salubérrimo	salubɛʁimu
salva	sawva
salva	sawvɐ
salvar	sawvaɹ
salvar	sawvaɻ
salvar	sawvaʁ
salve	sawve
salve	sawvi
salvo	sawvu
salvífico	sawvifiku
salário	salaɾio
salário	salaɾiu
salário	salaɾjo
salário	salaɾju
salão	salɐ̃w̃
samaria	samaɾiɐ
samba	sɐ̃bɐ
sambódromo	sɐ̃bɔdɾomu
samo	samu
samoano	samuɐnu
samurai	samuɾaj
samurai	sɐmuɾaj
sanduíche	sɐ̃duiʃi
sanduíche	sɐ̃dwiʃi
sandália	sɐ̃dalia
sandália	sɐ̃daliɐ
sandália	sɐ̃dalja
sandália	sɐ̃daljɐ
sandália	sɐ̃daʎa
sandália	sɐ̃daʎɐ
saneamento	sɐniɐmẽtu
sanfona	sɐ̃fonɐ
sangramento	sɐ̃ɡɾɐmẽtu
sangrento	sɐ̃ɡɾẽtu
sangria	sɐ̃ɡɾiɐ
sangue	sɐ̃ɡi
sanguento	sɐ̃ɡwẽtu
sansão	sɐ̃sɐ̃w̃
santana	sɐ̃tɐnɐ
santarém	sɐ̃taɾẽj̃
santo	sɐ̃tu
santuário	sɐ̃tuaɾiu
santuário	sɐ̃tuaɾju
sanção	sɐ̃sɐ̃w̃
sapata	sapata
sapata	sapatɐ
sapateado	sapat͡ʃiadu
sapateado	sapat͡ʃjadu
sapato	sapatu
sapiente	sapiẽt͡ʃi
sapo	sapu
sapão	sapɐ̃w̃
sarado	saɾadu
sarapatel	saɾapatɛw
sarcástico	sarkastʃikʊ
sardinha	saʁd͡ʒiɲɐ
sardão	saʁdɐ̃w̃
sargento	saʁʒẽtu
sarilho	saɾiʎu
sarin	saɾĩ
sashimi	saʃimi
satanás	satanajs
satiríase	sat͡ʃiɾiazi
satisfazer	satʃisfazeʁ
satisfação	satisfasɐ̃w̃
satisfação	satiʃfasɐ̃w̃
satisfação	satʃisfasɐ̃w̃
satisfação	satʃiʃfasɐ̃w̃
saturno	satuʁnu
satã	satɐ̃
satélite	satɛlitʃi
saudade	sawdade
saudade	sawdadi
saudade	sawdadʒi
saudação	saudasɐ̃w̃
saudação	sawdasɐ̃w̃
saxofone	saksofoni
saxão	saksɐ̃w̃
sazão	sazɐ̃w̃
saída	saidɐ
saúde	saude
saúde	saudi
saúde	saud͡ʒi
scrapie	skɾejpi
se	si
sebastianismo	sebast͡ʃjɐnizmu
sebe	sɛbi
sebo	sebu
seca	sekɐ
seca	sɛkɐ
seco	seku
secretamente	sekɾɛtɐmẽt͡ʃi
secrete	sekɾɛtʃi
secretária	sekɾetaɾiɐ
secretária	sekɾetaɾjɐ
secretário	sekɾetaɾio
secretário	sekɾetaɾiu
secretário	sekɾetaɾjo
secretário	sekɾetaɾju
seda	seda
seda	sedɐ
sede	sedʒi
sede	sɛdʒi
sedição	sed͡ʒisɐ̃w̃
segar	seɡaʁ
segmento	seɡimẽtu
segredar	seɡɾedaʁ
segredo	seɡɾedu
segregação	seɡɾiɡasɐ̃w̃
segue	sɛɡi
seguidor	seɡidoʁ
seguindo	seɡĩdu
seguinte	seɡĩt͡ʃi
seguinte	siɡĩt͡ʃi
seguir	seɡiʁ
segunda	seɡũdɐ
segundo	seɡũdu
seguradora	seɡuɾadoɾɐ
segurança	seɡuɾɐ̃sɐ
segurança	siɡuɾɐ̃sɐ
segurar	seɡuɾaɹ
segurar	seɡuɾaɻ
segurar	seɡuɾaʁ
seguridade	seɡuɾidad͡ʒi
seguro	seɡuɾu
seguro	siɡuɾu
sei	sej
seira	sejɾa
seira	sejɾɐ
seis	sejs
seiscentos	sejsẽtus
seita	sejta
seita	sejtɐ
seixo	sejʃu
seja	seʒa
seja	seʒɐ
sela	sɛlɐ
selecionado	selesjonadu
selecionar	selesjonaʁ
selena	selenɐ
selene	seleni
selenita	selenitɐ
selenologia	selenoloʒiɐ
seleção	selesɐ̃w̃
selfie	sɛwfi
selma	sɛwmɐ
selo	selu
selo	sɛlu
selva	sɛwva
selva	sɛwvɐ
selvagem	sewvaʒẽj̃
sem	sẽj̃
semana	semɐnɐ
semanal	semanaw
semanal	semɐnaw
semeador	semeadoʁ
semeadura	semiaduɾɐ
semelhante	semeʎɐ̃t͡ʃi
semelhança	semeʎɐ̃sa
semelhança	semeʎɐ̃sɐ
semente	semẽt͡ʃi
sementeira	semẽtejra
semestre	semɛstɾi
semestre	semɛʃtɾi
semirreta	semiʁɛtɐ
semiólogo	semjɔloɡu
sempre	sẽpɾe
sempre	sẽpɾi
semáforo	semafoɾu
semáforos	semafoɾus
sena	senɐ
senciente	sẽsiẽt͡ʃi
sendo	sẽdu
senectude	sinekitud͡ʒi
senhor	seɲoʁ
senhora	seɲɔɾɐ
senhorio	seɲoɾiw
senhorita	seɲoɾitɐ
seno	senu
sensatez	sẽsatejs
sensato	sẽsatu
sensação	sẽsasɐ̃w̃
sensações	sẽsasõj̃s
sensibilidade	sẽsibilidad͡ʒɪ
senso	sẽsu
sentar	sẽtaʁ
sentenciarei	sẽtẽsjaɾej
sentença	sẽtẽsa
sentença	sẽtẽsɐ
sentido	sẽt͡ʃido
sentido	sẽt͡ʃidu
sentimento	sẽt͡ʃimẽtu
sentinela	sẽt͡ʃinɛlɐ
sentir	sĩt͡ʃiɹ
sentir	sĩt͡ʃiɻ
sentir	sẽt͡ʃiɹ
sentir	sẽt͡ʃiɻ
sentir	sẽt͡ʃiʁ
separadamente	sepaɾadɐmẽt͡ʃi
separado	sepaɾadu
separar	sepaɾaʁ
separarão	sepaɾaɾɐ̃w̃
septicemia	sept͡ʃisemiɐ
septicémico	sept͡ʃisemiku
sepultar	sepuwtaʁ
sepultura	sepuwtuɾɐ
sequestro	sekwɛstɾo
sequestro	sekwɛstɾu
sequestro	sekwɛʃtɾu
sequestro	sɛkwɛʃtɾʊ
sequência	sekwẽsjɐ
ser	seʁ
sereia	seɾeja
sereia	seɾejɐ
serenidade	seɾenidad͡ʒi
seres	seɾis
seres	seɾiʃ
serguei	seʁɡej
seria	seɾiɐ
seriado	seɾiadu
seriar	seɾiaʁ
seriar	seɾjaʁ
seriação	seɾiasɐ̃w̃
serifa	seɾifa
serifa	seɾifɐ
sermos	seɹmus
sermos	seɾmus
sermos	seʁmuʃ
servidor	seɾvidoʁ
servir	seʁviʁ
serviço	seɹvisu
serviço	seɻviso
serviço	seʁvisu
será	seɾa
sessenta	sesẽtɐ
sessenta	sɛsẽtɐ
sessão	sesɐ̃w̃
sesta	sɛsta
sesta	sɛstɐ
sesta	sɛʃtɐ
sestra	sɛstɾɐ
sestro	sɛstɾu
sestro	sɛʃtɾu
set	sɛtʃi
sete	sɛte
sete	sɛtɪ
sete	sɛt͡ʃi
setecentos	sɛt͡ʃisẽtus
setembro	setẽbɾu
setembro	sɛtẽbɾu
setenta	setẽtɐ
setenta	sɛtẽtɐ
setim	setʃĩ
setor	setoʁ
seu	sew
seul	seuw
seus	sews
severo	sevɛɾu
sexo	sɛksu
sexta	sestɐ
sexto	sestu
sexual	seksuaw
sexy	sɛksi
seção	sesɐ̃w̃
sheila	ʃejlɐ
shiitake	ʃiitaki
shiitake	ʃitaki
shiva	ʃivɐ
shopping	ʃɔpĩ
shopping	ʃɔpẽj̃
show	ʃow
si	si
sicofanta	sikofɐ̃ta
sicofanta	sikofɐ̃tɐ
sidra	sidɾɐ
sievert	siveʁt͡ʃ
sigilo	siʒilu
sigla	siɡla
sigla	siɡlɐ
significativo	siɡinifikat͡ʃivu
significativo	siɡnifikat͡ʃivu
signo	siɡnu
silhueta	siʎuwetɐ
silhueta	siʎwetɐ
silva	siwva
silva	siwvɐ
silvestre	siwvɛstɾi
silêncio	silẽsju
sim	sĩj̃
simbologia	sĩboloʒia
simbólico	sĩbɔliku
simetria	simetɾia
simetria	simetɾiɐ
similar	similaʁ
simone	simoni
simonia	simonia
simonia	simoniɐ
simpatizante	sĩpat͡ʃizɐ̃t͡ʃi
simples	sĩplis
simplesmente	sĩplizmẽt͡ʃi
simplesmente	sĩpliʒmẽt͡ʃi
simpático	sĩpat͡ʃiku
simulacro	simulakɾu
simulação	simulasɐ̃w̃
simum	simũ
simão	simɐ̃w̃
simétrico	simɛtɾiku
sinal	sinaw
sinalizar	sinalizaʁ
sinceramente	sĩsɛɾɐmẽt͡ʃi
sindical	sĩd͡ʒikaw
sindicato	sĩd͡ʒikatu
sinfonia	sĩfoniɐ
single	sĩɡow
sino	sinu
sinopse	sinɔpsi
sinquisita	sĩkizitɐ
sintaxe	sĩtaksi
sintaxe	sĩtasi
sinto	sĩtu
sintoma	sĩtoma
sintoma	sĩtomɐ
sinó	sinɔ
sipaio	sipaju
siracusa	siɾakuzɐ
sirena	siɾenɐ
siribeira	siɾibejɾɐ
siririca	siɾiɾika
sismo	sizmu
siso	sizu
sistema	sistemɐ
sistematizado	sistemat͡ʃizadu
sitar	sitaʁ
site	sajt͡ʃi
situar	situaʁ
situação	situasɐ̃w̃
skate	skejt͡ʃ
skinhead	skĩhɛd͡ʒ
slide	izlajd͡ʒi
slide	slajd
slide	slajd͡ʒ
slide	zlajd͡ʒ
smartphone	smaʁt͡ʃfoni
smartphone	smaʁt͡ʃfown
soar	soaɾ
soar	soaʁ
sob	sob
sob	sobi
sobejar	sobeʒaʁ
sobejo	sobeʒu
soberania	sobeɾɐniɐ
soberano	sobeɾɐnu
soborô	soboɾo
sobra	sɔbɾɐ
sobrancelha	sobɾɐ̃seʎa
sobrancelha	sobɾɐ̃seʎɐ
sobrar	sobɾaʁ
sobre	sobɾe
sobre	sobɾi
sobre	sɔbɾi
sobremesa	sobɾimeza
sobremesa	sobɾimezɐ
sobrenome	sobɾenomi
sobreviver	sobɾeviveʁ
sobrinha	sobɾiɲɐ
sobrinho	sobɾiɲu
socar	sokaʁ
sociabilidade	sosjabilidadʒi
social	sosiaw
social	sosjaw
socialismo	sosialismu
socialismo	sosialiʒmu
socialismo	sosjalismu
socialismo	sosjaliʒmu
socialista	sosialista
socialista	sosialistɐ
socialista	sosialiʃtɐ
socialista	sosjalista
socialista	sosjalistɐ
socialista	sosjaliʃtɐ
sociedade	sosiedade
sociedade	sosiedad͡ʒi
sociedade	sosjedade
sociedade	sosjedad͡ʒi
sociniano	sosiniɐnu
sociniano	sosinjɐnu
sociologia	sosjoloʒia
sociologia	sosjoloʒiɐ
socorro	sokoʁu
sofrer	sofɾeʁ
sofrimento	sofɾimẽtu
sogra	sɔɡɾa
sogra	sɔɡɾɐ
sol	sɔw
sol	sɔɹ
soldado	sowdadu
soldo	sowdu
soldo	sɔwdu
soleira	solejɾa
soleira	solejɾɐ
solidariedade	solidaɾiedad͡ʒi
solidariedade	solidaɾjedad͡ʒi
solidão	solidɐ̃w
sologamia	sɔloɡɐ̃mia
soltar	sowtaʁ
solteiro	sowtejɾu
solucionar	solusjonaʁ
soluço	solusu
solução	solusɐ̃w̃
som	sõ
soma	somɐ
somali	somali
sombra	sõbɾɐ
sombrinha	sõbɾiɲɐ
sombrio	sõbɾiu
sombrio	sõbɾiw
some	somi
some	sɔmi
somos	sõmus
somos	sõmuʃ
somália	somaliɐ
sonda	sõdɐ
sonha	sõɲɐ
sonhar	soɲaʁ
sonho	soɲu
sonoplastia	sonoplast͡ʃia
sonoplastia	sonoplaʃt͡ʃia
sonso	sõsu
sonzeira	sõzejɾɐ
soo	sou
sopa	sopɐ
sopesar	sopezaɾ
sopesar	sopezaʁ
soprar	sopɾaʁ
sopro	sopɾu
sopro	sɔpɾu
sopé	sopɛ
soro	soɾu
soro	sɔɾu
soror	surɔr
sorria	soʁiɐ
sorriso	soʁizu
sorriu	soʁiw
sorumbático	soɾũbat͡ʃiku
sossegado	soseɡadu
sossegado	suseɡadu
sossego	soseɡu
sossego	suseɡu
sotaina	sotajna
sotaque	sotaki
sotaque	sutaki
sou	sow
soul	sow
sousa	sowzɐ
souto	sowtu
soviético	soviɛtʃikʊ
sozinho	sɔziɲu
status	istatus
status	status
stonehenge	stownhẽd͡ʒ
stop	stɔp
stop	stɔpi
strike	istɾajki
strike	stɾajk
string	estɹĩɡi
string	estɾĩɡi
style	istajli
style	iʃtajli
style	stajli
sua	suɐ
suarabácti	swaɾabakt͡ʃi
suas	suɐs
suave	suavi
suave	swavi
suaíli	suaili
suaíli	swaili
suba	suba
suba	subɐ
subclínico	subkliniku
subdelegacia	subdeleɡasiɐ
subdivisão	subidivizɐ̃w̃
subida	subidɐ
subir	subiʁ
subjuntivo	subiʒũt͡ʃivu
subjuntivo	subʒũt͡ʃivu
sublevação	sublevasɐ̃w̃
sublime	sublimɪ
submarino	subimaɾinu
submarino	submaɾinu
submete	submɛtʃi
submeter	subimeteʁ
submeter	submeteʁ
substanciar	substɐ̃siaʁ
substanciar	substɐ̃sjaʁ
substantivo	subistɐ̃t͡ʃivu
substantivo	subiʃtɐ̃t͡ʃivu
substantivo	substɐ̃t͡ʃivu
substantivo	subʃtɐ̃t͡ʃivu
substituir	subistʃituiʁ
substituto	subist͡ʃitutu
substituto	subiʃt͡ʃitutu
substituto	subst͡ʃitutu
substituto	subʃt͡ʃitutu
substância	subistɐ̃sia
substância	subistɐ̃sja
substância	substɐ̃sia
substância	substɐ̃sja
subsídio	subsidʒju
subterfúgio	subterfuʒju
subvencionar	subivẽsɐ̃w̃
subvencionar	subvẽsɐ̃w̃
subversivo	subiveʁsivu
subversão	subiveʁsɐ̃w̃
sucatear	sukateaʁ
sucatear	sukatʃɪaʁ
suceder	susedeʁ
sucessivo	susesivu
sucesso	susɛsu
sucinto	susĩtu
suco	suko
suco	suku
sucumbir	sukũbiʁ
sudanesa	sudɐnezɐ
sudanesas	sudɐnezɐs
sudaneses	sudɐnezis
sudanês	sudɐnejs
sudeste	sudɛst͡ʃi
sudeste	sudɛʃt͡ʃi
sudestino	sudest͡ʃinu
sueco	suɛku
sueco	swɛku
suficiente	sufisiẽtʃi
suficientes	sufisjẽt͡ʃis
suflê	sufle
sugerir	suʒeɾiʁ
sugestivo	suʒest͡ʃivu
sugestivo	suʒeʃt͡ʃivu
sugestivos	suʒest͡ʃivus
suicídio	suisid͡ʒiu
sujeira	suʒejɾa
sujeira	suʒejɾɐ
sujeito	suʒejtu
sul	suw
sulco	suwku
sulfossal	suɫfusaɫ
sumiço	sumisu
sundanesa	sũdɐnezɐ
sundanesas	sũdɐnezɐs
sundaneses	sũdɐnezis
sundanês	sũdɐnejs
superar	supeɾaʁ
superavitário	superavitarju
superciliar	supeʁsiliaʁ
superficial	supeɾfisiaw
superfície	supeʁfisi
superior	supeɾioʁ
supermercado	supeʁmeʁkadu
superpotência	supeʁpotẽsjɐ
superstição	supeʁstisɐ̃w̃
superveniência	supeɾveniẽsja
superávit	superavitʃi
supimpa	supipɐ
supimpa	supĩpɐ
supor	supoʁ
suporte	supɔɹt͡ʃi
suporte	supɔɻte
suporte	supɔʁt͡ʃi
suposição	supozisɐ̃w̃
supostamente	supostɐmẽt͡ʃi
supremo	supɾemu
suprimento	supɾimẽtu
suprir	supɾiʁ
surgido	suʁʒidu
surgir	suʁʒiʁ
suricate	suɾikat͡ʃi
suriname	suɾinɐmi
surpresa	suʁpɾezɐ
surrão	suʁɐ̃w̃
susana	suzɐnɐ
suspeitar	suspejtaʁ
sussa	susɐ
sussurro	susuʁu
sustentar	sustẽtaʁ
sustentação	sustẽtasɐ̃w̃
sutil	sut͡ʃiw
sutiã	sut͡ʃiɐ̃
sutiã	sut͡ʃjɐ̃
suábia	suabiɐ
suábia	swabjɐ
suçuarana	susuaɾɐna
suécia	suɛsjɐ
suécia	swɛsjɐ
suíça	suisɐ
suíça	swisɐ
suíço	suisu
swansea	swɐ̃si
sweep	swip
switch	swit͡ʃ
sydney	sid͡ʒnej
sábado	sabadu
sábio	sabiu
sábio	sabju
sálvia	sawvia
sálvia	sawviɐ
sálvia	sawvja
sálvia	sawvjɐ
sátira	sat͡ʃiɾa
sânscrito	sɐ̃skɾitu
sânscrito	sɐ̃ʃkɾitu
sã	sɐ̃
são	sɐ̃w̃
sé	sɛ
século	sɛkulu
sérgio	sɛʁʒju
série	sɛɾi
série	sɛɾie
série	sɛɾje
série	sɛɾji
sério	sɛɾju
sétimo	sɛt͡ʃimu
sêmen	semẽj̃
sídnei	sid͡ʒnej
sídon	sidõ
sílaba	silɐbɐ
sílfide	siwfid͡ʒi
sílvia	siwvjɐ
síndrome	sĩdɾomi
sítio	sit͡ʃiu
sítio	sit͡ʃju
só	sɔ
sóbrio	sɔbɾiu
sóbrio	sɔbɾju
sódio	sɔd͡ʒju
sódio	sɔd͡ʒu
sólon	sɔlõ
sóror	sɔrɔr
sósia	sɔzjɐ
sótão	sɔtɐ̃w
sônia	soniɐ
sônia	sonjɐ
súbita	subitɐ
súbito	subitu
súdito	sud͡ʒitu
súplica	suplikɐ
sútil	sut͡ʃiw
tabacaria	tabakaɾiɐ
tabefe	tabɛfi
tabela	tabɛlɐ
tablete	tablɛtʃi
taboa	taboɐ
taboca	tabɔka
tabua	tabuɐ
tabular	tabular
tabuleiro	tabulejɾu
tacar	takaʁ
tacha	taʃɐ
tachar	taʃaʁ
taco	taku
tadeu	tadew
tael	taɛw
taful	tafuw
tagarela	taɡɐɾɛlɐ
taipei	tajpej
tais	tajs
tais	tajʃ
taiwan	tajwɐ̃
tal	taw
talante	talɐ̃tʃi
talento	talẽtu
talhe	taʎi
talher	taʎɛɾ
talher	taʎɛʁ
talho	taʎu
talian	taljɐ̃
talmude	tawmud͡ʒi
talvez	tawvejs
tamanduá	tamɐ̃dua
tamanho	tamɐɲu
tamara	tamaɾɐ
tamara	tɐmaɾɐ
tamareira	tamaɾejɾa
tamareira	tamaɾejɾɐ
tamareira	tɐmaɾejɾa
tamareira	tɐmaɾejɾɐ
tambor	tɐ̃boʁ
tamborilar	tɐ̃borilaɾ
também	tɐmẽj̃
também	tɐ̃bẽj̃
tamos	tɐmus
tamém	tɐmẽj̃
tangerina	tɐ̃ʒiɾina
tangerina	tɐ̃ʒiɾinɐ
tangerineira	tɐ̃ʒiɾinejɾa
tangerineira	tɐ̃ʒiɾinejɾɐ
tango	tɐ̃ɡu
tangível	tɐ̃ʒivew
tanso	tɐ̃su
tanta	tɐ̃tɐ
tantas	tɐ̃tɐs
tanto	tɐ̃tu
tantos	tɐ̃tus
tantã	tɐ̃tã
tanuki	tɐnuki
tanzânia	tɐ̃zɐnia
tanzânia	tɐ̃zɐniɐ
tanzânia	tɐ̃zɐnja
tanzânia	tɐ̃zɐnjɐ
tape	tapi
tapete	tapetʃi
tapir	tapiʁ
taquara	takwaɾa
tarde	taɹd͡ʒi
tarde	taɻde
tarde	taʁd͡ʒi
tardio	taɹd͡ʒiu
tardio	taɹd͡ʒiw
tardio	taɻd͡ʒio
tardio	taɻd͡ʒiw
tardio	taʁd͡ʒiw
tareco	tarɛku
tarefa	taɾɛfɐ
taria	taɾiɐ
tarrafa	taʁafa
tarsiliano	taɾsiljɐnu
tarso	taɻso
tartu	taʁtu
tarô	taɾo
tasca	taskɐ
tascar	taskaʁ
tatiana	tat͡ʃiɐnɐ
tatiana	tat͡ʃjɐnɐ
tato	tatu
tatu	tatu
tatuagem	tatuaʒẽj̃
taurus	tawɾus
tava	tavɐ
tavam	tavɐ̃w̃
taverna	tɐvɛɾnɐ
taxa	taʃɐ
taça	tasɐ
tchau	t͡ʃaw
tcheco	t͡ʃɛku
tchecoslováquia	t͡ʃɛkozlovakiɐ
tchecoslováquia	t͡ʃɛkozlovakjɐ
tchê	t͡ʃe
te	te
te	ti
te	tɪ
te	t͡ʃi
tear	teaʁ
teatro	teatɾo
teatro	teatɾu
teatro	t͡ʃiatɾu
tebas	tɛbɐs
tecer	teseɾ
tecido	tesidu
tecla	tɛkla
tecla	tɛklɐ
tecladista	teklad͡ʒistɐ
teclado	tekladu
tecnologia	tɛkinoloʒiɐ
tecnologia	tɛknoloʒiɐ
teco	tɛku
teeteto	teetetu
teia	teja
teia	tejɐ
teixo	tejʃu
teja	teʒɐ
tejadilho	teʒad͡ʒiʎu
tela	tɛlɐ
telecomandar	tɛlekomɐ̃daʁ
teledramaturgia	tɛledɾamatuɾʒia
teledramaturgia	tɛledɾamatuʁʒia
telefonar	telefonaʁ
telefone	telefõni
televendas	tɛlevẽdɐs
televendedor	tɛlevẽdedoʁ
televisor	televizoʁ
televisão	televizɐ̃w̃
telha	teʎa
telhado	teʎadu
tem	tẽj̃
tema	temɐ
temente	temẽt͡ʃi
temer	temeʁ
temeste	temest͡ʃi
temeu	temew
tempera	tẽpɛɾa
temperamento	tẽpeɾɐmẽtu
temperatura	tẽpeɾatuɾɐ
temperatura	tẽpɛɾatuɾɐ
tempero	tẽperu
templo	tẽplu
tempo	tẽpo
tempo	tẽpu
temporada	tẽpoɾadɐ
temporal	tẽpoɾaw
temporão	tẽpoɾɐ̃w̃
tempurá	tẽpuɾa
tender	tẽdeʁ
tenente	tenẽt͡ʃi
tenho	teɲu
tenro	tẽʁu
tens	tẽj̃s
tens	tẽj̃ʃ
tenso	tẽsu
tensos	tẽsus
tensão	tẽsɐ̃w̃
tentar	tẽtaʁ
tentativa	tẽtatʃivɐ
tentação	tẽtasɐ̃w̃
tentação	tẽtɐsɐ̃w̃
tença	tẽsa
tenção	tẽsɐ̃w̃
tenência	tenẽsja
teobaldo	teobawdu
teobaldo	tewbawdu
teodoro	tewdɔɾu
teoria	teoɾiɐ
ter	teh
ter	teɹ
ter	teɻ
ter	teɾ
ter	teʁ
tera	tɛra
terabit	tɛɾabiti
terabit	tɛɾabit͡ʃi
terabyte	tɛɾabajtʃi
terceiro	teʁsejɾu
tereré	teɾeɾɛ
tererê	teɾeɾe
tergiversar	teɾʒiveɾsar
tergiversação	teɾʒiveɾsasɐ̃w̃
teria	teɾia
terminar	teʁminaʁ
termo	teɹmu
termo	teɻmo
termo	teʁmu
ternura	teɾnuɾa
terpsícore	teʁpsikoɾi
terra	tɛɦɐ
terra	tɛʁɐ
terremoto	teʁemɔtu
terreno	teʁenu
terrinha	tɛʁĩj̃ɐ
terrinha	tɛʁĩɲɐ
território	teʁitɔɾju
território	tiɦitɔɾju
território	tɛɦitɔɾju
terror	teʁoʁ
terrorista	teʁoɾistɐ
terráqueo	teʁakiu
terráqueo	teʁakju
terrível	teʁivew
terça	teʁsɐ
terço	teʁsu
terêncio	teɾẽsju
tese	tɛzi
tesoura	t͡ʃizowɾa
tesoura	t͡ʃizowɾɐ
tesouro	tezowɾu
tesouro	t͡ʃizowɾu
tessália	tesaliɐ
testa	tɛstɐ
testamento	testamẽtu
testamento	teʃtamẽtu
testar	testaʁ
teste	tɛste
teste	tɛst͡ʃi
teste	tɛʃt͡ʃi
testemunho	test͡ʃimuɲu
testemunho	teʃt͡ʃimuɲu
testosterona	testosteɾona
testosterona	testosteɾonɐ
testosterona	teʃtoʃteɾonɐ
testículo	test͡ʃikulu
teta	teta
teta	tetɐ
teta	tɛta
teta	tɛtɐ
teto	tɛtu
tetraedro	tɛtɾaɛdɾu
tetraedro	tɛtɾɐɛdɾu
tetraz	tetɾajs
teu	tew
teus	tews
teve	tevi
texas	tɛksɐs
texto	testo
texto	testu
texto	teʃtu
textura	tejʃtuɾa
textura	testuɾa
texugo	teʃuɡu
teísmo	teizmu
teórico	teɔɾiku
ti	ti
ti	t͡ʃi
tibete	t͡ʃibɛt͡ʃi
ticket	t͡ʃiket͡ʃ
tifo	t͡ʃifu
tigela	t͡ʃiʒɛlɐ
tigelinha	t͡ʃiʒɛliɲɐ
tigre	t͡ʃiɡɾi
til	tʃiw
time	t͡ʃime
time	t͡ʃimi
timidez	t͡ʃimidejʃ
tina	t͡ʃina
tingitano	tĩʒitɐnu
tinha	t͡ʃiɲa
tinha	t͡ʃiɲɐ
tinhoso	tij̃ozu
tinir	t͡ʃiniʁ
tino	t͡ʃinu
tinta	t͡ʃĩta
tinta	t͡ʃĩtɐ
tintim	t͡ʃĩt͡ʃĩ
tinto	t͡ʃĩtu
tintura	t͡ʃĩtuɾa
tintura	t͡ʃĩtuɾɐ
tio	tiw
tio	t͡ʃiw
tipicamente	t͡ʃipikɐmẽt͡ʃi
tipo	tipu
tipo	t͡ʃipo
tipo	t͡ʃipu
tira	t͡ʃiɾa
tira	t͡ʃiɾɐ
tirana	t͡ʃiɾɐnɐ
tirano	t͡ʃiɾɐnu
tirar	t͡ʃiɾaʁ
tiro	t͡ʃiɾu
tirol	t͡ʃiɾɔw
tirânico	t͡ʃiɾɐnikamẽt͡ʃi
titanic	t͡ʃitɐnik
titicaca	t͡ʃit͡ʃikakɐ
titã	t͡ʃitɐ̃
tiver	t͡ʃivɛʁ
tivesse	t͡ʃivɛsi
tivessem	t͡ʃivɛsẽj̃
toa	toɐ
tocaio	tokaju
tocam	tɔkɐ̃w̃
tocando	tokɐ̃du
tocantins	tokɐ̃tʃĩs
tocar	tokaʁ
tocha	tɔʃɐ
toda	todɐ
toda	tɔda
toda	tɔdɐ
todas	todɐs
todo	todo
todo	todu
todos	todos
todos	todus
tofu	tofu
togliatti	toʎat͡ʃi
toilette	toalɛtʃi
tolerar	toleɾaʁ
tolete	tolet͡ʃi
tolher	toʎeʁ
tolo	tolu
tolosa	tolɔzɐ
tom	tõ
tomada	tomadɐ
tomando	tomɐ̃du
tomar	tomaʁ
tomara	tomaɾa
tomate	tomate
tomate	tomat͡ʃi
tomateiro	tumatejɾu
tombar	tõbaɹ
tombar	tõbaɾ
tombar	tõbaʁ
tomás	tomas
tonel	tonɛw
tonelada	tonelada
tonelada	toneladɐ
tonfa	tõfa
tontice	tõt͡ʃisi
tonto	tõtu
tontura	tõtuɾɐ
tony	toni
top	tɔp
top	tɔpi
tope	tɔpi
topete	topɛt͡ʃi
topo	topu
topzeira	tɔpizejɾɐ
topzeira	tɔpzejɾɐ
toque	tɔki
torcida	toʁsidɐ
torcido	toʁsidu
tordo	toʁdu
torengo	toɾẽɡu
tormenta	toɾmẽtɐ
tornado	toɾnadu
tornar	toʁnaʁ
toro	tɔɾu
toronto	toɾõtu
torpe	toɾpi
torpe	tɔɾpi
torre	toʁi
torre	tɔʁi
torrente	toʁẽt͡ʃi
toscana	toskɐnɐ
tosse	tɔsi
totais	totajs
totais	totajʃ
total	totaw
totalidade	tutalidad͡ʒi
totem	tɔtẽj̃
toucinho	towsiɲu
toupeira	towpejɾa
toupeira	towpejɾɐ
touro	towɾu
toxicólogo	toksikɔloɡu
toxicólogo	tɔksikɔlɔɡu
trabalhar	tɾabaʎaʁ
trabalho	tɾabajo
trabalho	tɾabaʎo
trabalho	tɾabaʎu
trabalhoso	tɾabaʎozu
trabuco	tɾabuku
tradicional	tɾadʒisjonaw
tradicional	tɾad͡ʒisionaw
tradição	tɾadʒisɐ̃w̃
tradutor	tɾadutoʁ
traduçãozinha	tɾadusɐ̃w̃ziɲɐ
trafalgar	tɾafawɡaʁ
tragédia	tɾaʒɛd͡ʒjɐ
traição	tɾaisɐ̃w̃
traição	tɾajsɐ̃w̃
traje	tɾaʒe
traje	tɾaʒi
trajeto	tɾaʒɛtu
trajo	tɾaʒu
trama	tɾɐma
trama	tɾɐmɐ
trambicagem	tɾãbikaʒẽ
trambicar	tɾãbikaɾ
trambicar	tɾãbikaχ
trambique	tɾãbiki
trambiqueiro	tɾãbikejɾu
trampolim	tɾɐ̃polĩ
trampolim	tɾɐ̃pulĩ
tranquilinha	tɾɐ̃kwiliɲɐ
tranquilinhas	tɾɐ̃kwiliɲɐs
tranquilinho	tɾɐ̃kwiliɲu
tranquilinhos	tɾɐ̃kwiliɲus
tranquilizador	tɾɐ̃kwilizadoʁ
tranquilizadora	tɾɐ̃kwilizadoɾɐ
tranquilo	tɾɐ̃kwilu
tranquilona	tɾɐ̃kwilonɐ
tranquilonas	tɾɐ̃kwilonɐs
tranquilão	tɾɐ̃kwilɐ̃w̃
tranquilíssima	tɾɐ̃kwilisimɐ
tranquilíssimas	tɾɐ̃kwilisimɐs
tranquilíssimo	tɾɐ̃kwilisimu
tranquilíssimos	tɾɐ̃kwilisimus
tranquilões	tɾɐ̃kwilõj̃s
transa	tɾɐ̃za
transar	tɾɐ̃zaʁ
transeunte	tɾɐ̃zeũt͡ʃi
transeuntes	tɾɐ̃zeũt͡ʃis
transferir	tɾɐ̃sfeɾiʁ
transferência	tɾɐ̃sfeɾẽsjɐ
transfiguro	trãsfiɡuɾu
transitar	tɾɐ̃zitaʁ
transitividade	tɾɐ̃zit͡ʃividad͡ʒi
transitivo	tɾɐ̃zit͡ʃivu
transitório	tɾɐ̃zitɔɾiu
transitório	tɾɐ̃zitɔɾju
transição	tɾɐ̃zisɐ̃w̃
transições	tɾɐ̃zisõj̃s
transições	tɾɐ̃zisõj̃ʃ
transliteração	tɾɐ̃sliteɾasɐ̃w̃
transmitir	tɾɐ̃smitʃiɹ
transmitir	tɾɐ̃smitʃiɻ
transmitir	tɾɐ̃smitʃiʁ
transmitir	tɾɐ̃ʃmitiχ
transmitir	tɾɐ̃ʒmitʃiχ
transpassado	tɾɐ̃spasadu
transplantar	tɾɐ̃splɐ̃taʁ
transporte	tɾɐ̃spɔʁtʃi
transvaal	tɾɐ̃zvaaw
transvaal	tɾɐ̃zvaw
transversais	trɐ̃zveʁsajs
transversal	trɐ̃zveʁsaw
trança	tɾɐ̃sa
trançar	tɾɐ̃saʁ
trapalhada	tɾapaʎadɐ
trapaça	tɾapasɐ
trapo	tɾapu
traqueia	tɾakeja
traqueia	tɾakejɐ
traqueia	tɾakɛja
traqueia	tɾakɛjɐ
traquejar	tɾakeʒaɹ
traquejar	tɾakeʒaχ
traquejo	tɾakeʒu
trata	tɾatɐ
tratado	tɾatadu
tratamento	tɾatɐmẽtu
tratar	tɾataʁ
trato	tɾatu
trave	tɾavi
traveco	tɾavɛku
travessa	tɾavɛsa
travessa	tɾavɛsɐ
travesseiro	tɾavesejɾu
travessia	tɾavesia
travessia	tɾavesiɐ
travesso	tɾavesu
travesso	tɾavɛsu
travão	tɾavɐ̃w̃
trazer	tɾazeʁ
traça	tɾasa
traça	tɾasɐ
traço	tɾasu
traíra	tɾaiɾɐ
trecho	tɾeʃu
treco	tɾɛku
treinamento	tɾejnɐmẽtu
treinar	tɾejnaʁ
trem	tɾẽj̃
trema	tɾemɐ
trema	tɾɛmɐ
tremedeira	tɾemedejɾa
tremura	tɾemuɾa
trena	tɾenɐ
treno	tɾenu
trenó	tɾenɔ
trepadeira	tɾepadejɾɐ
trepação	tɾepasɐ̃w̃
trete	tɾɛtʃi
treva	tɾɛvɐ
trevas	tɾɛvɐs
trevisan	tɾevizɐ̃
trevo	tɾevu
treze	tɾezi
trezentos	tɾezẽtus
tri	tɾi
triangular	tɾiɐ̃ɡulaɾ
tribal	tɾibaw
tribo	tɾibu
tribunal	tɾibunaw
tricô	tɾiko
trieste	tɾiɛst͡ʃi
trigo	tɾiɡu
trigésimo	tɾiʒɛzimu
trilhão	tɾiʎɐ̃w̃
trimestral	tɾimestɾaw
trimestre	tɾimɛstɾi
trimestre	tɾimɛʃtɾi
trincar	tɾĩkaʁ
trindade	tɾĩdad͡ʒi
trinta	tɾĩtɐ
tripa	tɾipɐ
trisavó	tɾizavɔ
trisavô	tɾizavo
triste	tɾiste
triste	tɾistʃi
triste	tɾiʃti
triste	tɾiʃtʃi
tristeza	tɾistezɐ
tristeza	tɾiʃtezɐ
tritura	tɾituɾa
trituradora	tɾituɾadoɾɐ
trituro	tɾituɾu
triunfal	tɾiũfaw
triunfo	tɾiũfu
trivial	tɾiviaw
trivialidade	trivialidadʒi
troar	tɾoaɾ
troca	tɾɔkɐ
trocadilho	tɾokad͡ʒiʎu
trocado	tɾokadu
trocar	tɾokaʁ
troco	tɾoku
troco	tɾɔku
trololó	tɾololɔ
trololó	tɾɔlɔlɔ
trom	tɾõ
tromba	tɾõbɐ
trombeta	tɾõbetɐ
tronco	tɾõku
trono	tɾonu
tropa	tɾɔpɐ
tropical	tɾopikaw
trotskismo	tɾɔtskismu
trotskismo	tɾɔtʃkiʃmu
trouxe	tɾose
trouxe	tɾowse
trouxe	tɾowsi
trova	trɔvɐ
trovar	truvar
trovoar	tɾovoaɾ
trovão	tɾovɐ̃w̃
trufa	tɾufɐ
truta	tɾuta
truta	tɾutɐ
tráfego	tɾafeɡu
tráfico	tɾafiku
trágico	traʒiku
trás	tɾajs
trânsito	tɾɐ̃zitu
trégua	tɾɛɡwɐ
três	tɾejs
tríplex	tɾipleks
tríptico	tɾipt͡ʃiku
trítio	tɾit͡ʃiu
trítio	tɾit͡ʃju
tu	tu
tua	tuɐ
tuas	tuɐs
tubarão	tubaɾɐ̃w̃
tucano	tukɐnu
tucuxi	tukuʃi
tucídides	tusid͡ʒid͡ʒis
tudo	tudo
tudo	tudu
tufo	tufu
tufão	tufɐ̃w̃
tuiuiú	tujuju
tule	tuli
tulipa	tulipɐ
tumefação	tumefasɐ̃w̃
tumor	tumoʁ
tundra	tũdɾɐ
tupi	tupi
tupiniquim	tupinikĩ
tupperware	tapuɛʁ
tupperware	tapɐwɛʁ
tupperware	tejpuɛʁ
tupperware	tɐpɐwɛʁ
turbulento	tuʁbulẽtu
turismo	tuɾismu
turismo	tuɾiʃmu
turma	tuʁmɐ
turno	tuʁnu
turquia	tuʁkiɐ
turu	tuɾu
turíbulo	tuɾibulu
tussa	tusɐ
tutela	tutɛlɐ
tá	ta
tábua	tabuɐ
tábua	tabwɐ
tácito	tasitu
tágide	taʒid͡ʒi
tálus	talus
tárraco	taʁaku
tática	tat͡ʃika
tática	tat͡ʃikɐ
tático	tat͡ʃiku
tâmara	tɐmaɾa
tâmara	tɐmaɾɐ
tântalo	tɐ̃talu
tão	tɐ̃w̃
técnica	tɛkinikɐ
técnica	tɛknikɐ
técnico	tɛkniku
tédio	tɛd͡ʒiu
tédio	tɛd͡ʒju
térmica	tɛʁmikɐ
térmicas	tɛʁmikɐs
término	tɛʁminu
tétrico	tɛtɾiku
tê	te
têm	tẽj̃
têmpora	tẽpoɾɐ
tênis	tenis
tênis	teniʃ
têxtil	tejst͡ʃiw
tíbia	t͡ʃibiɐ
tíbia	t͡ʃibjɐ
tímido	tĩmidʊ
tímido	t͡ʃimidu
tímpano	t͡ʃĩpɐnu
tímpanos	t͡ʃĩpɐnus
típico	t͡ʃipiku
tísica	t͡ʃizikɐ
tísico	t͡ʃiziku
título	t͡ʃitulo
título	t͡ʃitulu
tó	tɔ
tórax	tɔɾaks
tóxico	tɔksiku
túlipa	tulipɐ
túmulo	tumulu
túnel	tunɛw
u	u
uai	uaj
uapiti	wapit͡ʃi
uau	uaw
uau	waw
uberrimamente	ubɛʁimɐmẽt͡ʃi
ubicação	ubikasɐ̃w̃
ubre	ubɾi
ubá	uba
ubérrimo	ubɛʁimu
ubíquo	ubikwu
ucraniano	ukɾɐniɐnu
ucraniano	ukɾɐnjɐnu
ucrânia	ukɾɐnjɐ
ufa	ufɐ
ufo	ufo
uganda	uɡɐ̃dɐ
uhul	uʁuw
uirapuru	ujɾapuɾu
uivo	ujvu
ula	ulɐ
ulna	uwna
ulterior	uwteɾioʁ
ultimato	uwt͡ʃimatu
ultrapassado	uwtɾapasadu
ultraterreno	uwtɾateʁenu
ultravioleta	uwtɾavioleta
ultravioleta	uwtɾavjoleta
ultravioleta	uwtɾɐvioletɐ
ultravioleta	uwtɾɐvjoletɐ
um	ũ
uma	umɐ
uma	ũɐ
umas	umɐs
umbigada	ũbiɡadɐ
umbigo	ũbiɡu
umbrais	ũbɾajs
umbral	ũbɾaw
underline	ɐ̃deɾlajni
undécimo	ũdɛsimu
unha	uɲɐ
unhar	uɲaɾ
unicamente	unikamẽti
unidade	unidad͡ʒi
unido	unidu
unificação	unifikasɐ̃w̃
unilateral	unilateɾaw
unilateralismo	unilateɾalijʃmu
unilateralismo	unilateɾalismu
universidade	univeʁsidad͡ʒi
universidades	universidadʒis
universitária	univeʁsitaɾjɐ
união	uniɐ̃w̃
uno	unu
uns	ũs
untar	ũtaɹ
untar	ũtaɻ
untar	ũtaɾ
untar	ũtaʁ
unto	ũtu
ununséptio	unũsɛpt͡ʃiu
ununséptio	unũsɛpt͡ʃju
ununóctio	ununɔt͡ʃiu
ununóctio	ununɔt͡ʃju
unção	ũsɐ̃w̃
uníssono	unisonu
upar	upaʁ
update	upideit͡ʃi
update	ɐpideit͡ʃi
upgrade	upiɡɾeid͡ʒi
upgrade	ɐpiɡɾeid͡ʒi
uppsala	upsalɐ
urano	uɾɐnu
urbanizar	uʁbɐnizaʁ
urbano	uʁbɐnu
urdir	uɾd͡ʒiɾ
urna	uʁnɐ
uro	uɾu
urrar	uʁaɾ
urrar	uʁaχ
urro	uʁu
urso	uɾsu
urso	uχsu
urubiciense	uɾubisiẽsi
urucum	uɾukũ
uruguai	uɾuɡwaj
uruguaio	uɾuɡwaju
urupemense	uɾupemẽsi
urutau	uɾutaw
urze	uʁzi
usar	uzaʁ
username	juzeʁnejm
username	juzeʁnejmi
usina	uzina
usina	uzinɐ
uso	uzu
usso	usu
ustulação	ustulasɐ̃w̃
usual	uzuaw
usufruto	uzufɾutu
usura	uzuɾa
usuário	uzuaɾiu
usuário	uzuaɾju
usável	uzavew
utah	juta
utilidade	ut͡ʃilidade
utilidade	ut͡ʃilidad͡ʒi
utilizar	ut͡ʃilizaʁ
utilização	ut͡ʃilizasɐ̃w̃
utópico	utɔpiku
uva	uva
uva	uvɐ
uzbeque	uzbɛki
uzbeque	uʒbɛki
ué	uɛ
ué	wɛ
uísque	wiski
uísque	wiʃki
vaca	vakɐ
vacante	vɐkɐ̃t͡ʃi
vacilar	vasilaɾ
vacuidade	vakuidad͡ʒi
vadoso	vadozu
vagabundagem	vaɡabũdaʒẽj̃
vagabundo	vaɡabũdu
vagante	vɐɡɐ̃t͡ʃi
vagem	vaʒẽj̃
vago	vaɡu
vai	vaj
vaivém	vajvẽj̃
vaivéns	vajvẽj̃s
valado	valadu
valdemar	vawdemaʁ
vale	vali
valente	valẽt͡ʃi
valentim	valẽt͡ʃĩ
valentino	valẽt͡ʃinu
valentão	valẽtɐ̃w̃
valer	valeʁ
valete	valɛt͡ʃi
valeu	valew
valhalla	vawʁalɐ
valhalla	vaʎalɐ
valia	valiɐ
valo	valu
valor	valoɹ
valor	valoɻ
valor	valoɾ
valor	valoʁ
valorização	valoɾizasɐ̃w̃
valáquio	valakju
valão	valɐ̃w̃
vamos	vɐmu
vamos	vɐmus
vamos	vɐmuʃ
vampiro	vɐ̃piɾu
vancouver	vɐ̃kuveʁ
vanderlei	vɐ̃deʁlej
vanglória	vɐ̃ɡlɔɾia
vanglória	vɐ̃ɡlɔɾiɐ
vanglória	vɐ̃ɡlɔɾja
vanglória	vɐ̃ɡlɔɾjɐ
vantagem	vɐ̃taʒẽj̃
vantajoso	vɐ̃taʒozu
vaqueiro	vakejɾu
vara	vaɾɐ
varanda	vaɾɐ̃dɐ
varapau	vaɾapaw
vareja	vaɾeʒɐ
varejista	vaɾeʒista
varejista	vaɾeʒistɐ
varejista	vaɾeʒiʃtɐ
variar	vaɾiaʁ
variedade	vaɾjedade
variedade	vaɾjedad͡ʒi
variedade	vaɾjɛdadɪ
varonis	vaɾonis
vaso	vazu
vassalo	vasalu
vassili	vasili
vassoura	vasowɾɐ
vastidão	vast͡ʃidɐ̃w̃
vastidão	vaʃt͡ʃidɐ̃w̃
vasto	vastu
vasão	vazɐ̃w̃
vatapá	vatapa
vau	vaw
vazamento	vazɐmẽtu
vazia	vaziɐ
vazio	vaziw
vazão	vazɐ̃w̃
veado	veadu
veado	viadu
vedor	vedoʁ
veem	veẽj̃
vegano	veɡɐ̃nu
vegetal	veʒetaw
vegete	veʒɛtʃi
veia	veja
veia	vejɐ
veio	veju
veio	vɛju
veios	vejus
veja	veʒa
veja	veʒɐ
vejo	veʒo
vejo	veʒu
vela	vɛla
vela	vɛlɐ
velar	velaʁ
velcro	vɛwkru
veleiro	vilejɾu
velhaco	veʎaku
velho	vɛjʊ
velho	vɛʎu
velhos	vɛʎus
velhos	vɛʎuʃ
velhota	veʎɔtɐ
velhota	vɛʎɔtɐ
velocidade	velosidad͡ʒi
velocidades	velosidad͡ʒis
veludo	veludu
vem	vẽj̃
vencelho	vẽseʎu
vencer	vẽsex
vencer	vẽseʁ
vencido	vẽsidu
vencilho	vẽsiʎu
venda	vẽdɐ
vendas	vẽdɐs
vender	vẽdeʁ
vendável	vẽdavew
veneno	venenu
venera	venɛɾa
venerável	veneɾavew
venha	vẽɲɐ
venham	vẽɲɐ̃w̃
venho	vej̃u
venial	veniaw
venoso	venozu
ventar	vẽtaɾ
vento	vẽtu
ventre	vẽtɾi
ventura	vẽtuɾɐ
ventã	vẽtɐ̃
ver	veh
ver	veɹ
ver	veɻ
ver	veʁ
verbasco	veʁbasku
verbo	vɛɹbu
verbo	vɛʁbu
verborragia	vɛɹboʁaʒia
verborreia	vɛɹboʁɛja
verbosamente	vɛʁbozɐmẽt͡ʃi
verboso	veʁbozu
verdade	veɦdad͡ʒi
verdade	veɹdadi
verdade	veɹdad͡ʒi
verdade	veɾdade
verdade	veʁdadʒi
verdade	vɛxdadi
verdadeiramente	veʁdadejɾamẽt͡ʃi
verdadeiro	veɹdadejɾu
verdadeiro	veɻdadejɾo
verdadeiro	veɾdadejɾo
verdadeiro	veɾdadejɾu
verdadeiro	veʁdadejɾu
verdura	veɹduɾa
verdura	veɹduɾɐ
verdura	veɻduɾa
verdura	veʁduɾɐ
vereador	veɾjadoʁ
verear	veɾeaʁ
verear	veɾjaʁ
vergastada	veʁɡastadɐ
verificar	veɾifikaʁ
vermelho	vexmeʎʊ
vermelho	veɦmeʎʊ
vermelho	veɹmeʎʊ
vermelho	veɻmejo
vermelho	veɻmeʎo
vermelho	veʁmeʎu
verona	veɾonɐ
versão	veʁsɐ̃w̃
versúcia	veɹsusja
versúcia	veχsusja
vertical	veʁtʃikaw
verás	veɾas
verão	veɾɐ̃w̃
vespeiro	vespejɾu
vespeiro	veʃpejɾu
vestibular	vest͡ʃibulaʁ
vestido	vest͡ʃido
vestido	vest͡ʃidu
vestimenta	vest͡ʃimẽtɐ
vestir	vest͡ʃiʁ
vestir	vist͡ʃiʁ
vestuário	vestuaɾiu
vestuário	vestuaɾju
vestuário	veʃtuaɾiu
vestuário	veʃtuaɾju
vesícula	vizikula
vesúvio	vezuvio
vesúvio	vezuviu
vesúvio	vezuvjo
vesúvio	vezuvju
vetar	vetaʁ
vete	vɛtʃi
veterinário	veteɾinariu
veterinário	veteɾinarju
veto	vɛtu
vexame	veʃɐmi
vez	vejs
vezes	vezis
vi	vi
via	viɐ
viagem	viaʒẽj̃
viajado	viaʒadʊ
viajar	viaʒaʁ
viajar	vjaʒaʁ
viandante	vjɐ̃dɐ̃t͡ʃi
viatura	viatuɾɐ
vibrante	vibɾɐ̃ntʃi
victor	viktoʁ
vida	vidɐ
vide	vidi
vide	vid͡ʒi
videira	videjɾa
videira	videjɾɐ
vidente	vidẽt͡ʃi
vidrar	vidɾaʁ
vidraça	vidɾasa
vidraça	vidɾasɐ
vidro	vidɾu
vidrão	vidɾɐ̃w̃
vieira	viejɾa
vieira	viejɾɐ
viela	viɛla
viela	viɛlɐ
vietname	viɛtnɐ̃
vietname	viɛt͡ʃinɐ̃
vietname	viɛt͡ʃnɐ̃
vietname	vjɛtnɐ̃
vietname	vjɛt͡ʃinɐ̃
vietname	vjɛt͡ʃnɐ̃
view	viw
vigente	viʒẽt͡ʃi
vigilância	viʒilɐ̃siɐ
vigo	viɡu
vigor	viɡoʁ
vigoroso	viɡoɾozu
vigésimo	viʒɛzimu
vih	veiɐɡa
viking	vikĩ
viking	vikĩɡi
vil	viw
vila	vilɐ
vilancico	vilɐ̃siku
vilhancico	viʎɐ̃siku
vilipendiar	vilipẽd͡ʒiaʁ
vilão	vilɐ̃w̃
vim	vĩ
vinagreira	vinaɡɾejɾɐ
vinagrete	vinaɡɾɛtʃi
vincilho	vĩseʎu
vindimar	vĩd͡ʒimaʁ
vindos	vĩdus
vindouro	vĩdowɾu
vingança	vĩɡɐ̃sa
vingança	vĩɡɐ̃sɐ
vinho	viɲu
vinicultura	vinikuwtuɾɐ
vinte	vĩt͡ʃi
viola	viɔlɐ
violação	violasɐ̃w̃
violação	vjolasɐ̃w̃
violentamente	vjolẽtɐmẽt͡ʃi
violento	violẽtu
violento	vjolẽtu
violeta	violetɐ
violeta	vjoletɐ
violinista	vjuliniʃtɐ
violoncelo	violõsɛlu
violoncelo	vjolõsɛlu
violão	violãw
violência	violẽsjɐ
vir	viʁ
vira	viɾɐ
viral	viɾaw
virar	viɾaʁ
vires	viɾis
virgem	viɦʒẽj̃
virgem	viɹʒẽj̃
virgem	viɾʒẽj̃
virgem	viʁʒẽj̃
virgindade	viɦʒĩdadɪ
virgindade	viɹʒĩdad͡ʒi
virgindade	viɾʒĩdad͡ʒi
virgindade	viʁʒĩdad͡ʒi
viril	viɾiw
virilha	viɾiʎɐ
virtuais	viʁtuajs
virtual	viʁtuaw
virtual	viʁtwaw
virtuosos	viʁtuɔzus
visar	vizaʁ
visconde	viskõd͡ʒi
viscondessa	viskõdesɐ
visita	vizitɐ
visitar	vizitaʁ
vislumbre	vizlũbɾi
vista	vistɐ
visto	vistu
visto	viʃtu
vistoso	vijʃtozu
vistoso	vistozu
visual	vizuaw
visualizar	vizwalizaʁ
visão	vizɐ̃w̃
vital	vitaw
vitamina	vitaminɐ
viticultura	vit͡ʃikuwtuɾɐ
vitimismo	vitimiʃmu
vitimismo	vitʃimizmu
vitivinicultura	vinivit͡ʃikuwtuɾɐ
vitral	vitɾaw
vitrificar	vitɾifikaʁ
vitória	vitɔɾjɐ
viu	viw
vivar	vivaʁ
vivenciar	vivẽsiaʁ
vivenda	vivẽda
vivenda	vivẽdɐ
viver	viveʁ
vivo	vivo
vivo	vivu
vivência	vivẽsjɐ
vizinhança	viziɲɐ̃sa
vizinhança	viziɲɐ̃sɐ
vizinho	viziɲu
viço	visu
viçoso	visozu
viúva	viuva
viúva	viuvɐ
voadora	voadoɾɐ
voadora	vuadoɾɐ
voadora	vwadoɾɐ
voar	voaʁ
vocabulário	vokabulaɾju
você	se
você	vose
vocês	sejs
vocês	vosejs
vocês	vosejʃ
vogar	voɡaʁ
volapuque	volapuki
voleibol	volejbɔw
volga	vɔwɡɐ
volta	vɔwta
volta	vɔwtɐ
voltar	vowtaʁ
volteio	vowteju
volume	volumi
volume	vɔlum
volume	vɔlumɪ
volumoso	vulumozu
voluntário	volũtaɾiu
voluntário	volũtaɾju
voluntário	vulũtaɾiu
voluntário	vulũtaɾju
volátil	volat͡ʃiw
vontade	võtadʒi
voo	vou
voo	vow
voragem	voɾaʒẽj̃
voraz	voɾajs
vorazes	voɾazis
vos	vus
vossa	vɔsɐ
vossas	vɔsɐs
vosso	vɔsu
vossos	vɔsus
votante	votɐ̃t͡ʃi
votar	votaʁ
vote	vɔt͡ʃi
voto	vɔtu
vou	vow
vovó	vovɔ
vovô	vovo
voz	vɔjs
vozear	voziaɾ
vozes	vɔziʃ
voçoroca	vosoɾɔka
vukovar	vukovaʁ
vulcanismo	vuwkɐnizmu
vulgarmente	vuwɡaʁmẽt͡ʃi
vulgo	vuwɡu
vulnerar	vuwniɾaʁ
vulto	vuwtu
vuvuzela	vuvuzɛla
vá	va
vácuo	vakuo
vácuo	vakwo
válido	validu
válvula	vawvula
válvula	vawvulɐ
vário	vaɾju
vários	vaɾjus
vândalo	vɐ̃dalu
vã	vɐ̃
vão	vɐ̃w̃
véi	vɛj
véio	vɛjʊ
vénus	vẽnus
vértice	vɛʁt͡ʃisi
véspera	vɛspeɾɐ
véu	vɛw
vê	ve
vêm	vẽj̃
vês	ves
víbora	viboɾa
vídeo	vid͡ʒiw
vídeo	vid͡ʒju
vínico	viniku
vívido	vividu
vós	vɔjs
vós	vɔjʃ
vós	vɔs
vós	vɔʃ
vômito	vomitu
w	v
wan	wɐ̃
washington	wɔʃĩtõ
webnamorada	wɛbinamoɾada
webnamorado	wɛbinamoɾadu
webnamorar	wɛbinamoɾaɾ
webnamorar	wɛbinamoɾaχ
webnamoro	wɛbinamoɾu
wellington	wɛlĩtõ
wikcionário	wiksjonaɾju
wikipédia	wikipɛd͡ʒjɐ
wisconsin	viskõsĩ
wisconsin	wiskõsĩ
wolf	vowf
wolfgang	volfɡɐ̃ɡ
wolfgang	vowfɡɐ̃ɡ
workshop	woʁkʃɔp
workshop	woʁkʃɔpi
workstation	woʁkstejʃõ
worm	woʁmi
wyoming	wajomĩ
x	ʃis
xadrez	ʃadɾejs
xaile	ʃajli
xampu	ʃɐ̃pu
xamã	ʃamɐ̃
xana	ʃɐna
xana	ʃɐnɐ
xangai	ʃɐ̃ɡaj
xavasca	ʃavaska
xavasca	ʃavaskɐ
xavasca	ʃavaʃkɐ
xavecar	ʃavekaɾ
xavecar	ʃavekaʁ
xaveco	ʃavɛku
xavier	ʃaviɛʁ
xelim	ʃelĩ
xeque	ʃɛki
xereca	ʃeɾɛka
xerocar	ʃeɾokaʁ
xerox	ʃeɾɔkis
xerófilo	ʃeɾɔfilu
xiismo	ʃiizmu
xiita	ʃiita
xiita	ʃiitɐ
xilindró	ʃilĩdɾɔ
xingamento	ʃĩɡɐmẽtu
xingar	ʃĩɡaɾ
xis	ʃis
xis	ʃiʃ
xote	ʃɔt͡ʃi
xoxota	ʃoʃɔtɐ
xurumbambo	ʃuɾũbɐ̃bu
xá	ʃa
xícara	ʃikaɾa
yakisoba	jakisobɐ
yorkshire	jɔʁkiʃajɾi
yorkshire	jɔʁkʃajeʁ
youtube	jutub
youtube	jutubi
yukon	jukõ
yunnan	junɐ̃
zabaione	zabajoni
zagal	zaɡaw
zagreb	zaɡɾɛb
zagreb	zaɡɾɛbi
zagueiro	zaɡejɾu
zangado	zɐ̃ɡadu
zangão	zɐ̃ɡɐ̃w̃
zebra	zebɾa
zebra	zebɾɐ
zebro	zebɾu
zebu	zebu
zelador	zeladoʁ
zelda	zɛwdɐ
zelha	zeʎɐ
zelo	zelu
zelo	zɛlu
zeloso	zelozu
zepelim	zepelĩ
zero	zɛɾu
zeugma	zewɡimɐ
zeus	zews
zigoma	ziɡoma
zigoto	ziɡotu
zigoto	ziɡɔtu
zilhão	ziʎɐ̃w̃
zimbabué	zĩbabuɛ
zincografia	zĩkoɡɾafia
zodiacal	zod͡ʒiakaw
zodíaco	zod͡ʒiaku
zona	zõnɐ
zoneamento	zoniɐmẽtu
zoo	zou
zoo	zow
zoofilia	zoofiliɐ
zoologia	zooloʒiɐ
zoológico	zolɔʒiku
zoológico	zoolɔʒiku
zoom	zũ
zootecnia	zootɛkniɐ
zoólogo	zoɔloɡu
zulu	zulu
zumbi	zũbi
zumbido	zũbidu
zumbir	zũbiʁ
zurrapa	zuʁapɐ
zâmbia	zɐ̃bjɐ
zângão	zɐ̃ɡɐ̃w̃
zé	zɛ
zéfiro	zɛfiɾu
zénite	zenit͡ʃi
zê	ze
à	a
àquela	akɛlɐ
àquelas	akɛlas
àquelas	akɛlɐs
àquelas	akɛlɐʃ
àquele	akeli
àqueles	akelis
àqueles	akeliʃ
àquilo	akilu
às	as
á	a
ábaco	abako
ábaco	abaku
ácido	asidu
ádito	ad͡ʒitu
ágrafo	aɡɾafu
água	aɡwɐ
águia	aɡia
águia	aɡiɐ
águia	aɡja
águia	aɡjɐ
álamo	alamu
álamo	alɐmu
álbum	awbũ
álcool	awkow
álcool	awkoɔw
álcool	awkɔw
álibi	alibi
árabe	aɾabi
árbitro	aʁbitɾu
área	aɾjɐ
árido	aɾidu
árvore	aɦvoɾi
árvore	aɦvuɾi
árvore	aɹvoɾi
árvore	aʁvoɾi
ás	ajs
ásia	azjɐ
átomo	atomu
átrio	atɾju
áudio	awd͡ʒju
áureo	awɾiu
áustria	awstɾiɐ
áustria	awstɾjɐ
áxis	akisis
áxis	aksis
â	ɐ
â	ɐ̃
âmago	ɐmaɡu
âmago	ɐmɐɡu
âmbito	ɐ̃bitu
âncora	ɐ̃koɾa
âncora	ɐ̃koɾɐ
ânfora	ɐ̃foɾa
ânfora	ɐ̃foɾɐ
ângela	ɐ̃ʒelɐ
ângelo	ɐ̃ʒelu
ângulo	ɐ̃ɡulu
ânimo	ɐnimu
ânus	ɐnus
ânus	ɐnuʃ
ã	ɐ̃
ç	s
é	ɛ
éfeso	ɛfezu
égua	ɛɡwɐ
época	ɛpukɐ
érica	ɛɾikɐ
éris	ɛɾis
és	ɛs
ésquilo	ɛskilu
ética	ɛt͡ʃikɐ
étimo	ɛt͡ʃimu
étnico	ɛtniku
étnico	ɛt͡ʃiniku
étnico	ɛt͡ʃniku
éxon	ɛksõ
éxons	ɛksõs
ênclise	ẽklizi
ênfase	ẽfɐzi
êxito	ezitu
êxodo	ezodu
êxodo	ezudu
ícone	ikoni
íeis	iejs
ímpeto	ĩpetu
ímprobo	ĩpɾobu
índia	ĩd͡ʒjɐ
índice	ĩdʒisi
índio	ĩd͡ʒjo
índio	ĩd͡ʒo
íntimo	ĩt͡ʃimu
íon	iõ
ípsilon	ipsilõ
íris	iɾis
íris	iɾiʃ
ístria	istɾiɐ
ó	ɔ
óbito	ɔbitu
óbolo	ɔbolu
óbvio	ɔbivju
óbvio	ɔbvju
óculos	ɔklus
óculos	ɔkulus
ódio	ɔdju
óleo	ɔljo
óleo	ɔlju
óleo	ɔʎo
óleo	ɔʎu
óliver	ɔliveʁ
ónix	oniks
óptico	ɔpt͡ʃiku
órbita	ɔʁbitɐ
ósseo	ɔseu
ósseo	ɔsiu
ótico	ɔt͡ʃiku
ótimo	ɔt͡ʃimo
ótimo	ɔt͡ʃimu
óvni	ɔvini
óvni	ɔvni
óvulo	ɔvulu
óxido	ɔksidu
ô	o
ônibus	onibus
õ	õ
ú	u
úlcera	uwseɾa
úlcera	uwseɾɐ
última	uwtʃimɐ
último	uwt͡ʃimu
úmido	umidu
único	uniku
úrsula	uʁsulɐ
útil	utiɫ
útil	ut͡ʃiw
ü	i
ü	w
