جي	ɟˈeː
جو	ɟˈoː
آهي	ˌaːheː
کي	kʰˈeː
تي	t̪ˈeː
کان	kʰˈãː
سان	sˈãː
ان	ˈɪna
ته	t̪ˈʌh
هن	hˈɪna
آهن	ˈaːhɪn
به	bˈɪ
ڪري	kˈareː
هو	hˈoː
جا	ɟˈaː
ٿي	tʰi
هڪ	hˈɪkʊ
مان	mˈaːn
آھي	ˌaːheː
ٿو	tʰˈoː
ڪيو	kˈajoː
يا	jˈaː
جنهن	ɟˈẽhɪ̃
سندس	səndˈʌs
ويو	ʋˈajoː
سنڌ	sˈɪndh
نه	nˈʌh
پر	pˈʌr
واري	ʋˈaːri
ئي	ˈiː
پنهنجي	pˈʌ̃hnɟi
ڪئي	kˈʌi
ھن	hˈɪna
ڪرڻ	kərˈʌɳ
پڻ	pˈɪɳ
وقت	ʋˈaqt
ٿيو	tʰjˈoː
ڪتاب	kɪtˈaːb
جيڪو	ɟˈeːkoː
تائين	t̪aːˈiːn
ٿا	tʰˈaː
ھڪ	hˈɪkʊ
اهو	ˈɪhoː
هي	hˈiː
محمد	mˌəhəmˈʌd
انهن	ˌanəhˈʌn
نالو	nˈaːloː
سنڌي	sˈɪndhi
جن	ɟˈɪn
وڃي	ʋˈʌɲi
جون	ɟˈoːn
ويندو	ʋˈeːndoː
طور	tˈoːr
هئا	hˈʊaː
آھن	ˈaːhɪn
هئي	hˈʊi
ڪم	kˈʌm
خان	xˈaːn
شهر	ʃəhˈʌr
جڏهن	ɟaɖˈẽhɪ̃
ملڪ	mˈʊlk
جنھن	ɟˈʌnhn
سال	sˈaːl
شامل	ʃˈaːmɪl
پاڻ	pˈaːɳ
کيس	kʰˈeːs
ڳوٺ	ɡˈoːʈʰ
ٿئي	tʰˈɪeː
تہ	t̪ˈʌh
نالي	nˈaːli
اچي	ˈaci
رهيو	rˈʌhjoː
ڪنهن	kˈʌ̃hɪ̃
جيڪي	ɟˈeːki
وڏو	ʋˈʌɖoː
حاصل	haːʂˈʌl
وڏي	ʋˈʌɖi
پاڪستان	pˌaːkˈɪstaːn
ٻين	bˈɪan
بہ	bˈɪ
مشهور	mˌəʃhˈuːr
دنيا	dˈʌnjaː
شروع	ʃˈʊruː
سڀ	sˈʌbʰ
شاهه	ʃaːhˈʌh
وارو	ʋˈaːroː
شھر	ʃəhˈʌr
گڏ	ɡˈʌɖ
صاحب	ʂaːhˈʌb
علي	ˈali
واقع	ʋˈaːqeː
جيڪا	ɟˈeːkaː
استعمال	ɪstˈeːmaːl
وڌيڪ	ʋədʰˈiːk
ٿيندو	tʰˈĩːdoː
موجود	moːɟˈuːd
مختلف	mʊxtˈalɪf
عام	ˈaːm
بعد	bˈaːd
ماڻهو	mˈaːɳhuː
ھي	hˈeː
ڏينهن	ɖˈĩːhʊ̃
وئي	ʋˈʌi
قسم	qəsˈʌm
حڪومت	hˌəkoːmˈʌt̪
طرح	tˌərˈah
تعليم	t̪aːlˈiːm
پيدا	pˈeːdaː
قائم	qaːˈɪm
دور	dˈoːr
اها	ˈɪhaː
هر	hˈʌr
ڪيائين	kjaːˈiːn
تاريخ	t̪aːrˈiːx
تمام	t̪əmˈaːm
لفظ	lˈafʐa
اهي	ˈɪheː
ويا	ʋˈajaː
ٻئي	bˈʌi
هوندو	hˈũːdoː
ٿيڻ	tʰˈɪaɳ
ڪن	kˈʌn
ھو	hˈoː
اسان	ˈasãː
خاص	xˈaːʂ
ڏنو	ɖˈɪnoː
جيئن	ɟˈiːʌ̃
وچ	ʋˈʌc
وري	ʋˈʌri
ماڻهن	mˌaːɳəhˈʌn
آباد	aːbˈaːd
ڪندو	kˈʌndoː
ضلعي	zəlˈaːi
جتي	ɟˈʌt̪i
سبب	səbˈʌb
ڪو	kˈoː
مطابق	mˌətaːbˈʌq
سندن	səndˈʌn
ٽي	ʈˈeː
آيو	ˈaːjoː
ٻه	bˈʌh
ڪي	kˈeː
ڪندا	kˈʌndaː
اڳ	ˈaɡ
زمين	zəmˈiːn
چيو	cˈajoː
ڪجهه	kˈʊɟʰʊ
گهڻو	ɡəhˈʌɳoː
ٿيل	tʰˈɪal
وٽ	ʋˈʌʈ
وغيره	ʋˌəɣirˈʌh
رهي	rˈʌhi
سي	sˈeː
حصو	hˈʌʂoː
الله	ˈallaːh
حيدرآباد	hˌeːdraːbˈaːd
مير	mˈeːr
ملي	mˈʌli
مقرر	mˌəqərˈʌr
يعني	jˈaːni
اتي	ˈat̪i
ڪيا	kjˈaː
وفات	ʋˌəfˈaːt
ٻيو	bjˈoː
طرف	tərˈʌf
آبادي	aːbˈaːdi
پهريون	pˌəhərjˈoːn
ٿيون	tʰjˈoːn
قديم	qədˈiːm
ٻولي	bˈoːli
هوندي	hˈũːdi
انھن	ˈanhn
ادب	adˈʌb
بن	bˈʌn
ويندي	ʋˈeːndi
پٽ	pˈʌʈ
جنگ	ɟˈʌnɡ
وٺي	ʋˈʌʈʰi
اسڪول	ˌaskˈoːl
وارن	ʋaːrˈʌn
م	mˈiːm
سيد	saˈiːad
پاڻي	pˈaːɳi
ادبي	ˌadbˈiː
هتي	hˈʌt̪i
رنگ	rˈʌnɡ
ٻن	bˈʌn
چوندا	cˈoːndaː
اصل	aʂˈʌl
ٿيندي	tʰˈĩːdi
ھيو	hjˈoː
پهرين	pˌəhərˈiːn
سالن	saːlˈʌn
ٿيندا	tʰˈĩːdaː
بي	bˈeː
ذريعي	zərˈiːi
تعلقي	t̪aːlˈʌqi
اندر	andˈʌr
نظر	naʐˈar
اهڙي	ahˈʌr.i
ٻيا	bjˈaː
نہ	nˈʌh
ھئي	hˈʊi
لکيل	lˈʌkʰjal
رياست	rjˈaːst̪
علائقي	ˌalaːˈɪqi
عمر	ˈʊmr
ٿيا	tʰjˈaː
پيو	pjˈoː
اھو	ˈahoː
ڏکڻ	ɖəkʰˈʌɳ
ملڪن	mˌələkˈʌn
ڪيترائي	kˌeːt̪rˈaːi
بابت	bˈaːbɪt̪
لاء	lˈaː
ڪيل	kˈajal
صدر	ʂədˈʌr
تان	t̪ˈaːn
ڊاڪٽر	ɖˈaːkʈar
اتر	at̪ˈʌr
علم	alˈʌm
زماني	zəmˈaːni
ڏني	ɖˈʌni
پنھنجي	pənhnˈʌɟi
ٿين	tʰˈeːn
ڏانهن	ɖˌaːnəhˈʌn
هيٺ	hˈeːʈʰ
آف	ˈaːf
اڄ	ˈaɟ
حضرت	hˌəzərˈʌt̪
شاعر	ʃaːˈaːɪr
اوڀر	uːbʰˈʌr
غلام	ɣəlˈaːm
نظام	nɪʐˈaːm
رکيو	rˈʌkʰjoː
شايع	ʃˈaːjaː
سياسي	sjˈaːsi
پير	pˈeːr
ڪاليج	kaːlˈiːɟ
خيال	xjˈaːl
شيخ	ʃˈeːx
اهم	ahˈʌm
پيش	pˈeːʃ
رکي	rˈʌkʰi
تڏهن	t̪ˌəɖəhˈʌn
ذڪر	zəkˈʌr
طرفان	tˌərfˈaːn
پنهنجو	pˈʌ̃hnɟoː
دوران	doːrˈaːn
گهر	ɡəhˈʌr
ويندا	ʋˈeːndaː
ڪندي	kˈʌndi
وڃن	ʋəɲˈʌn
مٿي	mˈʌtʰi
ڏيڻ	ɖˈɪaɳ
دؤر	dəˈa͡ʊr
ڄام	ɟˈaːm
هوندا	hˈũːdaː
تنهن	t̪ˌənəhˈʌn
هٿ	hˈʌʈ
اثر	asˈʌr
عمل	amˈʌl
هنن	hənˈʌn
الدين	ˌaldˈiːn
هندستان	hɪnɖˈʊstaːn
ڪافي	kˈaːfi
وارا	ʋˈaːraː
ڪيترن	kˌeːt̪ərˈʌn
صورت	ʂoːrˈʌt̪
ڇڏيو	cʰˈʌɖjoː
اي	ˈeː
خاندان	xaːndˈaːn
اڪثر	ˌakəsˈʌr
نئين	nəˈiːn
هنڌ	hˈʌndʰ
ورتو	ʋərˈʌt̪oː
ڏئي	ɖˈʌi
سڀني	səbʰˈʌni
بنياد	bənjˈaːd
پاسي	pˈaːsi
اختيار	axt̪jˈaːr
سمنڊ	səmˈʌnɖ
بيان	bjˈaːn
وانگر	ʋaːnɡˈʌr
لکي	lˈʌkʰi
جاري	ɟˈaːri
انگريزي	ˌanɡərˈiːzi
احمد	ɛhmˈʌd
ڪراچي	kərˈaːci
هيو	hjˈoː
پاران	paːrˈaːn
انسان	ɪnsˈaːn
موجب	moːɟˈʌb
سگهي	səɡˈʌhi
سر	sˈʌr
لکيو	lˈʌkʰjoː
مدد	mədˈʌd
گل	ɡˈʌl
تحريڪ	t̪ˌəhrˈiːk
حيثيت	heːsˈiːt̪
مشتمل	mˌəʃt̪əmˈʌl
ختم	xət̪ˈʌm
وڻ	ʋˈʌɳ
گهڻي	ɡəhˈʌɳi
سڄي	sˈʌɟi
جيڪڏهن	ɟˌeːkəɖəhˈʌn
ميان	mjˈaːn
يو	jˈoː
ھوندو	hˈoːndoː
اھي	ˈahi
اٿس	aʈˈʌs
رڳو	rˈʌɡoː
ڪا	kˈaː
هجي	hˈʊɟeː
حوالي	haʋˈaːli
ڪندڙ	kəndˈʌr.
ڇڏي	cʰˈʌɖi
ڪائونسل	kˌaːoːnsˈʌl
ٻي	bˈeː
ڪردار	kərdˈaːr
يونين	joːnˈiːn
ڪڏهن	kˌəɖəhˈʌn
مرزا	mərˈʌzaː
سيڪڙو	seːkˈʌr.oː
ڳالهه	ɡˌaːləhˈʌh
جنم	ɟənˈʌm
قومي	qˈoːmi
وڏا	ʋˈʌɖaː
مٿان	mətʰˈaːn
پئي	pˈʌi
زبان	zəbˈaːn
بخش	bəxˈʌʃ
تعلق	t̪aːlˈʌq
توڙي	t̪ˈoːr.i
صوبي	ʂuːbˈiː
اڳتي	aɡˈʌt̪i
شروعات	ʃʊrˈuːaːt
ٻار	bˈaːr
نمبر	nəmbˈʌr
پوري	pˈoːri
استاد	ast̪ˈaːd
زندگي	zˈɪndɡi
چئبو	cəbˈoː
ائين	aˈiːn
ميمبر	meːmbˈʌr
سرڪاري	sˌərkˈaːri
سڏيو	sˈʌɖjoː
شاعري	ʃaːˈaːɪrˌiː
چار	cˈaːr
فلم	fˈɪlm
فوج	fˈoːɟ
ديھ	dˈeːh
ٽن	ʈˈʌn
ڪجھ	kəɟˈʌh
آزاد	aːzˈaːd
مولانا	moːlˈaːnaː
فتح	fˌət̪ˈah
ايم	ˈeːm
تيار	t̪jˈaːr
باقي	bˈaːqi
مرڪز	mˌərəkˈʌz
يونيورسٽي	jˌoːnjoːrəsˈʌʈi
شاھ	ʃˈaːh
رهيا	rˈʌhjaː
گهٽ	ɡəhˈʌʈ
بند	bˈʌnd
مطلب	mˌətəlˈʌb
فقير	fəqˈiːr
لڳ	lˈʌɡ
خلاف	xəlˈaːf
سماجي	səmˈaːɟi
علائقن	ˌalaːɪqˈʌn
ٺٽي	ʈʰˈʌʈi
جدا	ɟˈʊdaː
هيون	hjˈoːn
ٻيون	bjˈoːn
کين	kʰˈeːn
سن	sˈʌn
ڪتابن	kˌɪtaːbˈʌn
تاريخي	t̪aːrˈiːxi
ترقي	t̪ərˈʌqi
ميل	mˈeːl
صرف	ʂərˈʌf
قيمت	qeːmˈʌt̪
اچڻ	acˈaɳʊ
اسلام	ˌɪslˈaːm
والد	ʋaːlˈʌd
ترجمو	t̪ˌərəɟˈʌmoː
تنهنڪري	t̪ˌənəhˌənəkˈʌri
جلد	ɟəlˈʌd
مثال	məsˈaːl
ننڍي	nənˈʌɖʰi
ڌاري	dʰˈaːri
سو	sˈoː
آخري	aːxˈʌri
جسم	ɟəsˈʌm
صدي	ʂˈʌdi
ظاهر	ʐaːhˈʌr
هندو	hˈɪndoː
پنج	pənˈʌɟ
هاڻي	hˈaːɳi
ڪيون	kjˈoːn
چون	cˈoːn
کڻي	kʰˈʌɳi
حسن	həsˈʌn
سخت	sˈʌxt̪
لڳي	lˈʌɡi
ڪونه	koːnˈʌh
ايندو	ˈeːndoː
دل	dˈʌl
لڳو	lˈʌɡoː
هزار	həzˈaːr
ٻنهي	bənˈʌhi
سگهجي	sˌəɡəhˈʌɟi
تعداد	t̪aːdˈaːd
سنه	sənˈʌh
سج	sˈʌɟ
مضمون	mˌəzmˈuːn
مون	mˈũː
اولاد	uːlˈaːd
غير	ɣˈeːr
لحاظ	ləhˈaːʐ
مسجد	mˈasɟˌɪd
مڪمل	mˌəkəmˈʌl
عالم	aːlˈʌm
مقام	məqˈaːm
شادي	ʃˈaːdi
ڪلوميٽر	kˌəloːmiʈˈʌr
عربي	ˌarbˈiː
سنڌو	sˈɪndhoː
بنيادي	bənjˈaːdi
مسلمان	mʊsˈalmˌaːn
ڇو	cʰˈoː
چڪو	cˈʌkoː
ڪنھن	kˈʌnhn
امير	amˈiːr
اھا	ˈahaː
سفر	səfˈʌr
داخل	daːxˈʌl
خدا	xˈʌdaː
آخر	ˈaːxɪr
بادشاهه	bˈaːdʃˌaːhəh
مال	mˈaːl
مسلمانن	mʊsˈalmˌaːnən
الڳ	alˈʌɡ
انساني	ɪnsˈaːni
ڏنل	ɖˈɪnal
ڪلام	kəlˈaːm
سطح	sˌətˈah
ٿيندڙ	tʰĩːdˈʌr.
رکندڙ	rˌəkʰəndˈʌr.
فارسي	faːrˈʌsi
ڪوشش	koːʃˈʌʃ
ھئا	hˈʌaː
جڏھن	ɟˌəɖəhˈʌn
مسلم	mˈʊslˌɪm
هلي	hˈʌli
چوڻ	cˈoːɳ
شڪل	ʃəkˈʌl
ٻولين	boːlˈiːn
راجا	rˈaːɟaː
ھر	hˈʌr
حصي	hˈʌʂi
جديد	ɟədˈiːd
سائيز	saːˈiːz
ناول	naːˈoːl
لشڪر	lˌəʃəkˈʌr
اڃا	ˈaɲaː
فوٽ	fˈoːʈ
نموني	nəmˈoːni
اسلامي	ˌɪslˈaːmi
پي	pˈeː
آمريڪا	ˌaːmrˈiːkaː
حالت	haːlˈʌt̪
ريت	rˈeːt̪
پنجاب	pˌənɟˈaːb
ڊي	ɖˈeː
حسين	həsˈiːn
سميت	səmˈiːt̪
فوجي	fˈoːɟi
اردو	ˈardoː
انڊيا	ˈɪnɖjaː
وزير	ʋəzˈiːr
پاس	pˈaːs
ادا	ˈadaː
آيا	ˈaːjaː
رات	rˈaːt̪
ڪوٽ	kˈoːʈ
ذات	zˈaːt̪
مخدوم	mˌəxdˈuːm
ڄاڻايل	ɟaːɳˈaːjal
قوم	qˈoːm
زور	zˈoːr
نسل	nəsˈʌl
تحقيق	t̪ˌəhqˈiːq
قانون	qaːnˈoːn
قلعي	qəlˈaːi
انداز	andˈaːz
بيگ	bˈeːɡ
پسند	pəsˈʌnd
امام	amˈaːm
رکڻ	rəkʰˈʌɳ
بڻجي	bəɳˈʌɟi
قتل	qət̪ˈʌl
سلطان	sˌəltˈaːn
قرآن	qərˈaːn
رھيو	rˈʌhjoː
ڏسڻ	ɖɪsˈʌɳ
عورت	ˌaoːrˈʌt̪
پري	pˈʌri
تعمير	t̪aːmˈiːr
خبر	xəbˈʌr
ماڻھن	mˈaːɳhʊn
اتان	at̪ˈaːn
رهندو	rəhˈʌndoː
علائقو	ˌalaːˈɪqoː
فن	fˈʌn
ليکڪ	leːkʰˈʌk
وڃڻ	ʋəɲˈʌɳ
وڌي	ʋˈʌdʰi
شريف	ʃərˈiːf
شعر	ʃˈaːr
صفحا	ʂəfˈʌhaː
ويون	ʋjˈoːn
ڏي	ɖˈeː
پھرين	pˌəhrˈiːn
آواز	aːʋˈaːz
اهڙو	ahˈʌr.oː
هڪڙو	həkˈʌr.oː
گڏيل	ɡˈʌɖjal
هئڻ	hˈʌɳ
بورڊ	bˈoːrəɖ
انهي	ɪnˈɪhi
حقيقت	hˌəqiqˈʌt̪
قاضي	qˈaːzi
سلسلي	sˈɪlsˌɪli
لکڻ	lˈɪkʰaɳ
حق	hˈʌq
نهايت	nˌəhaːˈiːt̪
مقصد	mˌəqəʂˈʌd
ماڻھو	maːɳˈʌhoː
نالا	nˈaːlaː
لوڪ	lˈoːk
لاڙڪاڻي	lˌaːr.kˈaːɳi
آئي	ˈaːi
ٿر	ʈˈʌr
جبل	ɟəbˈʌl
حڪم	həkˈʌm
ڪناري	kənˈaːri
جنرل	ɟˌənərˈʌl
لفظن	lˌəfəʐˈʌn
اولهه	ˌuːləhˈʌh
حاڪم	haːkˈʌm
عالمي	aːlˈʌmi
پورو	pˈoːroː
طاقت	taːqˈʌt̪
عرب	arˈʌb
ميٽر	meːʈˈʌr
چين	cˈeːn
ھتي	hˈʌt̪i
لک	lˈʌkʰ
نڪري	nˈɪkri
ڏسي	ɖˈɪsi
انگريزن	ˌanɡərizˈʌn
ترتيب	t̪ˌərt̪ˈiːb
اخبار	ˌaxbˈaːr
مارچ	mˈaːrc
مشھور	mˌəʃhˈuːr
موجوده	moːɟˈuːdh
ملن	məlˈʌn
ڪيترا	keːt̪ˈʌraː
وڏن	ʋəɖˈʌn
وجود	ʋəɟˈoːd
ٻاهر	baːhˈʌr
حاجي	hˈaːɟi
شين	ʃˈeːn
وي	ʋˈeː
معلوم	maːlˈoːm
هڪڙي	həkˈʌr.i
آيل	ˈaːjal
جنوري	ɟənˈoːri
عرصي	arˈʌʂi
عورتن	ˌaoːrət̪ˈʌn
واپار	ʋaːpˈaːr
پوء	pˈoː
بين	bˈeːn
مليو	mˈʌljoː
جان	ɟˈaːn
شڪار	ʃəkˈaːr
مذهبي	mˌəzəhəbˈiː
ٻارن	baːrˈʌn
اولھ	uːlˈʌh
ناهي	nˈaːhi
ڀرسان	bʰˌərsˈaːn
ڄاڻ	ɟˈaːɳ
بيت	bˈeːt̪
گڏجي	ɡəɖˈʌɟi
ھوندا	hˈoːndaː
و	ʋˈaːɔ
ڄائو	ɟˈaːoː
آگسٽ	ˌaːɡəsˈʌʈ
تحت	t̪əhˈʌt̪
رهڻ	rəhˈʌɳ
ھوندي	hˈoːndi
پوي	pʋˈeː
ايندا	ˈeːndaː
اھڙي	ahˈʌr.i
فقط	fəqˈʌt
پٿر	pəʈˈʌr
گھٽ	ɡʰˈʌʈ
اهڙا	ahˈʌr.aː
ٻج	bˈʌɟ
خود	xˈʊd
ساڳي	sˈaːɡi
اچن	acˈʌn
ويجهو	ʋeːɟˈʌhoː
ٺهيل	ʈʰˈʌhjal
پارٽي	paːrˈʌʈi
واپس	ʋaːpˈʌs
روشني	roːʃˈʌni
پن	pˈʌn
مکيه	məkʰˈiːh
ٻہ	bˈʌh
چئن	cˈʌn
ايران	eːrˈaːn
شخص	ʃˈaxʂ
قبيلي	qəbˈiːli
بزرگ	bˈʊzʊɾɡ
شاعرن	ʃaːˈaːɪrn
گورنر	ɡˌoːrənˈʌr
اهميت	ˌahəmˈiːt̪
ضرورت	zˌaruːrˈʌt̪
محبت	mˌəhəbˈʌt̪
پروفيسر	pˌəroːfisˈʌr
اڌ	ˈadʰ
شمار	ʃəmˈaːr
تبديل	t̪əbˈʌdjal
رستي	rˈʌst̪i
شڪارپور	ʃˌəkaːrpˈoːr
لکيا	lˈʌkʰjaː
يورپ	joːrˈʌp
تعليمي	t̪aːlˈiːmi
رھي	rˈʌhi
عليه	alˈiːh
اٽڪل	ˌaʈəkˈʌl
تن	t̪ˈʌn
راڳ	rˈaːɡ
پيا	pjˈaː
روڊ	rˈoːɖ
علاوه	ˌalaːˈoːh
مراد	mərˈaːd
کن	kʰˈʌn
صحيح	ʂˈʌhih
شهرن	ʃˌəhərˈʌn
ٻيٽ	bˈeːʈ
پکي	pˈʌkʰi
تنظيم	t̪ˌənʐˈiːm
ڏاڍو	ɖˈaːɖʰoː
روايت	rʋaːˈiːt̪
سردار	sərdˈaːr
متاثر	mˌət̪aːsˈʌr
بهترين	bˌəhət̪rˈiːn
ثابت	saːbˈɪt̪
ساڳئي	saːɡˈʌi
عظيم	aʐˈiːm
رسالي	rəsˈaːli
ننڍا	nənˈʌɖʰaː
ڇا	cʰˈaː
گرم	ɡərˈʌm
آڪٽوبر	ˌaːkʈoːbˈʌr
شهيد	ʃəhˈiːd
تصور	t̪əʂˈoːr
درياهه	dˌərjaːhˈʌh
موت	mˈoːt̪
چورس	coːrˈʌs
ڪڍي	kˈʌɖʰi
سرڪار	sˌərkˈaːr
نظم	nəʐˈʌm
سکر	səkʰˈʌr
صوفي	ʂˈoːfi
ميدان	meːdˈaːn
سائنس	saːˈɪns
نئون	nəˈoːn
نٿو	nˈʌtʰoː
رت	rˈʌt̪
موسم	moːsˈʌm
ڇاڪاڻ	cʰaːkˈaːɳ
گهڻا	ɡəhˈʌɳaː
شاگرد	ʃaːɡˈʌrd
ڀڳ	bʰˈʌɡ
مذهب	mˌəzəhˈʌb
آزادي	aːzˈaːdi
بلڪل	bˌələkˈʌl
پھريون	pˌəhrjˈoːn
ڌار	dʰˈaːr
مگر	məɡˈʌr
ورتي	ʋərˈʌt̪i
ويئي	ʋˈeːi
پاڪ	pˈaːk
پنهنجن	pʌ̃hnɟˈʌn
ڪرايو	kərˈaːjoː
الاقوامي	ˌalaːqʋˈaːmi
اپريل	apˈʌrjal
باري	bˈaːri
سماج	səmˈaːɟ
ننڍو	nənˈʌɖʰoː
ابن	abˈʌn
اصطلاح	ɪʂtˈɪlaːh
ايس	ˈeːs
شاه	ʃˈaːh
مقامي	məqˈaːmi
ڏاڍي	ɖˈaːɖʰi
آمريڪي	ˌaːmrˈiːki
سائين	saːˈiːn
پراڻي	pərˈaːɳi
پکيڙ	pəkʰˈiːr.
لطيف	lətˈiːf
نواب	nˈaʋaːb
هتان	hət̪ˈaːn
ڌرم	dʰərˈʌm
سڏيندا	səɖˈiːndaː
هجڻ	hˈʊɟaɳ
ٽيون	ʈjˈoːn
لاڳاپيل	laːɡˈaːpjal
لڳا	lˈʌɡaː
پرائمري	pˌəraːɪmˈʌri
پڙهڻ	pˌər.əhˈʌɳ
ياد	jˈaːd
نومبر	noːmbˈʌr
ڊسمبر	ɖˌəsəmbˈʌr
مضبوط	mˌəzbˈuːt
ٿينديون	tʰĩːdjˈoːn
ڀيرو	bʰˈeːroː
کير	kʰˈeːr
منهنجي	mˌənəhənˈʌɟi
ڪٿي	kˈʌtʰi
بلوچستان	bˌəloːcˈɪstaːn
خط	xˈʌt
قرار	qərˈaːr
رواج	rʋˈaːɟ
قبضو	qəbˈʌzoː
قسمن	qˌəsəmˈʌn
اديب	adˈiːb
چئي	cˈʌi
ڪل	kˈʌl
سامونڊي	saːmˈoːnɖi
قومن	qoːmˈʌn
حالتن	hˌaːlət̪ˈʌn
رسم	rəsˈʌm
ست	sˈʌt̪
حملو	həmˈʌloː
وٺڻ	ʋəʈʰˈʌɳ
کاتي	kʰˈaːt̪i
موضوع	mˈoːzuː
وسيلي	ʋəsˈiːli
اوهان	uːhˈaːn
تخت	t̪ˈʌxt̪
قيام	qjˈaːm
وينديون	ʋeːndjˈoːn
ھيا	hjˈaː
حصن	həʂˈʌn
پهتو	pəhˈʌt̪oː
آندو	ˈaːndoː
اسيمبلي	ˌasimbˈʌli
سڃاڻپ	sˌəɲaːɳˈʌp
علمي	alˈʌmi
مرڪزي	mˌərəkˈʌzi
چنڊ	cˈʌnɖ
ڏٺو	ɖˈʌʈʰoː
گھڻو	ɡʰˈʌɳoː
بلوچ	bəlˈoːc
جهڙو	ɟəhˈʌr.oː
سياست	sjˈaːst̪
ضروري	zarˈuːri
ٿورو	tʰˈoːroː
اداري	adˈaːri
سلطنت	sˌələtənˈʌt̪
يوناني	joːnˈaːni
جتان	ɟət̪ˈaːn
عوام	aʋˈaːm
شاگردن	ʃˌaːɡərdˈʌn
پوندو	pˈoːndoː
پڌرو	pədʰˈʌroː
رهندا	rəhˈʌndaː
شروعاتي	ʃərʋˈaːt̪i
شڪست	ʃəkˈʌst̪
چڪا	cˈʌkaː
ابراهيم	ˌabraːhˈiːm
واپاري	ʋaːpˈaːri
ايندڙ	eːndˈʌr.
رهن	rəhˈʌn
ريڊيو	rˈeːɖjoː
شاخ	ʃˈaːx
ماهر	maːhˈʌr
پروگرام	pˌəroːɡrˈaːm
پنهنجا	pˈʌ̃hnɟaː
ڏيئي	ɖˈeːi
کنڊ	kʰˈʌnɖ
سلسلو	sˈɪlsˌɪloː
قبول	qəbˈoːl
ولد	ʋəlˈʌd
ڇپيل	cʰˈʌpjal
ڪيتريون	kˌeːt̪rjˈoːn
جيتوڻيڪ	ɟˌeːt̪oːɳˈiːk
ريلوي	rˈeːlʋi
عوامي	aʋˈaːmi
ندي	nˈʌdi
ملتان	mˌəlt̪ˈaːn
مندر	məndˈʌr
نتيجي	nət̪ˈiːɟi
ابو	abˈoː
سگھي	sˈaɡʰeː
عالمن	ˌaːləmˈʌn
قاسم	qaːsˈʌm
نبي	nəbˈiː
معني	mˈaːni
ڍنڍ	ɖʰənˈʌɖʰ
ڏيندا	ɖˈeːndaː
منجهان	mˌənəɟhˈaːn
پٺيان	pəʈʰjˈaːn
وطن	ʋətˈʌn
جماعت	ɟˌəmaːˈaːt̪
ٺاهي	ʈʰˈaːhi
ڀاڱي	bʰaːˈŋ̩i
ڊگري	ɖəɡˈʌri
ڪرائون	kˌəraːˈoːn
گورنمينٽ	ɡˌoːrənminˈʌʈ
گول	ɡˈoːl
درجو	dˈarɟoː
دوست	dˈoːst̪
رام	rˈaːm
فائدو	faːˈɪdoː
فرق	fərˈʌq
گڏوگڏ	ɡˌəɖoːɡˈʌɖ
اول	ˈuːl
جنهنڪري	ɟˌənəhˌənəkˈʌri
فرزند	fˌərəzˈʌnd
جانور	ɟaːnˈoːr
سامهون	sˌaːmhˈoːn
مئي	mˈʌi
ڏنا	ɖˈʌnaː
بکر	bəkʰˈʌr
هونديون	hũːdjˈoːn
ڀارت	bʰaːrˈʌt̪
گھر	ɡʰˈʌr
سيپٽمبر	sˌeːpəʈəmbˈʌr
ماحول	maːhˈoːl
خدمت	xˌədəmˈʌt̪
سگهن	sˌəɡəhˈʌn
طريقي	tərˈiːqi
قوت	qˈoːt̪
ڇپائي	cʰəpˈaːi
ڇپيو	cʰˈʌpjoː
ابتدائي	ˌɪbtɪdˈaːi
اسٽيشن	ˌasʈiʃˈʌn
بندر	bəndˈʌr
جهڙوڪ	ɟˌəhər.ˈuːk
صاف	ʂˈaːf
ليگ	lˈeːɡ
باغ	bˈaːɣ
جهڙي	ɟəhˈʌr.i
جيل	ɟˈeːl
ديوان	djʋˈaːn
لڏي	lˈʌɖi
ڀاڱو	bʰaːˈŋ̩oː
ڏينھن	ɖˈeːnhn
امن	amˈʌn
اڳيان	aɡjˈaːn
بدران	bˌədrˈaːn
مخصوص	mˌəxʂˈuːʂ
مفيد	məfˈiːd
ٺاهڻ	ʈʰaːhˈʌɳ
تھ	t̪ˈʌh
مولوي	mˈoːlʋi
برابر	bˌəraːbˈʌr
سيڪريٽري	sˌeːkriʈˈʌri
قبضي	qəbˈʌzi
وزن	ʋəzˈʌn
گھڻي	ɡʰˈʌɳi
ھتان	hət̪ˈaːn
تيل	t̪ˈeːl
ماڳ	mˈaːɡ
ادارن	ˌadaːrˈʌn
خاصيت	xaːʂˈiːt̪
زال	zˈaːl
مرد	mˈʌrd
اڻ	ˈaɳ
خلافت	xˌəlaːfˈʌt̪
ڪاري	kˈaːri
گيت	ɡˈeːt̪
اين	ˈeːn
عبدالله	ˌabdˌaːləlˈʌh
مادي	mˈaːdi
ٿوري	tʰˈoːri
ڪرائي	kərˈaːi
ڪمپني	kəmpˈʌni
حد	hˈʌd
ديوتا	djˈoːt̪aː
سرحد	sˌərəhˈʌd
اعلان	eːlˈaːn
ايشيا	ˈeːʃjaː
نور	nˈoːr
ايترو	eːt̪ˈʌroː
سنسڪرت	sˌənsəkərˈʌt̪
نقصان	nˌəqʂˈaːn
ڇاپو	cʰˈaːpoː
آئين	aːˈiːn
قابل	qaːbˈɪl
محمود	mˌəhmˈuːd
ٻيهر	beːhˈʌr
ڪتب	kət̪ˈʌb
گهرجي	ɡˌəhərˈʌɟi
سموري	səmˈoːri
چوڌاري	coːdʰˈaːri
اڳواڻ	aɡʋˈaːɳ
خيرپور	xˌeːrpˈoːr
گجرات	ɡˌəɟərˈaːt
شيون	ʃjˈoːn
منهن	mˌənəhˈʌn
نشان	nɪʃˈaːn
ڀيٽ	bʰˈeːʈ
آنا	ˈaːnaː
جبلن	ɟˌəbəlˈʌn
لقب	ləqˈʌb
نيٺ	nˈeːʈʰ
رکيل	rˈʌkʰjal
مليل	mɪlˈɪal
واريون	ʋaːrjˈoːn
وڻن	ʋəɳˈʌn
پهرئين	pˌəhərˈiːn
ڪامياب	kaːmjˈaːb
اڳي	ˈaɡi
مل	mˈʌl
موڪليو	moːkˈʌljoː
هندن	hɪndˈʌn
وڌو	ʋˈʌdʰoː
کائڻ	kʰaːˈɪɳ
اکر	akʰˈʌr
بڻايو	bəɳˈaːjoː
راڻي	rˈaːɳi
ٻڌل	bədʰˈʌl
پيٽ	pˈeːʈ
ڏيندو	ɖˈeːndoː
ڪلوميٽرن	kˌəloːmˌiːʈərˈʌn
ڪمپيوٽر	kˌəmpjoːʈˈʌr
گذريو	ɡəzˈʌrjoː
زرعي	zərˈaːi
پراڻو	pərˈaːɳoː
ايندي	ˈeːndi
دڙي	dˈʌr.i
شوق	ʃˈoːq
هليو	hˈʌljoː
پنجن	pˌənəɟˈʌn
فاصلي	faːʂˈʌli
ايڊيٽر	ˌeːɖiʈˈʌr
ثقافت	sˌəqaːfˈʌt̪
سڄو	sˈʌɟoː
قدر	qədˈʌr
مواد	mʋˈaːd
موٽي	mˈoːʈi
راڄ	rˈaːɟ
سا	sˈaː
سڏجي	səɖˈʌɟi
سگهيو	səɡˈʌhjoː
شام	ʃˈaːm
مقدار	mˌəqdˈaːr
قبرستان	qˌəbərˈɪstaːn
مري	mˈʌri
چڱو	cəˈŋ̩oː
آثار	aːsˈaːr
انعام	ɪnˈaːm
خشڪ	xəʃˈʌk
وٽان	ʋəʈˈaːn
ڀيرا	bʰˈeːraː
ڀٽو	bʰˈʌʈoː
ايتري	eːt̪ˈʌri
خدمتون	xˌədəmt̪ˈoːn
درجي	dˈarɟi
رهائش	rˌəhaːˈɪʃ
سيوهڻ	sjoːhˈʌɳ
فرانس	fərˈaːns
ڪورٽ	koːrˈʌʈ
انتظامي	ˌɪntɪʐˈaːmi
نڪتل	nˌəkət̪ˈʌl
ٻڌي	bˈʌdʰi
ڏنائين	ɖˌənaːˈiːn
اکين	akʰˈiːn
شاهي	ʃˈaːhi
عهدي	ahˈʌdi
ڇپايو	cʰəpˈaːjoː
انگريز	ˌanɡərˈiːz
تاج	t̪ˈaːɟ
رپيا	rˈʌpjaː
محسوس	mˌəhsˈuːs
مهيني	məhˈiːni
پهچي	pəhˈʌci
ڪجي	kˈʌɟi
راند	rˈaːnd
تون	t̪ˈoːn
نيشنل	nˌeːʃənˈʌl
هوا	hʋˈaː
گادي	ɡˈaːdi
ادارو	adˈaːroː
ايوارڊ	ˌeːʋaːrˈʌɖ
اڪثريت	ˌakəsrˈiːt̪
معاشي	mˈaːʃi
مغل	məɣˈʌl
گرفتار	ɡˈɪrɪftˌaːr
صحت	ʂəhˈʌt̪
هميشه	hˌəmiʃˈʌh
وزيراعظم	ʋˌəzirˌaːaːʐˈʌm
وڌ	ʋˈʌdʰ
پنجابي	pˌənɟaːbˈiː
چونڊيو	cˈoːnɖjoː
جهاز	ɟəhˈaːz
خرچ	xˈʌrc
سزا	sˈʌzaː
قدرتي	qˌədərˈʌt̪i
مجموعو	mˌəɟmʋˈaːoː
وارين	ʋaːrˈiːn
تيز	t̪ˈeːz
محفوظ	mˌəhfˈuːʐ
ملڻ	məlˈʌɳ
آهستي	aːhˈʌst̪i
ترين	t̪ərˈiːn
رڪن	rəkˈʌn
مرحوم	mˌərhˈuːm
مهل	məhˈʌl
ڪاٺ	kˈaːʈʰ
جانورن	ɟˌaːnoːrˈʌn
سٺي	sˈʌʈʰi
غريب	ɣərˈiːb
مالڪ	maːlˈʌk
اجازت	ˌaɟaːzˈʌt̪
ثقافتي	sˌəqaːfˈʌt̪i
صوبو	ʂuːbˈoː
چونڊ	cˈoːnɖ
سور	sˈoːr
فلسفي	fˌələsˈʌfi
فيبروري	fˌeːbrˈoːri
قيد	qˈeːd
جواب	ɟˈaʋaːb
ورتائين	ʋˌərt̪aːˈiːn
ھجڻ	həɟˈʌɳ
مٿس	məʈˈʌs
هيا	hjˈaː
باهه	bˈaːhəh
جهڙا	ɟəhˈʌr.aː
حڪمران	hˌəkəmrˈaːn
رسول	rəsˈoːl
سٺو	sˈʌʈʰoː
غزل	ɣəzˈʌl
احوال	ahʋˈaːl
سياري	sjˈaːri
شعبي	ʃˈɔbi
عمارت	ˌamaːrˈʌt̪
فيروز	feːrˈoːz
قلعو	qəlˈaːoː
مختصر	mˌəxt̪əʂˈʌr
وار	ʋˈaːr
ڪانفرنس	kˌaːnəfərˈʌns
ڪوبه	koːbˈʌh
انتظام	ˌɪntɪʐˈaːm
اٺ	ˈaʈʰ
باوجود	bˈaːoːɟˌoːd
سگھجي	səɡʰˈʌɟi
عرصو	arˈʌʂoː
وانگي	ʋˈaːnɡi
روانو	rʋˈaːnoː
سوال	sʋˈaːl
چڪي	cˈʌki
گاهه	ɡaːhˈʌh
آفريڪا	ˌaːfrˈiːkaː
برطانوي	bˌərtˈaːnʋi
حساب	həsˈaːb
مسٽر	mˌəsəʈˈʌr
نوان	nˈaʋaːn
پيداوار	pˌeːdaːʋˈaːr
رفتار	rˈafətˌaːr
رکن	rəkʰˈʌn
شايد	ʃaːˈiːd
علامه	ˌalaːmˈʌh
عملي	amˈʌli
مقبول	mˌəqbˈuːl
ملڪيت	mˌəlkˈiːt̪
ڪڇ	kˈʌcʰ
تربيت	t̪ˌərbˈiːt̪
لاهور	laːhˈoːr
مصر	məʂˈʌr
آغا	ˈaːɣaː
رئيس	rəˈiːs
سوويت	sʋʋˈeːt̪
قبيلن	qəbˈiːlən
بمبئي	bəmbˈʌi
حملي	həmˈʌli
ريگستان	rˌeːɡˈɪstaːn
لائق	laːˈɪq
هجن	hˈʊɟan
هه	hˈʌh
ڊراما	ɖərˈaːmaː
انقلاب	ˌɪnqɪlˈaːb
بادشاھ	bˈaːdʃˌaːh
خوبصورت	xˌoːbʂoːrˈʌt̪
ملائي	məlˈaːi
ها	hˈaː
هند	hˈɪnd
ساڻس	saːɳˈʌs
شخصيت	ʃˈaxʂit̪
قلم	qəlˈʌm
لنڊن	lənɖˈʌn
مخالف	mʊxˈaːlɪf
ھجي	hˈʌɟi
سمجهيو	sˌəməɟˈʌhjoː
لڳل	ləɡˈʌl
ڳوٺن	ɡoːʈʰˈʌn
امتحان	ˌɪmtɪhˈaːn
اهڙن	ˌahər.ˈʌn
رکندو	rəkʰˈʌndoː
سون	sˈoːn
علاج	alˈaːɟ
لاڳو	lˈaːɡoː
لکت	lˈɪkʰat
ميمڻ	meːmˈʌɳ
مڙس	mər.ˈʌs
هندي	hˈɪndi
دفن	dəfˈʌn
ذاتي	zˈaːt̪i
رهندڙ	rˌəhəndˈʌr.
في	fˈeː
مليا	mˈʌljaː
نماز	namˈaːz
پرنٽنگ	pˌərənəʈˈʌnɡ
ڏيڍ	ɖˈeːɖʰ
اعظم	aːʐˈʌm
بار	bˈaːr
ديوي	djʋˈeː
عربن	ˌarəbˈʌn
فڪر	fəkˈʌr
ايڇ	ˈeːcʰ
بهتر	bˌəhət̪ˈʌr
رسالن	rˌəsaːlˈʌn
طريقو	tərˈiːqoː
مزار	məzˈaːr
ممڪن	mˌəməkˈʌn
ڊويزن	ɖʋeːzˈʌn
رستو	rˈʌst̪oː
نوجوان	noːɟʋˈaːn
ٻڌ	bˈʌdʰ
پئجي	pˈʌɟi
پريس	pərˈiːs
پيدائش	pˌeːdaːˈɪʃ
ڪيئن	keːˈɪn
گرمي	ɡərˈʌmi
ھيٺ	hˈeːʈʰ
تنقيد	t̪ˌənqˈiːd
خوش	xˈʊʃ
دماغ	dəmˈaːɣ
رکندا	rəkʰˈʌndaː
سڏبو	sˌəɖbˈoː
ضرور	zarˈuːr
ٻڌايو	bədʰˈaːjoː
پنن	pənˈʌn
ڪانه	kaːnˈʌh
ڪيائون	kjaːˈoːn
حدن	hədˈʌn
فيصلو	feːʂˈʌloː
مقابلي	mˌəqaːbˈʌli
ناٽڪ	naːʈˈʌk
يوسف	joːsˈʌf
ڪروڙ	kərˈoːr.
ڳالھ	ɡaːlˈʌh
باني	bˈaːni
جابلو	ɟaːbˈʌloː
معاملن	mˌaːməlˈʌn
پاسو	pˈaːsoː
اھم	ahˈʌm
برطانيا	bˌərtˈaːnjaː
صوبائي	ʂuːbˈaːi
ضلعو	zəlˈaːoː
عنوان	ʊnʋˈaːn
ويٺو	ʋˈeːʈʰoː
چئجي	cˈʌɟi
آفيسر	ˌaːfisˈʌr
اخبارن	ˌaxbˈaːrən
اڪبر	ˌakəbˈʌr
دين	dˈeːn
فلمن	fˈɪlmn
هنڌن	həndʰˈʌn
وجهي	ʋəɟˈʌhi
ورهاڱي	ʋˌərhaːˈŋ̩i
ڄمار	ɟəmˈaːr
گوشت	ɡˈoːʃt̪
اظهار	ˌaʐhˈaːr
افغانستان	ˌafɣaːnˈɪstaːn
دفعو	dəfˈaːoː
مريد	mərˈiːd
ڀڄي	bʰˈʌɟi
ڌيان	dʰjˈaːn
رضه	rəzˈʌh
رھندڙ	rˌəhəndˈʌr.
لا	lˈaː
مستقل	mˌəst̪əqˈʌl
معلومات	mˌaːloːmˈaːt
ميرن	meːrˈʌn
پوندي	pˈoːndi
آڻي	ˈaːɳi
انچ	ˈanc
سائنسي	saːˈɪnsi
سامان	saːmˈaːn
قدم	qədˈʌm
چيني	cˈeːni
بيمارين	bˈeːmaːrˌiːn
تعلقو	t̪aːlˈʌqoː
خليفي	xəlˈiːfi
دي	dˈeː
سرانجام	sˌəraːnɟˈaːm
مارجي	maːrˈʌɟi
گهراڻي	ɡˌəhərˈaːɳi
حيدر	heːdˈʌr
در	dˈʌr
روپ	rˈoːp
صبح	ʂˌəbˈah
متعلق	mˌət̪aːlˈʌq
منظور	mˌanʐˈuːr
مهينن	mˌəhinˈʌn
اياز	eːˈaːz
مدرسي	mˌədərˈʌsi
ڪارڻ	kaːrˈʌɳ
آدم	aːdˈʌm
اسماعيل	ˌasmaːˈaːjal
اعزاز	eːzˈaːz
رياستن	rjaːst̪ˈʌn
واسطو	ʋaːsˈʌtoː
ڏين	ɖˈeːn
اصول	ʊʂˈuːl
انگ	ˈanɡ
جام	ɟˈaːm
حقن	həqˈʌn
خراب	xərˈaːb
رخ	rˈʊx
رهندي	rəhˈʌndi
صلاح	ʂˈʌlaːh
لال	lˈaːl
ليڪن	leːkˈʌn
نثر	nəsˈʌr
تهذيب	t̪ˌəhəzˈiːb
سمجهي	sˌəməɟˈʌhi
صفحن	ʂˌəfəhˈʌn
نگار	nəɡˈaːr
پيل	pˈeːl
چڱي	cəˈŋ̩i
ھنن	hənˈʌn
بحث	bəhˈʌs
دادو	dˈaːdoː
توهان	t̪oːhˈaːn
ساز	sˈaːz
ويندڙ	ʋeːndˈʌr.
ٽالپر	ʈˌaːləpˈʌr
پکڙيل	pəkʰˈʌr.jal
ڪهاڻيون	kˌəhaːɳjˈoːn
حال	hˈaːl
رسالو	rəsˈaːloː
سوچ	sˈoːc
ٽنڊي	ʈˈʌnɖi
ڊرامي	ɖərˈaːmi
کائيندا	kʰaːˈiːndaː
اضافو	ɪzˈaːfoː
برسات	bˌərəsˈaːt
حل	hˈʌl
عزت	azˈʌt̪
نواز	nˈaʋaːz
پکين	pəkʰˈiːn
چيف	cˈeːf
ڇهه	cʰəhˈʌh
ڇپجي	cʰəpˈʌɟi
ڪائنات	kˌaːɪnˈaːt
آڏو	ˈaːɖoː
السلام	ˌaləslˈaːm
خطي	xˈʌti
دولت	doːlˈʌt̪
سنگت	sənɡˈʌt̪
ميرزا	meːrˈʌzaː
مٽياري	məʈjˈaːri
ٻنھي	bˈʌnhi
ڪرائڻ	kˌəraːˈɪɳ
سئو	sˈʌoː
مرڻ	mərˈʌɳ
هزارين	hˌəzaːrˈiːn
اتحاد	ˌat̪hˈaːd
اندازو	andˈaːzoː
روايتي	rʋaːˈiːt̪i
سڪندر	sˌəkəndˈʌr
ماهرن	mˌaːhərˈʌn
ملڪي	məlˈʌki
نٿي	nˈʌtʰi
ٺھيل	ʈʰˈʌhjal
پارليامينٽ	pˌaːrljˌaːminˈʌʈ
پاڪستاني	pˌaːkɪstˈaːni
پور	pˈoːr
پوڄا	pˈoːɟaː
ڀرپور	bʰˌərpˈuːr
ڏنيون	ɖˈɪnjũː
ڏهه	ɖəhˈʌh
کاڌي	kʰˈaːdʰi
اينڊ	ˈeːnɖ
محنت	mˌəhənˈʌt̪
مسئلن	mˌəsəlˈʌn
ننڍپڻ	nˌənəɖʰəpˈʌɳ
ڪيترين	kˌeːt̪rˈiːn
ڪپڙي	kəpˈʌr.i
اڀياس	abʰjˈaːs
اڃان	aɲˈaːn
بغاوت	bˌaɣaːʋˈat
دلچسپي	dˌɪlcˈaspi
صورتحال	ʂˌoːrət̪hˈaːl
عيسوي	aˈiːsʋi
لينڊ	lˈeːnɖ
محل	məhˈʌl
موقعي	moːqˈaːi
نتيجو	nət̪ˈiːɟoː
ٻوليون	boːljˈoːn
ڳالهيون	ɡˌaːlhjˈoːn
ايل	ˈeːl
تحقيقي	t̪ˌəhqˈiːqi
رڪارڊ	rˌəkaːrˈʌɖ
صلي	ʂˈʌli
فصل	fəʂˈʌl
فيض	fˈeːz
ميلن	meːlˈʌn
مٽي	mˈʌʈi
واهه	ʋaːhˈʌh
ڀر	bʰˈʌr
ڪهاڻي	kəhˈaːɳi
گهڻن	ɡˌəhəɳˈʌn
خيالن	xjaːlˈʌn
دفعا	dˈʌfaː
شرڪت	ʃˌərəkˈʌt̪
ننڍڙو	nˌənəɖʰˈʌr.oː
ننڍڙي	nˌənəɖʰˈʌr.i
گذاري	ɡəzˈaːri
اسپتال	ˌasəpt̪ˈaːl
بلند	bəlˈʌnd
ذهن	zəhˈʌn
روشن	roːʃˈʌn
علائقا	ˌalaːˈɪqaː
واقعي	ʋaːqˈaːi
پهريائين	pˌəhərjaːˈiːn
ڪمن	kəmˈʌn
ڪهاڻين	kˌəhaːɳˈiːn
ڳائڻ	ɡaːˈɪɳ
مڪي	mˈʌki
ڪلهوڙن	kˌəlhuːr.ˈʌn
شريڪ	ʃərˈiːk
عثمان	ˌasmˈaːn
مغلن	mˌəɣəlˈʌn
منزل	mˈanzˌɪl
نمونو	nəmˈoːnoː
ڪانگريس	kˌaːnɡərˈiːs
اسين	asˈiːn
بنا	bˈʌnaː
روايتن	rʋˌaːit̪ˈʌn
روح	rˈoːh
ريپبلڪ	rˌeːpəbəlˈʌk
لازمي	laːzˈʌmi
وهڪري	ʋˌəhəkˈʌri
پوليس	poːlˈiːs
ڌرتي	dʰərˈʌt̪i
بيماري	bˈeːmaːrˌiː
جرمن	ɟˌərəmˈʌn
جيترو	ɟeːt̪ˈʌroː
خاطر	xaːtˈʌr
عشق	aʃˈʌq
عورتون	ˌaoːrt̪ˈoːn
نمايان	nˈʊmaːjˌaːn
ڦر	pʰˈʌr
کل	kʰˈʌl
ڪارو	kˈaːroː
ڪچي	kˈʌci
آسپاس	ˌaːspˈaːs
انگلينڊ	ˌanɡəlˈiːnɖ
جيڪب	ɟeːkˈʌb
جيڪڏھن	ɟˌeːkəɖəhˈʌn
رد	rˈʌd
سؤ	sˈʌa͡ʊ
سنڌين	sɪndhˈiːn
سير	sˈeːr
مئٽرڪ	mˌəʈərˈʌk
هم	hˈʌm
ورهيه	ʋˌərhˈiːh
وسلم	ʋˌəsəlˈʌm
پنڌ	pˈʌndʰ
اليڪشن	ˌalikəʃˈʌn
باب	bˈaːb
خدمتن	xˌədəmət̪ˈʌn
دشمن	dˌəʃəmˈʌn
روس	rˈoːs
ساڳيو	sˈaːɡjoː
ضلعن	zəlˈaːn
فرد	fˈʌrd
لڳائي	ləɡˈaːi
نسبت	nˌəsəbˈʌt̪
ننڍن	nˌənəɖʰˈʌn
ڪريم	kərˈiːm
آڻڻ	aːɳˈʌɳ
اديبن	ˌadibˈʌn
حديث	hədˈiːs
خواجه	xʋaːɟˈʌh
قمبر	qəmbˈʌr
منتقل	mˌənət̪əqˈʌl
نالن	naːlˈʌn
هڪٻئي	hˌəkəbˈʌi
يورپي	joːrˈʌpi
پنھنجو	pənhnˈʌɟoː
ڄڻ	ɟˈʌɳ
چونڊن	coːnɖˈʌn
اوائلي	ˌuːaːˈɪli
بڻائي	bəɳˈaːi
سب	sˈʌb
سول	sˈoːl
صنف	ʂənˈʌf
ماڻي	mˈaːɳi
موهن	moːhˈʌn
مڇي	mˈʌcʰi
هريجن	hˌəriɟˈʌn
ڏيندي	ɖˈeːndi
ڪچو	kˈʌcoː
آسمان	ˌaːsmˈaːn
بهادر	bˌəhaːdˈʌr
جنگي	ɟˈʌnɡi
داستان	daːst̪ˈaːn
رائج	raːˈɪɟ
رائچند	rˌaːɪcˈʌnd
شمسي	ʃəmˈʌsi
ع	ˈa͡ɪn
هاڻوڪي	haːɳˈoːki
ڀري	bʰˈʌri
چند	cˈʌnd
ڪنديون	kəndjˈoːn
ايجاد	eːɟˈaːd
بازار	bˈaːzaːr
درٻار	dˌərbˈaːr
روحاني	roːhˈaːni
سکيا	sˈʌkʰjaː
مخالفت	mˌʊxaːlɪfˈat
هاڻ	hˈaːɳ
وزارت	ʋˌəzaːrˈʌt̪
آذربائيجان	ˌaːzərbˈaːiɟˌaːn
جاگرافيائي	ɟˌaːɡraːfjˈaːi
جوڙي	ɟˈoːr.i
حافظ	haːfˈʌʐ
حفاظت	hˌəfaːʐˈʌt̪
خريد	xərˈiːd
سمن	səmˈʌn
صوبن	ʂuːbˈʌn
قد	qˈʌd
مجموعي	mˌəɟmʋˈaːi
نظريي	naʐˈarji
نيو	njˈoː
ووٽ	ʋˈoːʈ
ٽئين	ʈəˈiːn
پيار	pjˈaːr
ڀريل	bʰˈʌrjal
ء	hˈamzah
صنعت	ʂənˈaːt̪
عيوض	ajˈoːz
ماري	mˈaːri
مصنف	mˌəʂənˈʌf
موسيقي	moːsˈiːqi
هڻي	hˈʌɳi
ڪاروبار	kˌaːroːbˈaːr
گهوٽ	ɡəhˈoːʈ
ابتدا	ɪbtˈɪdaː
اڪيڊمي	ˌakiɖˈʌmi
ديني	dˈeːni
عراق	arˈaːq
متعارف	mˌət̪aːrˈʌf
ملين	məlˈiːn
نوڪري	noːkˈʌri
هلندو	həlˈʌndoː
ورتل	ʋˈartal
پيپلز	pˌeːpəlˈʌz
پٽي	pˈʌʈi
گذري	ɡəzˈʌri
تبديلي	t̪ˌəbdˈiːli
جمع	ɟˈʌmaː
حقيقي	həqˈiːqi
سربراھ	sˌərəbrˈaːh
سرن	sərˈʌn
ولي	ʋˈʌli
ٽائون	ʈaːˈoːn
ڪهڙي	kəhˈʌr.i
اڇي	ˈacʰi
اکرن	ˌakʰərˈʌn
بدين	bədˈiːn
بڻيو	bˈʌɳjoː
تقريبن	t̪ˌəqribˈʌn
سينٽ	seːnˈʌʈ
لاڙ	lˈaːr.
مفاصلي	mˌəfaːʂˈʌli
نڪتو	nəkˈʌt̪oː
ورهين	ʋˌərhˈiːn
ڊائريڪٽر	ɖˌaːɪrˌiːkəʈˈʌr
ايمپائر	ˌeːmpaːˈɪr
خالي	xˈaːli
خوراڪ	xoːrˈaːk
دڙو	dˈʌr.oː
محدود	mˌəhdˈuːd
نظريو	naʐˈarjoː
نھ	nh
چوٿين	coːtʰˈiːn
ڪمزور	kˌəmzˈuːr
آفيس	aːfˈiːs
بيبي	bˈeːbˈiː
تيئن	t̪eːˈɪn
خير	xˈeːr
ستن	sət̪ˈʌn
شير	ʃˈeːr
طرز	tərˈʌz
عباسي	abˈaːsi
يادگار	jˌaːdɡˈaːr
پڙهي	pər.ˈʌhi
کاڌو	kʰˈaːdʰoː
ھيون	hjˈoːn
اوارڊ	ˌuːaːrˈʌɖ
ايئن	eːˈɪn
ايراني	eːrˈaːni
برٽش	bˌərəʈˈʌʃ
جملي	ɟˈʊmli
دريا	dˈʌrjaː
سڌي	sˈʌdʰi
مسيح	mˈʌsih
معدي	mˈaːdi
وڌائي	ʋədʰˈaːi
ٻڌائي	bədʰˈaːi
چچ	cˈʌc
کائي	kʰˈaːi
ڪنوار	kənʋˈaːr
گلن	ɡəlˈʌn
اقتدار	ˌɪqtɪdˈaːr
انڪار	ˌankˈaːr
ترڪ	t̪ərˈʌk
تسليم	t̪ˌəslˈiːm
جنس	ɟˈɪns
حڪيم	həkˈiːm
درگاهه	dˌərɡaːhˈʌh
زراعت	zˌəraːˈaːt̪
سدائين	sˌədaːˈiːn
سمورو	səmˈoːroː
سنگ	sˈʌnɡ
صلاحيت	ʂˌəlaːhˈiːt̪
مبارڪ	məbˈaːrək
ملاقات	mˌəlaːqˈaːt
واڌ	ʋˈaːdʰ
ڳالهين	ɡˌaːlhˈiːn
ھئڻ	hˈʌɳ
سومرو	soːmˈʌroː
قبر	qəbˈʌr
معيار	maːjˈaːr
ناھي	nˈaːhi
ٽيم	ʈˈeːm
ٽين	ʈˈeːn
پويان	pʋjˈaːn
گروپ	ɡərˈoːp
گھرجي	ɡʰərˈʌɟi
اٺن	aʈʰˈʌn
اک	ˈakʰ
جدوجهد	ɟˌədoːɟəhˈʌd
رهاڪو	rəhˈaːkoː
سرگرم	sˌarɡˈarm
سمجھيو	sˈamɟʰjoː
لڳندو	ləɡˈʌndoː
وسيع	ʋˈʌsi
ويد	ʋˈeːd
ويهي	ʋˈeːhi
ھزار	həzˈaːr
الخط	ˌaləxˈʌt
جاين	ɟaːˈiːn
دهلي	dəhˈʌli
عبادت	abˈaːdət̪
عبداللطيف	ˌabdˌaːləltˈiːf
نامور	naːmˈoːr
هلندڙ	hˌələndˈʌr.
وڏيون	ʋəɖjˈoːn
ٺاهيو	ʈʰˈaːhjoː
ڀيڻ	bʰˈeːɳ
کوڙ	kʰˈoːr.
ڪيس	kˈeːs
ڪپ	kˈʌp
ھاڻي	hˈaːɳi
برف	bərˈʌf
رس	rˈʌs
سمجهڻ	sˌəməɟəhˈʌɳ
قليچ	qəlˈiːc
مالي	mˈaːli
منظر	mˌanʐˈar
نرم	nərˈʌm
وڌڻ	ʋədʰˈʌɳ
پاسن	paːsˈʌn
پيرن	peːrˈʌn
کانئس	kʰaːnˈʌs
ڪالم	kaːlˈʌm
ڪتابي	kˌɪtaːbˈiː
ڪونهي	koːnˈʌhi
ڪڍيو	kˈʌɖʰjoː
آر	ˈaːr
آرام	aːrˈaːm
جنسي	ɟˈɪnsi
دعوت	daːˈoːt̪
سيٺ	sˈeːʈʰ
هندستاني	hˌɪndəɪstˈaːni
واحد	ʋaːhˈʌd
پهريان	pˌəhərjˈaːn
پوکي	pˈoːkʰi
ڇڏيندا	cʰəɖˈiːndaː
ڏس	ɖˈɪs
ڪارڪن	kˌaːrəkˈʌn
ڪنڊ	kˈʌnɖ
بيگم	bˈeːɡəm
خطاب	xətˈaːb
مطالعو	mˌətaːlˈaːoː
مٺي	mˈʌʈʰi
واٽ	ʋˈaːʈ
ڇڏيا	cʰˈʌɖjaː
ڪلاس	kəlˈaːs
گهرن	ɡˌəhərˈʌn
آغاز	aːɣˈaːz
بيٺل	bˈeːʈʰəl
جاء	ɟˈaː
رھيا	rˈʌhjaː
سهڻي	səhˈʌɳi
شرط	ʃərˈʌt
شھرن	ʃˌəhərˈʌn
مجبور	mˌəɟbˈuːr
مهينا	məhˈiːnaː
پذير	pəzˈiːr
ڄار	ɟˈaːr
ڪين	kˈeːn
بنجي	bənˈʌɟi
تخليق	t̪ˌəxlˈiːq
تو	t̪ˈoː
حصا	hˈʌʂaː
دير	dˈeːr
مناسب	mˌənaːsˈʌb
ميوو	mjʋˈoː
نٿا	nˈʌtʰaː
پهچڻ	pˌəhəcˈʌɳ
ڀت	bʰˈʌt̪
ڳنڍيل	ɡənˈʌɖʰjal
اختلاف	ˌɪxtɪlˈaːf
اوزار	uːzˈaːr
بابا	bˈaːbˈaː
بزرگن	bˈʊzʊɾɡn
جامع	ɟˈaːmeː
جگر	ɟəɡˈʌr
حيات	hjˈaːt̪
خاتمو	xaːt̪ˈʌmoː
روسي	rˈoːsi
سڀئي	səbʰˈʌi
ماني	mˈaːni
هٿان	hətʰˈaːn
وات	ʋˈaːt̪
آثارن	ˌaːsaːrˈʌn
ايوب	eːˈoːb
اڏاوت	ˌaɖaːˈoːt̪
دريافت	dˌərjaːfˈʌt̪
سچل	səcˈʌl
صدين	ʂədˈiːn
فرض	fərˈʌz
قانوني	qaːnˈoːni
مقابلو	mˌəqaːbˈʌloː
منجهس	mˌənəɟəhˈʌs
مٿين	mətʰˈiːn
نمائندگي	nˈʊmaːˈɪndəɡˌiː
وهڪرو	ʋˌəhəkˈʌroː
يونٽ	joːnˈʌʈ
ٻاهرين	bˌaːhərˈiːn
ڊرامن	ɖˌəraːmˈʌn
ڪار	kˈaːr
اقتصادي	ˌɪqtɪʂˈaːdi
انسانن	ɪnsˈaːnn
تصنيف	t̪ˌəʂnˈiːf
جنت	ɟənˈʌt̪
درس	dərˈʌs
رپورٽ	rˌəpoːrˈʌʈ
قدرت	qˌədərˈʌt̪
مارڪيٽ	mˌaːrkˈiːʈ
ٻيٽن	beːʈˈʌn
پوک	pˈoːkʰ
چوٿون	coːtʰˈoːn
ڪريو	kˈʌrjoː
ڪشمير	kˌəʃmˈiːr
ڪلاڪ	kəlˈaːk
ڪيئي	kˈeːi
احساس	ɛhsˈaːs
ايراضي	eːrˈaːzi
تحصيل	t̪əhˈʌʂjal
تيمور	t̪eːmˈoːr
حڪمت	hˌəkəmˈʌt̪
رهيون	rəhjˈoːn
رومن	roːmˈʌn
ساڄي	sˈaːɟi
سومرن	sˌoːmərˈʌn
سياستدان	sjˌaːst̪ədˈaːn
شهري	ʃəhˈʌri
عجيب	aɟˈiːb
عطا	ˈataː
ملندڙ	mˌələndˈʌr.
مولائي	moːlˈaːi
ڇوڙ	cʰˈoːr.
ڪالوني	kaːlˈoːni
اٿن	aʈˈʌn
تر	t̪ˈʌr
جج	ɟˈʌɟ
خاتمي	xaːt̪ˈʌmi
خودمختيار	xˈʊdməxt̪jˌaːr
ديهه	deːhˈʌh
مرض	mərˈʌz
مشڪل	mˌəʃəkˈʌl
مينهن	mˌeːnəhˈʌn
هيٺان	heːʈʰˈaːn
وائرس	ʋˌaːɪrˈʌs
پراڻن	pˌəraːɳˈʌn
پرڳڻي	pˌərəɡˈʌɳi
پيئڻ	peːˈɪɳ
ڪابه	kaːbˈɪh
بغداد	bˌəɣdˈaːd
حمايت	hˌəmaːˈiːt̪
حڪمراني	hˌəkəmrˈaːni
روزاني	roːzˈaːni
صالح	ʂˌaːlˈah
ٺهڻ	ʈʰəhˈʌɳ
ٻوٽو	bˈoːʈoː
پل	pˈʌl
پوڻ	pˈoːɳ
ڏانھن	ɖˈaːnhn
برقرار	bˌərəqrˈaːr
ذريعو	zərˈiːoː
غلط	ɣəlˈʌt
معاشري	maːʃˈʌri
ملندو	məlˈʌndoː
نائب	naːˈɪb
ون	ʋˈʌn
ٻڌڻ	bədʰˈʌɳ
ڊسٽرڪٽ	ɖˌəsəʈˌərəkˈʌʈ
ڊگهي	ɖəɡˈʌhi
ڪڍڻ	kəɖʰˈʌɳ
ھندو	hˈʌndoː
اصولن	ˌʊʂuːlˈʌn
اڳوڻي	aɡˈoːɳi
بيتن	bˈeːt̪ən
جيستائين	ɟˌeːst̪aːˈiːn
زالون	zaːlˈoːn
ساٿي	sˈaːtʰi
سسٽم	sˈɪsʈam
فنڪار	fˌənkˈaːr
مذھب	mˌəzəhˈʌb
ڇهن	cʰəhˈʌn
ڊگهو	ɖəɡˈʌhoː
ڪابل	kaːbˈɪl
آئيني	aːˈiːni
آهيان	aːhjˈaːn
امداد	ˌɪmdˈaːd
جين	ɟˈeːn
حدون	hədˈoːn
رھن	rəhˈʌn
سيڪنڊري	sˌeːkənɖˈʌri
شرح	ʃˌərˈah
ظاھر	ʐaːhˈʌr
مارشل	mˌaːrəʃˈʌl
مذھبي	mˌəzəhbˈiː
من	mˈʌn
نر	nˈʌr
نشاني	nɪʃˈaːni
ويجھو	ʋeːɟˈʌhoː
ٺهي	ʈʰˈʌhi
پتو	pˈʌt̪oː
چيئرمين	ceːˈɪrmˌiːn
ڪميونسٽ	kˌəmjoːnsˈʌʈ
آرين	aːrˈiːn
آهيون	aːhjˈoːn
سرگرمين	sˌarɡˈarmin
شهرت	ʃˌəhərˈʌt̪
صفا	ʂˈʌfaː
فطرت	fˌətərˈʌt̪
قبيلو	qəbˈiːloː
هيٺين	heːʈʰˈiːn
ٽنڊو	ʈˈʌnɖoː
ٽڪر	ʈəkˈʌr
پبلڪ	pˌəbəlˈʌk
کاٻي	kʰˈaːbi
کليل	kʰˈʌljal
کڻڻ	kʰəɳˈʌɳ
آخوند	aːxˈoːnd
تڪليف	t̪ˌəklˈiːf
صادق	ʂaːdˈʌq
طبقي	təbˈʌqi
مديني	mədˈiːni
مهراڻ	mˌəhərˈaːɳ
ڦري	pʰˈʌri
ڪمال	kəmˈaːl
آڳاٽي	aːɡˈaːʈi
انتهائي	ˌɪntɪhˈaːi
اهل	ahˈʌl
ترڪي	t̪ərˈʌki
تصوير	t̪əʂʋˈiːr
خارج	xaːrˈʌɟ
سڌو	sˈʌdʰoː
سک	sˈʌkʰ
عنايت	ˌanaːˈiːt̪
معياري	maːjˈaːri
نصير	nəʂˈiːr
هئو	hˈʌoː
ول	ʋˈʌl
ويل	ʋˈajal
پارڪ	paːrˈʌk
پرڏيهي	pˌərɖˈiːhi
ڏيکاريو	ɖeːkʰˈaːrjoː
ڪلو	kˈʌloː
ھونديون	hoːndjˈoːn
آسٽريليا	ˌaːsəʈrˈiːljaː
امر	amˈʌr
تڪرار	t̪ˌəkrˈaːr
جمال	ɟəmˈaːl
عرف	arˈʌf
فوٽن	foːʈˈʌn
مٿئين	mˌəʈˈiːn
نشين	nəʃˈiːn
نويس	nʋˈeːs
هوائي	hʋˈaːi
ڀيري	bʰˈeːri
ڏهن	ɖəhˈʌn
ڪشش	kəʃˈʌʃ
ارتقا	ˌɪrtˈɪqaː
اوچائي	uːcˈaːi
جڳهه	ɟˌəɡəhˈʌh
روز	rˈoːz
رکيا	rˈʌkʰjaː
سائي	sˈaːi
مقبرو	mˌəqəbˈʌroː
منڊل	mənɖˈʌl
ميمبرن	mˌeːmbərˈʌn
وڪيل	ʋˈʌkjal
ٻاهران	bˌaːhərˈaːn
ڄامشورو	ɟˌaːmʃˈoːroː
ڪاؤنسل	kˌaːa͡ʊnsˈʌl
ڳاڙهي	ɡaːr.ˈʌhi
تصوف	t̪əʂˈoːf
تعريف	t̪aːrˈiːf
جتوئي	ɟət̪ˈoːi
روڪڻ	roːkˈʌɳ
رکندي	rəkʰˈʌndi
ستين	sət̪ˈiːn
سمورن	sˌəmoːrˈʌn
غازي	ɣˈaːzi
نسلي	nəsˈʌli
يار	jˈaːr
چيائين	cjaːˈiːn
ڏيندڙ	ɖeːndˈʌr.
ڪمشنر	kˌəməʃənˈʌr
آڻيندا	aːɳˈiːndaː
اسٽيج	ˌasʈˈiːɟ
اسپين	ˌaspˈiːn
انسٽيٽيوٽ	ˌansəʈiʈjˈoːʈ
دم	dˈʌm
زمانو	zəmˈaːnoː
سٽ	sˈʌʈ
سڃاتو	səɲˈaːt̪oː
شھري	ʃəhˈʌri
فٽ	fˈʌʈ
موقعو	moːqˈaːoː
هدايت	hˌədaːˈiːt̪
پوئين	poːˈiːn
ڀلي	bʰˈʌli
ڏاهر	ɖaːhˈʌr
کولي	kʰˈoːli
ڪاميابي	kˌaːmjaːbˈiː
ڪهڙو	kəhˈʌr.oː
گهرو	ɡəhˈʌroː
آل	ˈaːl
ارب	arˈʌb
تڪ	t̪ˈʌk
جلال	ɟəlˈaːl
جيان	ɟjˈaːn
حبيب	həbˈiːb
روزانو	roːzˈaːnoː
رياستي	rjˈaːst̪i
سراسري	sˌəraːsˈʌri
عيسائي	ˌaisˈaːi
قلمي	qəlˈʌmi
معيشت	maːˈiːʃt̪
هينئر	heːnˈʌr
ٻيلي	bˈeːli
پاڙ	pˈaːr.
پبليڪيشن	pˌəblˌiːkiʃˈʌn
ڊيمي	ɖˈeːmi
اميد	amˈiːd
بطور	bətˈoːr
تماڪ	t̪əmˈaːk
ديبل	deːbˈʌl
راشدي	raːʃˈʌdi
زياده	zjaːdˈʌh
سونهن	sˌoːnəhˈʌn
سوين	sʋˈeːn
شمس	ʃəmˈʌs
صحافي	ʂəhˈaːfi
صحبت	ʂˌəhəbˈʌt̪
لکن	ləkʰˈʌn
مرتب	mˌərət̪ˈʌb
معنا	mˈaːnaː
ميلاپ	meːlˈaːp
هاري	hˈaːri
پٿرن	pˌəʈərˈʌn
ڌر	dʰˈʌr
اميرن	ˌamirˈʌn
بھ	bˈʌh
تارا	t̪ˈaːraː
داڻا	dˈaːɳaː
روم	rˈoːm
فرش	fərˈʌʃ
محقق	mʊhˈaqɪq
مسافر	mˌəsaːfˈʌr
منهنجو	mˌənəhənˈʌɟoː
هجري	həɟˈʌri
هٿن	həʈˈʌn
واڌارو	ʋaːdʰˈaːroː
پد	pˈʌd
ڀائرن	bʰˌaːɪrˈʌn
ڪڏھن	kˌəɖəhˈʌn
گذرڻ	ɡˌəzərˈʌɳ
ھاء	hˈaː
ھٿ	hˈʌʈ
بلڪ	bəlˈʌk
تحرير	t̪ˌəhrˈiːr
تخلص	t̪ˌəxəlˈʌʂ
ثبوت	səbˈoːt̪
رقم	rəqˈʌm
رنگن	rənɡˈʌn
سنڀال	sˌənbʰˈaːl
سوسائٽي	soːsˈaːʈi
علمن	ˌaləmˈʌn
لڳايو	ləɡˈaːjoː
مدار	mədˈaːr
مردن	mərdˈʌn
ملازمت	mˌəlaːzəmˈʌt̪
ناري	nˈaːri
وٽس	ʋəʈˈʌs
ڊيگهه	ɖˌeːɡəhˈʌh
ڪميشن	kˌəmiʃˈʌn
انقلابي	ˌɪnqɪlaːbˈiː
انڪري	ˌanəkˈʌri
ايڪڙ	eːkˈʌr.
اھڙو	ahˈʌr.oː
باقاعدي	bˈaːqˈaːjdi
بينظير	bˈeːnʐˌiːr
تارن	t̪aːrˈʌn
جڙيل	ɟˈʌr.jal
سروس	sərˈoːs
سچ	sˈʌc
طبيعت	təbˈiːt̪
لاهي	lˈaːhi
لاڏاڻو	laːɖˈaːɳoː
لاڳاپو	laːɡˈaːpoː
منصور	mˌənʂˈuːr
مهارت	mˌəhaːrˈʌt̪
هارون	haːrˈoːn
واقعن	ʋaːqˈaːn
واقعو	ʋaːqˈaːoː
واقف	ʋaːqˈʌf
وفاقي	ʋəfˈaːqi
ويٺل	ʋeːʈʰˈʌl
ٽالپرن	ʈˌaːləpərˈʌn
پار	pˈaːr
پيشاب	peːʃˈaːb
پٽن	pəʈˈʌn
چڪر	cəkˈʌr
گھراڻي	ɡʰərˈaːɳi
اسڪولن	ˌaskoːlˈʌn
الهه	ˌaləhˈʌh
اندروني	ˌandərˈoːni
بخاري	bəxˈaːri
برهمڻ	bˌərəhəmˈʌɳ
حرڪت	hˌərəkˈʌt̪
خواهش	xʋaːhˈʌʃ
زميني	zəmˈiːni
ساڻ	sˈaːɳ
سنگهه	sˌənɡəhˈʌh
سڏجڻ	sˌəɖəɟˈʌɳ
لباس	ləbˈaːs
مرشد	mˌərəʃˈʌd
ممتاز	mˌəmt̪ˈaːz
منسوب	mənsˈuːb
موضوعن	moːzʋˈaːn
وڌائڻ	ʋˌədʰaːˈɪɳ
پيئي	pˈeːi
ڀٽي	bʰˈʌʈi
ڏيکاري	ɖeːkʰˈaːri
ڪاميٽي	kaːmˈiːʈi
ڪلهوڙي	kˌəlhˈuːr.i
انصاف	ˌanʂˈaːf
بال	bˈaːl
جهان	ɟəhˈaːn
راجپوت	rˌaːɟpˈoːt̪
رڻ	rˈʌɳ
سيني	sˈeːni
مڃتا	məɲˈʌt̪aː
هيٺيان	heːʈʰjˈaːn
ٻوٽي	bˈoːʈi
پڙهيو	pər.ˈʌhjoː
پڪي	pˈʌki
ڄمڻ	ɟəmˈʌɳ
ڇوڪرين	cʰˌoːkrˈiːn
ڪبو	kəbˈoː
ڪير	kˈeːr
ڳالهائڻ	ɡˌaːlhaːˈɪɳ
اهڙيون	ˌahər.jˈoːn
او	ˈuː
تعلقات	t̪ˌaːləqˈaːt
درويش	dərʋˈiːʃ
ذوالفقار	zʋˌaːləfqˈaːr
رگ	rˈʌɡ
شاخون	ʃaːxˈoːn
صنعتي	ʂənˈaːt̪i
طاقتور	tˌaːqt̪ˈoːr
موڪلي	moːkˈʌli
ناميارو	naːmjˈaːroː
ٺاھي	ʈʰˈaːhi
ڄاڻايو	ɟaːɳˈaːjoː
چڙهي	cər.ˈʌhi
ڏند	ɖˈʌnd
ڪاٺي	kˈaːʈʰi
اکيون	akʰjˈoːn
باھ	bˈaːh
تفصيل	t̪əfˈʌʂjal
جاني	ɟˈaːni
جرمني	ɟˌərəmˈʌni
جهنگ	ɟəhˈʌnɡ
درياء	dˈʌrjaː
دوستن	doːst̪ˈʌn
ساري	sˈaːri
سگهندو	sˌəɡəhˈʌndoː
شاھي	ʃˈaːhi
صحافت	ʂˌəhaːfˈʌt̪
قلات	qˌəlˈaːt
لياقت	ljaːqˈʌt̪
مادو	mˈaːdoː
ملندي	məlˈʌndi
وٺندا	ʋəʈʰˈʌndaː
يونان	joːnˈaːn
پاڙي	pˈaːr.i
پوئتي	poːˈɪt̪i
پيغام	peːɣˈaːm
ڀڳت	bʰəɡˈʌt̪
چانڊيو	cˈaːnɖjoː
ابوذر	abˈoːzər
ادارا	adˈaːraː
الف	alˈʌf
بچي	bˈʌci
تباهه	t̪əbˈaːhəh
توانائي	t̪ʋaːnˈaːi
جاگير	ɟaːɡˈiːr
زڪوات	zˌəkoːˈaːt
سعيد	saːˈiːd
طبي	təbˈiː
عزيز	azˈiːz
فطري	fətˈʌri
قطب	qətˈʌb
مائي	mˈaːi
مريض	mərˈiːz
ناڪام	naːkˈaːm
نون	nˈoːn
وائي	ʋˈaːi
وٺندو	ʋəʈʰˈʌndoː
ٻوٽن	boːʈˈʌn
گروهه	ɡˌəroːhˈʌh
اصلي	aʂˈʌli
بجلي	bəɟˈʌli
بيهي	bˈeːhi
حالتون	hˌaːlt̪ˈoːn
دروازي	dərʋˈaːzi
زيارت	zjaːrˈʌt̪
سرزمين	sˌərəzmˈiːn
سند	sˈʌnd
سٽي	sˈʌʈi
طئي	tˈʌi
عنصر	ˌanəʂˈʌr
لائين	laːˈiːn
لاڙڪاڻو	lˌaːr.kˈaːɳoː
لڳائڻ	lˌəɡaːˈɪɳ
منصوره	mˌənʂuːrˈʌh
نياڻي	njˈaːɳi
واضح	ʋˌaːzˈah
ويب	ʋˈeːb
وٽامن	ʋˌəʈaːmˈʌn
وڏين	ʋəɖˈiːn
ٽيليويزن	ʈˌeːljʋizˈʌn
پيماني	peːmˈaːni
ڀاڻ	bʰˈaːɳ
چوي	cʋˈeː
گلاب	ɡəlˈaːb
آرٽ	aːrˈʌʈ
اسسٽنٽ	ˌasəsˌəʈənˈʌʈ
امان	amˈaːn
بروهي	bərˈoːhi
جاندار	ɟaːndˈaːr
حامي	hˈaːmi
سنت	sənˈʌt̪
لغاري	ləɣˈaːri
مس	mˈʌs
مطالعي	mˌətaːlˈaːi
منعقد	mˌənaːqˈʌd
ميٽرن	mˌeːʈərˈʌn
ٺاهيندا	ʈʰaːhˈiːndaː
ڪرڻو	kərˈʌɳoː
ھنڌ	hˈʌndʰ
آئرلينڊ	ˌaːɪrlˈiːnɖ
اداڪار	ˌadaːkˈaːr
اوچتو	uːcˈʌt̪oː
بحري	bəhˈʌri
بنگال	bənɡˈaːl
بيمار	bˈeːmaːr
جوان	ɟˈaʋaːn
حج	hˈʌɟ
ساٿين	saːtʰˈiːn
سگهجن	sˌəɡəhəɟˈʌn
شعور	ʃaːˈoːr
فني	fˈʌni
ماپ	mˈaːp
مسلسل	mˌəsələsˈʌl
مصري	məʂˈʌri
معمولي	maːmˈoːli
نگر	nəɡˈʌr
وادي	ʋˈaːdi
ورهايو	ʋˌərhˈaːjoː
ويٺا	ʋˈeːʈʰaː
يقين	jəqˈiːn
پاليسي	paːlˈiːsi
پوندا	pˈoːndaː
ڊپٽي	ɖəpˈʌʈi
ڏھ	ɖˈʌh
کوٽ	kʰˈoːʈ
الهندي	ˌaləhˈʌndi
جيتري	ɟeːt̪ˈʌri
جھڙوڪ	ɟˌəhr.ˈoːk
درياه	dərjˈaːh
سالار	saːlˈaːr
سرد	sˈʌrd
صديق	ʂədˈiːq
قبل	qəbˈʌl
قريشي	qərˈiːʃi
لاش	lˈaːʃ
لعل	lˈaːl
ماهوار	maːhʋˈaːr
مضمونن	mˌəzmuːnˈʌn
نار	nˈaːr
هلائي	həlˈaːi
هندوستان	hˌɪnduːst̪ˈaːn
هيڊ	hˈeːɖ
ويڪر	ʋeːkˈʌr
وڪالت	ʋˌəkaːlˈʌt̪
پنجين	pˌənɟˈiːn
پوسٽ	poːsˈʌʈ
ڪائونٽي	kˌaːoːnˈʌʈi
آمد	aːmˈʌd
اخلاقي	ˌaxlˈaːqi
انجام	ˌanɟˈaːm
اڇا	ˈacʰaː
بدن	bədˈʌn
بس	bˈʌs
تازو	t̪ˈaːzoː
تقسيم	t̪ˌəqsˈiːm
تهه	t̪əhˈʌh
حاڪمن	hˌaːkəmˈʌn
خشڪي	xəʃˈʌki
خواب	xʋˈaːb
دائري	daːˈɪri
دائود	daːˈoːd
زميندار	zˌəmindˈaːr
سڪي	sˈʌki
طالب	taːlˈʌb
قادر	qaːdˈʌr
لهي	lˈʌhi
مند	mˈʌnd
مڪاني	məkˈaːni
ورھايل	ʋˌərhˈaːjal
پارسي	paːrˈʌsi
پلي	pˈʌli
ڊالر	ɖaːlˈʌr
ڪوششن	kˌoːʃəʃˈʌn
ڳائي	ɡˈaːi
ڳايو	ɡˈaːjoː
اسٽيٽ	ˌasʈˈiːʈ
انور	anˈoːr
بندي	bˈʌndi
ترخان	t̪ˌərxˈaːn
خوشي	xˈʊʃi
دعا	dˈaː
سينٽي	seːnˈʌʈi
صدارتي	ʂˌədaːrˈʌt̪i
طب	tˈʌb
عقيدي	aqˈiːdi
فاضل	faːzˈʌl
قبرون	qˌəbrˈuːn
قبيلا	qəbˈiːlaː
ميلو	mˈeːloː
ننڍڙا	nˌənəɖʰˈʌr.aː
نوازيو	nˈaʋaːzjˌoː
ٻاھر	baːhˈʌr
پارڪر	pˌaːrəkˈʌr
ڌڪ	dʰˈʌk
ڪپڙا	kəpˈʌr.aː
ڳالهائيندڙ	ɡˌaːlhˌaːindˈʌr.
ھلي	hˈʌli
الزام	ˌɪlzˈaːm
امين	amˈiːn
انٽر	ˌanəʈˈʌr
انڊين	ɪnɖˈiːn
اچ	ˈac
تنھن	t̪ˈʌnhn
جهازن	ɟˌəhaːzˈʌn
حڪمرانن	hˌəkəmraːnˈʌn
خليفو	xəlˈiːfoː
رٽائر	rˌəʈaːˈɪr
سنگھ	sˈʌnɡʰ
سڏبا	sˌəɖbˈaː
ص	sˈʊaːd
عروج	arˈoːɟ
علامت	ˌalaːmˈʌt̪
فقيرن	fˌəqirˈʌn
فهرست	fˌəhərˈʌst̪
مڪران	mˌəkrˈaːn
نيم	nˈeːm
نڪرڻ	nˈɪkrɳ
پروٽين	pˌəroːʈˈiːn
پنهنجون	pʌ̃hnɟˈoːn
پوکڻ	poːkʰˈʌɳ
پٺاڻ	pəʈʰˈaːɳ
چونڊجي	coːnɖˈʌɟi
ڳڙهه	ɡˌər.əhˈʌh
اجلاس	ˌaɟlˈaːs
اھن	ahˈʌn
بت	bˈʌt̪
تبليغ	t̪ˌəblˈiːɣ
تنهنجي	t̪ˌənəhənˈʌɟi
خاني	xˈaːni
ذائقي	zaːˈɪqi
زوال	zʋˈaːl
سربراهه	sˌərəbraːhˈʌh
سرشتي	sərˈʌʃt̪i
سيمينٽ	sˌeːminˈʌʈ
شڪ	ʃˈʌk
طريقن	tˌəriqˈʌn
ظاهري	ʐaːhˈʌri
لاطيني	laːtˈiːni
لکندو	ləkʰˈʌndoː
مسئلو	məsˈʌloː
مقبوليت	mˌəqbˈuːlit̪
ٺاھيو	ʈʰˈaːhjoː
ٿرپارڪر	ʈˌərpˌaːrəkˈʌr
چونڊيل	cˈoːnɖjal
کنيو	kʰˈʌnjoː
کوٽائي	kʰoːʈˈaːi
ڪوڊ	kˈoːɖ
آندا	ˈaːndaː
اتفاق	ˌɪtɪfˈaːq
استادن	ˌast̪aːdˈʌn
اڇو	ˈacʰoː
بئنڪ	bənˈʌk
بهار	bəhˈaːr
بيٺو	bˈeːʈʰoː
تنظيمن	t̪ˌənʐimˈʌn
جيئي	ɟˈeːi
داس	dˈaːs
دليل	dˈʌljal
دوا	dʋˈaː
روپيا	rˈoːpjaː
زنده	zˈɪndh
زهر	zəhˈʌr
عباس	abˈaːs
غور	ɣˈoːr
فرقي	fərˈʌqi
لوڻ	lˈoːɳ
مسئلا	məsˈʌlaː
مقدس	mˌəqədˈʌs
ميونسپل	mjˌoːnsəpˈʌl
نڪ	nˈʌk
همت	həmˈʌt̪
ويجهي	ʋeːɟˈʌhi
ٺاھڻ	ʈʰaːhˈʌɳ
چمڙي	cəmˈʌr.i
ڏک	ɖˈʌkʰ
کٽي	kʰˈʌʈi
ڪر	kˈʌr
ڪنٽرول	kˌənəʈrˈoːl
گهڻيون	ɡˌəhəɳjˈoːn
ﷺ	lˈetəˈefdˈiːˈefˈeːj
آرٽس	ˌaːrəʈˈʌs
اقبال	ˌaqbˈaːl
امڪان	ˌamkˈaːn
اچار	acˈaːr
تارو	t̪ˈaːroː
دراصل	dˌəraːʂˈʌl
سڏين	səɖˈiːn
فضل	fəzˈʌl
لاڙو	lˈaːr.oː
مختيار	məxt̪jˈaːr
مور	mˈoːr
ميڊيا	mˈeːɖjaː
نما	nˈʊmaː
ننڍيون	nˌənɖʰjˈoːn
هجرت	hˌəɟərˈʌt̪
هنر	hənˈʌr
ٺاهه	ʈʰaːhˈʌh
ٻائي	bˈaːi
پائي	pˈaːi
پناهه	pˌənaːhˈʌh
ٿري	ʈˈʌri
ڇڏڻ	cʰaɖˈɪɳʊ
ڊرامو	ɖərˈaːmoː
ڪرڪيٽ	kˌərkˈiːʈ
ڪيترو	keːt̪ˈʌroː
ڪپڙو	kəpˈʌr.oː
آسٽريا	ˌaːsəʈˈʌrjaː
ارغون	ˌarɣˈoːn
اسحاق	ˌashˈaːq
البت	ˌaləbˈʌt̪
انڙ	anˈʌr.
ايسٽ	eːsˈʌʈ
اينديون	eːndjˈoːn
ايوان	eːʋˈaːn
جيت	ɟˈeːt̪
ذهني	zəhˈʌni
زخمي	zəxˈʌmi
سري	sˈʌri
سمورا	səmˈoːraː
شھدادڪوٽ	ʃˌəhdˌaːdkˈoːʈ
عبدالمجيد	ˌabdˌaːləmɟˈiːd
عدالت	ˌadaːlˈʌt̪
قومون	qoːmˈoːn
لوڪل	loːkˈʌl
لڙائي	lər.ˈaːi
ملهه	mˌələhˈʌh
نامياري	naːmjˈaːri
نشر	nəʃˈʌr
نڪرندو	nˈɪkrndoː
وائيس	ʋaːˈiːs
وحدت	ʋˌəhədˈʌt̪
ڇھ	cʰˈʌh
ڊيم	ɖˈeːm
ڏاڍا	ɖˈaːɖʰaː
آئون	ˈaːũː
ابڙو	abˈʌr.oː
اسرائيل	ˌasrˈaːjal
اميدوار	ˌamidʋˈaːr
اندازي	andˈaːzi
انکي	anˈʌkʰi
بحال	bəhˈaːl
درياھ	dərjˈaːh
دلچسپ	dˌɪlcˈasp
ديوار	djʋˈaːr
دڪان	dəkˈaːn
زير	zˈeːr
سلوڪ	səlˈoːk
سينٽر	sˌeːnəʈˈʌr
عالمگير	ˌaːləmɡˈiːr
عبدالرحمان	ˌabdˌaːlərˌəhmˈaːn
لفظي	ləfˈʌʐi
مقالا	məqˈaːlaː
منھن	mˈʌnhn
مهم	məhˈʌm
نقل	nəqˈʌl
ويڙهه	ʋˌeːr.əhˈʌh
ٻارهن	bˌaːrəhˈʌn
پروگرامن	pˌəroːɡraːmˈʌn
پکڙجي	pˌəkʰər.ˈʌɟi
چانهه	cˌaːnəhˈʌh
ڇڏيائين	cʰˌəɖjaːˈiːn
ڪوٺيو	kˈoːʈʰjoː
ڪينسر	keːnsˈʌr
ڳالهائي	ɡˌaːlhˈaːi
ھندستان	hˌəndəˈɪstaːn
ايف	ˈeːf
اٿارٽي	ˌatʰaːrˈʌʈi
بنايو	bənˈaːjoː
بيهڪ	bˈeːhək
تحفظ	t̪ˌəhəfˈʌʐ
جارج	ɟaːrˈʌɟ
جھڙي	ɟəhˈʌr.i
رھندو	rəhˈʌndoː
سليمان	sˌəlimˈaːn
سوانح	sʋˌaːnˈah
سومري	soːmˈʌri
سياحت	sjaːhˈʌt̪
ظلم	ʐəlˈʌm
فوت	fˈoːt̪
فوجن	foːɟˈʌn
لاڳاپن	lˌaːɡaːpˈʌn
مغربي	mˈaɣrˌɪbi
مفت	məfˈʌt̪
ننگر	nənɡˈʌr
ورهايل	ʋˌərhˈaːjal
ٻانهن	bˌaːnəhˈʌn
ٻيھر	beːhˈʌr
پڙهيل	pər.ˈʌhjal
ڀاڱن	bʰˌaːŋ̩ˈʌn
چارلس	cˌaːrəlˈʌs
چوندو	cˈoːndoː
ڇڏيندو	cʰəɖˈiːndoː
ڪامريڊ	kˌaːmrˈiːɖ
ڪثرت	kˌəsərˈʌt̪
ڪندڙن	kˌəndər.ˈʌn
ڪٿا	kˈʌtʰaː
گرھ	ɡərˈʌh
گم	ɡˈʌm
ڳولا	ɡˈoːlaː
آخرڪار	ˌaːxərkˈaːr
جمالي	ɟəmˈaːli
حڪومتي	hˌəkoːmˈʌt̪i
درست	dərˈʌst̪
دروازو	dərʋˈaːzoː
سائو	sˈaːoː
ساهه	saːhˈʌh
سوا	sʋˈaː
شئي	ʃˈʌi
شاندار	ʃaːndˈaːr
فريئر	fˌəriˈɪr
مارڻ	maːrˈʌɳ
ماضي	mˈaːzi
محبوب	mˌəhbˈuːb
ملهايو	mˌəlhˈaːjoː
ميڊيڪل	mˌeːɖikˈʌl
نيڪ	nˈeːk
نڪرندڙ	nɪkrndˈʌr.
وهي	ʋˈʌhi
پنجاهه	pˌənɟaːhˈʌh
ڏاڏو	ɖˈaːɖoː
ڪاهي	kˈaːhi
ڪنارن	kˌənaːrˈʌn
ڪهاڻيڪار	kˌəhaːɳikˈaːr
ڪوششون	kˌoːʃʃˈoːn
آھستي	aːhˈʌst̪i
اڄڪلهه	ˌaɟəkˌələhˈʌh
اڍائي	aɖʰˈaːi
بلاول	bˌəlaːˈoːl
تجويز	t̪əɟʋˈiːz
جھاز	ɟəhˈaːz
خسرو	xəsˈʌroː
خطن	xətˈʌn
رضي	rˈʌzi
رمضان	rˌəmzˈaːn
رپيو	rˈʌpjoː
سردارن	sˌərdaːrˈʌn
سگھن	səɡʰˈʌn
طلب	təlˈʌb
عقيدو	aqˈiːdoː
قلندر	qˌələndˈʌr
لکين	ləkʰˈiːn
لڪ	lˈʌk
مددگار	mˌədədɡˈaːr
مزاج	məzˈaːɟ
مهيا	mˈʌhjaː
مين	mˈeːn
هئائين	hˌəaːˈiːn
هفتي	həfˈʌt̪i
هليا	hˈʌljaː
والدين	ʋˌaːldˈiːn
ڏجي	ɖˈʌɟi
ڏسجي	ɖɪsˈʌɟi
ڪڻڪ	kəɳˈʌk
گرو	ɡˈʌroː
گرين	ɡərˈiːn
اسم	ˈɪsm
انٽرنيشنل	ˌanəʈˌərnˌiːʃənˈʌl
بندوبست	bˌənduːbˈʌst̪
بچائڻ	bˌəcaːˈɪɳ
جائزو	ɟaːˈɪzoː
جوڳي	ɟˈoːɡi
حجاج	həɟˈaːɟ
حرف	hərˈʌf
زبردست	zˌəbərdˈʌst̪
سوراخ	soːrˈaːx
شهادت	ʃˌəhaːdˈʌt̪
شو	ʃˈoː
صلاحڪار	ʂˌəlaːhkˈaːr
عبدالرحيم	ˌabdˌaːlərhˈiːm
عقل	aqˈʌl
لغت	ləɣˈʌt̪
ماستر	maːst̪ˈʌr
موتي	mˈoːt̪i
نانگ	nˈaːnɡ
هالا	hˈaːlaː
هت	hˈʌt̪
هلڻ	həlˈʌɳ
واسطي	ʋaːsˈʌti
پنهور	pˌənhˈuːr
ڏاڏي	ɖˈaːɖi
ڏياري	ɖjˈaːri
ڦاڪ	pʰˈaːk
ڪارا	kˈaːraː
ڪوئي	kˈoːi
آدمشماري	ˌaːdəmˌəʃmˈaːri
اشاعت	ˌaʃaːˈaːt̪
انچن	ancˈʌn
بخار	bəxˈaːr
بلندي	bəlˈʌndi
جسماني	ɟˌəsmˈaːni
جهلي	ɟəhˈʌli
دفعي	dəfˈaːi
ريل	rˈeːl
سرشتو	sərˈʌʃt̪oː
سفيد	səfˈiːd
سوار	sʋˈaːr
سين	sˈeːn
شعبن	ʃˈɔbn
صلح	ʂˌəlˈah
فساد	fəsˈaːd
قرض	qərˈʌz
قصي	qˈʌʂi
لئنگئيج	lˌənɡəˈiːɟ
ماء	mˈaː
مهمان	mˌəhəmˈaːn
مڃيو	mˈʌɲjoː
ننڊ	nˈʌnɖ
نو	nˈoː
هلندي	həlˈʌndi
هوس	hˈoːs
والده	ʋˌaːlədˈʌh
ويهه	ʋeːhˈʌh
ويچار	ʋeːcˈaːr
وڻندڙ	ʋˌəɳəndˈʌr.
ٽڪرا	ʈəkˈʌraː
پراڻا	pərˈaːɳaː
چاهي	cˈaːhi
چرچ	cˈʌrc
ڏاکڻي	ɖaːkʰˈʌɳi
ڪميٽي	kəmˈiːʈi
گهڻائي	ɡˌəhəɳˈaːi
گڏي	ɡˈʌɖi
اشارو	aʃˈaːroː
اعتبار	ˌeːtɪbˈaːr
انٽرنيٽ	ˌanəʈˌərnˈiːʈ
انگن	anɡˈʌn
ايما	ˈeːmaː
تغلق	t̪ˌəɣəlˈʌq
جوڙڻ	ɟoːr.ˈʌɳ
درد	dˈʌrd
دوائن	dʋaːˈɪn
رواجي	rʋˈaːɟi
رومي	rˈoːmi
سهڻو	səhˈʌɳoː
عهدن	ˌahədˈʌn
فراهم	fˌəraːhˈʌm
فلمي	fˈɪlmi
محرم	mˌəhərˈʌm
مظاهرو	mˌəʐaːhˈʌroː
معروف	maːrˈoːf
منڇر	mˌənəcʰˈʌr
ميلي	mˈeːli
واھ	ʋˈaːh
ورثي	ʋərˈʌsi
وڃ	ʋˈʌɲ
پابندي	paːbˈʌndi
پڪو	pˈʌkoː
ڀٽ	bʰˈʌʈ
ڪاهه	kaːhˈʌh
ڪلاسيڪي	kˌəlaːsˈiːki
گهري	ɡəhˈʌri
اٺين	aʈʰˈiːn
اڪيلو	akˈiːloː
برج	bərˈʌɟ
برقي	bərˈʌqi
بنائڻ	bˌənaːˈɪɳ
بهرحال	bˌəhərhˈaːl
تازي	t̪ˈaːzi
تقرير	t̪ˌəqrˈiːr
داخلا	daːxˈʌlaː
دستور	dəst̪ˈuːr
رسمن	rˌəsəmˈʌn
ساٿ	sˈaːʈ
ساڍا	sˈaːɖʰaː
فريد	fərˈiːd
لارڊ	laːrˈʌɖ
لطف	lətˈʌf
لکيائين	lˌəkʰjaːˈiːn
معصوم	maːʂˈoːm
ملازم	mˌəlaːzˈʌm
ميوزڪ	mjoːzˈʌk
ٽاور	ʈaːˈoːr
پرنسپال	pˌərənsəpˈaːl
پندرهن	pˌəndərəhˈʌn
ڀريو	bʰˈʌrjoː
چوٽي	cˈoːʈi
ڇت	cʰˈʌt̪
ڊگها	ɖəɡˈʌhaː
ڏاڙھون	ɖaːr.hˈoːn
گاھ	ɡˈaːh
آتم	aːt̪ˈʌm
ائنڊ	aːˈɪnɖ
بنيادن	bˌənjaːdˈʌn
جناح	ɟˈʌnaːh
ديوارن	djʋaːrˈʌn
راضي	rˈaːzi
رهجي	rəhˈʌɟi
سومرا	soːmˈʌraː
شهباز	ʃˌəhəbˈaːz
غالب	ɣaːlˈʌb
فرانسيسي	fˌəraːnsˈiːsi
فرينچ	fərˈiːnc
فلمون	fˈɪlmuːn
لکڻين	lˌəkʰɳˈiːn
مسئلي	məsˈʌli
میں	mˈiːmjˈeːlˈetəcʰˈahabˈiːˈeːj
ناچ	nˈaːc
نگراني	nˌəɡrˈaːni
وابسته	ʋˌaːbəst̪ˈʌh
واڌاري	ʋaːdʰˈaːri
ورلڊ	ʋˌərəlˈʌɖ
وليم	ʋəlˈiːm
وچولي	ʋəcˈoːli
پهچائڻ	pˌəhəcaːˈɪɳ
ڀائر	bʰaːˈɪr
ڌڻي	dʰˈʌɳi
ڪيميائي	keːmjˈaːi
ڪٽنب	kəʈˈʌnb
گذريل	ɡəzˈʌrjal
آ	ˈaː
آيون	aːjˈoːn
ابڙي	abˈʌr.i
اندران	ˌandərˈaːn
اوچو	ˈuːcoː
برداشت	bərdˈaːʃt̪
بغير	bəɣˈiːr
تيزي	t̪ˈeːzi
تھھ	t̪əhˈʌh
جاندارن	ɟˌaːndaːrˈʌn
جسٽس	ɟˌəsəʈˈʌs
ديوتائن	djˌoːt̪aːˈɪn
رنگين	rənɡˈiːn
رھندا	rəhˈʌndaː
شان	ʃˈaːn
عبدالڪريم	ˌabdˌaːləkrˈiːm
عدد	adˈʌd
فارم	faːrˈʌm
فرسٽ	fˌərəsˈʌʈ
فرمايو	fˌərmˈaːjoː
مجلس	mˌəɟəlˈʌs
نوجوانن	nˌoːɟʋaːnˈʌn
هلائڻ	hˌəlaːˈɪɳ
ولادت	ʋˌəlaːdˈʌt̪
وڌندو	ʋədʰˈʌndoː
ٻيڙين	beːr.ˈiːn
پوٽي	pˈoːʈi
ڊيگھ	ɖˈeːɡʰ
کوهه	kʰoːhˈʌh
ڪلاڪن	kˌəlaːkˈʌn
گھڻا	ɡʰˈʌɳaː
آپريشن	ˌaːpriʃˈʌn
اڳواڻي	aɡʋˈaːɳi
جايون	ɟaːjˈoːn
جوڙيو	ɟˈoːr.joː
درجا	dˈarɟaː
رکيائين	rˌəkʰjaːˈiːn
سوڄ	sˈoːɟ
سيڪنڊ	seːkˈʌnɖ
سٺا	sˈʌʈʰaː
عڪس	akˈʌs
مثاني	məsˈaːni
مرحلي	mˌərəhˈʌli
موسيقار	mˌoːsiqˈaːr
مٿيون	mətʰjˈoːn
مڃڻ	məɲˈʌɳ
نادر	naːdˈʌr
هڪدم	hˌəkədˈʌm
ٻرندڙ	bˌərəndˈʌr.
پئسا	pˈʌsaː
پرورش	pˌəroːrˈʌʃ
پڪ	pˈʌk
کپي	kʰˈʌpi
ڪليڪٽر	kˌəlikəʈˈʌr
گردش	ɡərdˈʌʃ
آندي	ˈaːndi
اداڪاري	ˌadaːkˈaːri
ارادو	arˈaːdoː
ارجن	ˌarəɟˈʌn
اروڙ	arˈoːr.
اورنگزيب	ˌuːrənɡəzˈiːb
تار	t̪ˈaːr
جوڙيل	ɟˈoːr.jal
جوڻيجو	ɟoːɳˈiːɟoː
جيو	ɟjˈoː
جڳ	ɟˈʌɡ
ذاتين	zaːt̪ˈiːn
سادي	sˈaːdi
سهڪار	sˌəhəkˈaːr
سينٽرل	sˌeːnəʈərˈʌl
سڪرنڊ	sˌəkərˈʌnɖ
شاهجهان	ʃˌaːhəɟhˈaːn
شخصيتن	ʃˈaxʂit̪ˌən
عضون	azˈoːn
عهد	ahˈʌd
لغوي	lˈʌɣʋi
محاذ	məhˈaːz
مستقبل	mˌəst̪əqəbˈʌl
معاملي	maːmˈʌli
مقصدن	mˌəqəʂədˈʌn
ممبئي	məmbˈʌi
مٺو	mˈʌʈʰoː
نامي	nˈaːmi
نمونا	nəmˈoːnaː
نمونن	nˌəmoːnˈʌn
نيون	njˈoːn
هاشم	haːʃˈʌm
والي	ʋˈaːli
ور	ʋˈʌr
وسيلن	ʋˌəsilˈʌn
ٻاراڻي	baːrˈaːɳi
پهتا	pəhˈʌt̪aː
پون	pˈoːn
پيشي	pˈeːʃi
ڀارتي	bʰaːrˈʌt̪i
کے	kʰˈʌeː
ڪانہ	kaːnˈʌh
گهٽجي	ɡˌəhəʈˈʌɟi
گوگل	ɡoːɡˈʌl
ھوا	hʋˈaː
آيت	aːˈiːt̪
اسٽالن	ˌasʈaːlˈʌn
اور	ˈuːr
ايئر	eːˈɪr
اڀرندي	ˌabʰərˈʌndi
بلڪه	bˌələkˈʌh
ترجمي	t̪ˌərəɟˈʌmi
توکي	t̪ˈoːkʰi
جت	ɟˈʌt̪
جعفر	ɟaːfˈʌr
جنيد	ɟənˈiːd
جوش	ɟˈoːʃ
جوڙ	ɟˈoːr.
جوڙجڪ	ɟˌoːr.əɟˈʌk
حاضر	haːzˈʌr
درخواست	dˌarxʋˈaːst
دروازا	dərʋˈaːzaː
راهه	raːhˈʌh
ريجن	reːɟˈʌn
زمينون	zˌəminˈoːn
سائنسدان	sˌaːɪnsədˈaːn
سجاول	sˌəɟaːˈoːl
سمجھي	sˈamɟʰi
سوشلسٽ	sˌoːʃələsˈʌʈ
ضلعا	zˈʌlaː
طبع	təbˈaː
عمرڪوٽ	ˈʊmrkoːʈ
فائز	faːˈɪz
قطار	qətˈaːr
قيادت	qjaːdˈʌt̪
لڳڻ	ləɡˈʌɳ
مڊل	məɖˈʌl
مھيني	məhˈiːni
نئي	nˈʌi
نازل	naːzˈʌl
ناولن	nˌaːoːlˈʌn
نفسياتي	nˌəfsjˈaːt̪i
نقش	nəqˈʌʃ
نڪاح	nˈʌkaːh
هئس	hˈʌs
هائوس	haːˈoːs
هين	hˈeːn
ورهائي	ʋˌərhˈaːi
ولايت	ʋˌəlaːˈiːt̪
پورا	pˈoːraː
ڏهاڪي	ɖəhˈaːki
ڦل	pʰˈʌl
ڪرايا	kərˈaːjaː
گنگا	ɡˈʌnɡaː
گوتم	ɡoːt̪ˈʌm
گولي	ɡˈoːli
الاسلام	alˌɪslˈaːm
باڪو	bˈaːkoː
برادري	bˌəraːdˈʌri
بچائي	bəcˈaːi
تصويرون	t̪ˌəʂʋirˈoːn
تڏھن	t̪ˌəɖəhˈʌn
ثقل	səqˈʌl
حيرت	heːrˈʌt̪
راز	rˈaːz
روزگار	rˌoːzɡˈaːr
سعودي	saːˈoːdi
سگهيا	səɡˈʌhjaː
شري	ʃˈʌri
عارضي	aːrˈʌzi
قطر	qətˈʌr
مدرسو	mˌədərˈʌsoː
مرمت	mˌərəmˈʌt̪
مهينو	məhˈiːnoː
نصرپور	nˌəʂərpˈoːr
نيوٽن	njoːʈˈʌn
هارين	haːrˈiːn
هزارن	hˌəzaːrˈʌn
وضاحت	ʋˌəzaːhˈʌt̪
پرديش	pərdˈiːʃ
پرست	pərˈʌst̪
پيون	pjˈoːn
پڙ	pˈʌr.
ڀٽائي	bʰəʈˈaːi
ڇهين	cʰəhˈiːn
کوجنا	kʰoːɟˈʌnaː
ڪرم	kərˈʌm
گذريا	ɡəzˈʌrjaː
بدر	bədˈʌr
بني	bˈʌni
تشدد	t̪ˌəʃədˈʌd
تيستائين	t̪ˌeːst̪aːˈiːn
ثاني	sˈaːni
خانبهادر	xˌaːnbəhaːdˈʌr
خوف	xˈoːf
دستن	dəst̪ˈʌn
راندين	raːndˈiːn
زمينن	zˌəminˈʌn
زڪام	zəkˈaːm
سائنسدانن	sˌaːɪnsˌədaːnˈʌn
سازش	saːzˈʌʃ
شديد	ʃədˈiːd
عثماني	ˌasmˈaːni
غار	ɣˈaːr
فار	fˈaːr
قصو	qˈʌʂoː
لڳاتار	lˌəɡaːt̪ˈaːr
مائل	maːˈɪl
ماسٽر	mˌaːsəʈˈʌr
ماڊل	maːɖˈʌl
مصروف	mˌəʂrˈuːf
منجهن	mˌənəɟəhˈʌn
ننڍين	nˌənɖʰˈiːn
نوري	nˈoːri
همعصر	hˌəmaːʂˈʌr
وڄائڻ	ʋˌəɟaːˈɪɳ
ٺاهيل	ʈʰˈaːhjal
ٻڌو	bˈʌdʰoː
پنجون	pˌənɟˈuːn
پڇ	pˈʌcʰ
ڀائي	bʰˈaːi
چندر	cəndˈʌr
چڪيون	cəkjˈoːn
ڊيٽا	ɖˈeːʈaː
ڏوھ	ɖˈoːh
کا	kʰˈaː
گهرائي	ɡˌəhərˈaːi
اخلاق	ˌaxlˈaːq
افغان	ˌafɣˈaːn
انسائيڪلوپيڊيا	ˌansaːˌiːkloːpˈiːɖjaː
انڊس	ˈɪnɖas
اڳواڻن	ˌaɡʋaːɳˈʌn
بدلي	bədˈʌli
بھترين	bˌəhət̪rˈiːn
تحليل	t̪əhˈʌljal
جلدي	ɟəlˈʌdi
حياتي	hjˈaːt̪i
خوب	xˈoːb
رحم	rəhˈʌm
رشيد	rəʃˈiːd
روايتون	rʋˌaːit̪ˈoːn
زالن	zaːlˈʌn
سروي	sˈʌrʋi
سيٽ	sˈeːʈ
سپريم	sˌəprˈiːm
سگهو	səɡˈʌhoː
شراب	ʃərˈaːb
ــ	lˈetəcʰˈahacˈaːrbˈʊr.ilˈetəcʰˈahacˈaːrbˈʊr.i
لاڳاپا	laːɡˈaːpaː
لکيون	ləkʰjˈoːn
ملا	mˈʌlaː
ميداني	meːdˈaːni
نوابشاهه	nˈaʋaːbʃaːhˌəh
نيڪال	neːkˈaːl
هٿيار	hətʰjˈaːr
وهندو	ʋəhˈʌndoː
وڪرو	ʋəkˈʌroː
ٽيڪنالاجي	ʈˌeːknaːlˈaːɟi
پاڙون	paːr.ˈoːn
پراڪرت	pˌəraːkərˈʌt̪
ڇوڪري	cʰoːkˈʌri
ڌرمي	dʰərˈʌmi
ڏهين	ɖəhˈiːn
ڏيکاريل	ɖeːkʰˈaːrjal
ڪيفيت	keːfˈiːt̪
گئس	ɡˈʌs
گهاٽي	ɡəhˈaːʈi
آسان	aːsˈaːn
اصلاح	ˌɪʂlˈaːh
الحق	ˌaləhˈʌq
اھميت	ˌahmˈiːt̪
بشير	bəʃˈiːr
بلوچن	bˌəloːcˈʌn
بنو	bˈʌnoː
تصديق	t̪ˌəʂdˈiːq
جهڙن	ɟˌəhər.ˈʌn
حب	hˈʌb
خون	xˈoːn
درج	dˈarɟ
دوستي	dˈoːst̪i
رستن	rəst̪ˈʌn
رضا	rˈʌzaː
سانگي	sˈaːnɡi
سگهون	sˌəɡhˈuːn
صدارت	ʂˌədaːrˈʌt̪
عبدالقادر	ˌabdˌaːlqaːdˈʌr
فائديمند	fˌaːɪdimˈʌnd
ماڳن	maːɡˈʌn
محققن	mʊhˈaqɪqn
مرڪب	mˌərəkˈʌb
مشين	məʃˈiːn
مقبري	mˌəqəbˈʌri
منظم	mˌənəʐˈʌm
ناس	nˈaːs
هري	hˈʌri
هوء	hˈoː
يزيد	jəzˈiːd
ٻيڙي	bˈeːr.i
ڄاڻو	ɟˈaːɳoː
ڦٽي	pʰˈʌʈi
گرامر	ɡˌəraːmˈʌr
گهٽتائي	ɡˌəhəʈt̪ˈaːi
گهڙي	ɡəhˈʌr.i
آئس	aːˈɪs
آريا	ˈaːrjaː
آمدني	ˌaːmədˈʌni
آڪسيجن	ˌaːksiɟˈʌn
تبديليون	t̪ˌəbdiljˈoːn
جمهوري	ɟˌəmhˈuːri
جهنگلي	ɟˌəhənɡˈʌli
جهڙيون	ɟˌəhər.jˈoːn
خانداني	xaːndˈaːni
خطرناڪ	xˌətərnˈaːk
راجپوتن	rˌaːɟpoːt̪ˈʌn
ري	rˈeː
رھڻ	rəhˈʌɳ
زبانن	zəbˈaːnən
زمان	zəmˈaːn
سني	sˈʌni
سيٽون	seːʈˈoːn
سکن	səkʰˈʌn
عملدار	ˌaməldˈaːr
عھدي	ahˈʌdi
لاڳيتو	laːɡˈiːt̪oː
لڳندا	ləɡˈʌndaː
ماتحت	mˌaːt̪əhˈʌt̪
مارڪس	mˌaːrəkˈʌs
ماڪڙ	maːkˈʌr.
مروج	mərˈoːɟ
مٿاڇري	mˌətʰaːcʰˈʌri
مٿن	məʈˈʌn
ناڻي	nˈaːɳi
هلڪي	həlˈʌki
ٻوٽا	bˈoːʈaː
پشاور	pˌəʃaːˈoːr
چانسلر	cˌaːnsəlˈʌr
چونڊي	cˈoːnɖi
کهاوڙ	kʰˌəhaːˈoːr.
ڪامل	kaːmˈʌl
ڪلب	kəlˈʌb
ڪمي	kˈʌmi
ڪنڊن	kənɖˈʌn
ڪيتري	keːt̪ˈʌri
گذارڻ	ɡˌəzaːrˈʌɳ
گذر	ɡəzˈʌr
آبپاشي	ˌaːbpˈaːʃi
آفيسرن	ˌaːfisərˈʌn
احترام	ˌɛht̪ərˈaːm
اسماعيلي	ˌasmˌaːaːˈiːli
اصطلاحن	ˌɪʂtɪlaːhˈʌn
الور	alˈoːr
انجمن	ˌanəɟəmˈʌn
اونهاري	ˌuːnhˈaːri
ايسوسيئيشن	ˌeːsoːsˌiːiʃˈʌn
ايمان	eːmˈaːn
برصغير	bˌərəʂɣˈiːr
بيحد	bˈeːhəd
تجارتي	t̪ˌəɟaːrˈʌt̪i
تجربو	t̪ˌəɟərbˈoː
تري	t̪ˈʌri
جڳھ	ɟəɡˈʌh
جھڙو	ɟəhˈʌr.oː
دارومدار	dˌaːroːmdˈaːr
رحيمداد	rˌəhimdˈaːd
رياستون	rjaːst̪ˈoːn
ساحلي	saːhˈʌli
سانوڻ	saːnˈoːɳ
سرائڪي	sˌəraːˈɪki
سڀا	sˈʌbʰaː
شعري	ʃˈaːri
فخر	fəxˈʌr
فلسطين	fˌələstˈiːn
فيصلي	feːʂˈʌli
لائن	laːˈɪn
مادري	maːdˈʌri
معاهدي	maːhˈʌdi
منظوم	mˌənʐˈuːm
مک	mˈʌkʰ
نسلن	nˌəsəlˈʌn
نيوز	njˈoːz
هرهڪ	hˌərəhˈʌk
وارث	ʋaːrˈʌs
واقعا	ʋˈaːqaː
ويهڻ	ʋeːhˈʌɳ
وڌندڙ	ʋˌədʰəndˈʌr.
ٺھڻ	ʈʰəhˈʌɳ
پليٽ	pəlˈiːʈ
پوٽو	pˈoːʈoː
ٿڌي	ʈˈʌdʰi
چاهه	caːhˈʌh
ڌاتو	dʰˈaːt̪oː
ڌرين	dʰərˈiːn
ڪلڪتي	kˌələkˈʌt̪i
ڪمانڊر	kˌəmaːnɖˈʌr
اصطلاحي	ˌɪʂtɪlˈaːhi
ترجما	t̪ˌərəɟˈʌmaː
تعاون	t̪aːˈoːn
جاکوڙ	ɟaːkʰˈoːr.
حملا	həmˈʌlaː
دمشق	dˌəməʃˈʌq
ديو	djˈoː
رومانوي	roːmˈaːnʋi
سپاهي	səpˈaːhi
شيدائي	ʃeːdˈaːi
عاشق	aːʃˈʌq
عاليشان	ˌaːliʃˈaːn
عمارتن	ˌamaːrət̪ˈʌn
فائدي	faːˈɪdi
قدامت	qˌədaːmˈʌt̪
قنڌار	qəndʰˈaːr
قيمتي	qeːmˈʌt̪i
لسانيات	lˌəsaːniˈaːt
ليکڪن	lˌeːkʰəkˈʌn
لڪي	lˈʌki
لڳن	ləɡˈʌn
لڳندي	ləɡˈʌndi
محترم	mˌəhət̪ərˈʌm
ميران	meːrˈaːn
نفرت	nˌəfərˈʌt̪
نڪرن	nˈɪkrn
هفتيوار	hˌəft̪jʋˈaːr
هيس	hˈeːs
هڻڻ	həɳˈʌɳ
ٺاهيا	ʈʰˈaːhjaː
ٻڪري	bəkˈʌri
پرچار	pərcˈaːr
ڇوڪرن	cʰˌoːkərˈʌn
ڇڏجي	cʰəɖˈʌɟi
ڊپ	ɖˈʌp
ڦٽن	pʰəʈˈʌn
ڪئنال	kənˈaːl
ڪئناڊا	kənˈaːɖaː
ڪاڇي	kˈaːcʰi
ڪورس	koːrˈʌs
ڪوٽڙي	koːʈˈʌr.i
گجراتي	ɡˌəɟrˈaːt̪i
گهوڙي	ɡəhˈoːr.i
ڳاڙهو	ɡaːr.ˈʌhoː
اباڻي	abˈaːɳi
اختياري	axt̪jˈaːri
انيڪ	anˈiːk
اهڃاڻ	ˌahəɲˈaːɳ
اهڙين	ˌahər.ˈiːn
بھتر	bˌəhət̪ˈʌr
خطري	xətˈʌri
دفاع	dˈɪfaː
دکن	dəkʰˈʌn
رانديگر	rˌaːndiɡˈʌr
روڪ	rˈoːk
روڪي	rˈoːki
ريسرچ	reːsˈʌrc
سرور	sərˈoːr
سليم	səlˈiːm
شاھه	ʃaːhˈʌh
علائقائي	ˌalaːɪqˈaːi
فيڊريشن	fˌeːɖriʃˈʌn
ماتا	mˈaːt̪aː
مت	mˈʌt̪
متحده	mʊtˈahɪdh
ميوزيم	mjoːzˈiːm
ميوي	mjʋˈeː
ناظم	naːʐˈʌm
نامزد	nˌaːməzˈʌd
نصاب	nəʂˈaːb
نقشو	nəqˈʌʃoː
نوٽ	nˈoːʈ
ويڙھ	ʋˈeːr.h
پهتي	pəhˈʌt̪i
پيغمبر	pˌeːɣəmbˈʌr
ڀاڄي	bʰˈaːɟi
ڀرتي	bʰərˈʌt̪i
ڇاپي	cʰˈaːpi
ڇيڙي	cʰˈeːr.i
ڦٽل	pʰəʈˈʌl
کيرٿر	kʰˌeːrəʈˈʌr
ڪارپوريشن	kˌaːrpˌoːriʃˈʌn
ڪجھه	kˌəɟəhˈʌh
ڪلچر	kˌələcˈʌr
ڪيريئر	kˌeːriˈɪr
گاجي	ɡˈaːɟi
آن	ˈaːn
ابي	abˈiː
اگهه	ˌaɡəhˈʌh
اھڙا	ahˈʌr.aː
بادشاهي	bˈaːdʃˌaːhi
بک	bˈʌkʰ
تاري	t̪ˈaːri
تباھ	t̪əbˈaːh
تلوار	t̪əlʋˈaːr
توازن	t̪ʋaːzˈʌn
جمهوريت	ɟˌəmhuːrˈiːt̪
جيڏو	ɟˈeːɖoː
خطرو	xətˈʌroː
راجائن	rˌaːɟaːˈɪn
رحه	rəhˈʌh
سخي	sˈʌxi
سٽن	səʈˈʌn
عرض	arˈʌz
عمارتون	ˌamaːrt̪ˈoːn
قابض	qaːbˈɪz
لائبريري	lˌaːɪbrˈiːri
لنگهي	lənɡˈʌhi
مجيد	məɟˈiːd
مٿو	mˈʌtʰoː
نتيجا	nət̪ˈiːɟaː
نوح	nˈoːh
وفاق	ʋəfˈaːq
وقف	ʋəqˈʌf
وڊيو	ʋˈʌɖjoː
يهودي	jəhˈoːdi
پس	pˈʌs
پڇڙ	pəcʰˈʌr.
پھچي	pəhˈʌci
ڀرپاسي	bʰˌərpˈaːsi
ڊپارٽمينٽ	ɖˌəpaːrˌəʈminˈʌʈ
ڏکيو	ɖˈʌkʰjoː
ڪرڻي	kərˈʌɳi
ڪلاسيڪل	kˌəlaːsikˈʌl
افسوس	ˌafsˈoːs
الاهي	alˈaːhi
انسانيت	ɪnsˈaːnit̪
اهوئي	ahˈoːi
ايڪٽ	eːkˈʌʈ
بناوٽ	bˌənaːˈoːʈ
بڻائڻ	bˌəɳaːˈɪɳ
تنقيدي	t̪ˌənqˈiːdi
تنگ	t̪ˈʌnɡ
جذبن	ɟˌəzəbˈʌn
جيسين	ɟeːsˈiːn
جپان	ɟəpˈaːn
ذخيرو	zəxˈiːroː
ربيع	rəbˈiː
سافٽ	saːfˈʌʈ
سببن	sˌəbəbˈʌn
سپر	səpˈʌr
شاهنواز	ʃˌaːhənʋˈaːz
شوري	ʃˈoːri
شي	ʃˈeː
طريقا	tərˈiːqaː
قابليت	qˌaːblˈiːt̪
مائٽن	maːʈˈʌn
مٽ	mˈʌʈ
نوعيت	nʋaːˈiːt̪
نگاري	nəɡˈaːri
وقتن	ʋˌəqət̪ˈʌn
ٺهرايو	ʈʰˌəhərˈaːjoː
ٺڪر	ʈʰəkˈʌr
ٽڪرين	ʈˌəkrˈiːn
پوزيشن	pˌoːziʃˈʌn
ڄاڻي	ɟˈaːɳi
ڇڏين	cʰəɖˈiːn
ڏوهه	ɖoːhˈʌh
ڪئين	kəˈiːn
گروھ	ɡərˈoːh
ابوالحسن	abʋˈaːləhˌəsən
از	ˈaz
باغن	bˈaːɣən
بدلائي	bˌədlˈaːi
تشريح	t̪əʃˈʌrih
تفصيلي	t̪ˌəfʂˈiːli
جذبي	ɟˌəzbˈiː
جناب	ɟənˈaːb
جيمس	ɟeːmˈʌs
حسام	həsˈaːm
حضور	həzˈoːr
خاتون	xaːt̪ˈoːn
داد	dˈaːd
سياح	sjˈaːh
صلاحيتن	ʂˌəlaːhit̪ˈʌn
فورس	foːrˈʌs
فيصلا	feːʂˈʌlaː
لوهه	loːhˈʌh
مارئي	maːrˈʌi
ماريو	mˈaːrjoː
ماٿري	maːʈˈʌri
معافي	mˈaːfi
ميرپور	mˌeːrpˈoːr
ميٽرڪ	mˌeːʈərˈʌk
ميڪسيڪو	mˌeːksˈiːkoː
مٽاسٽا	mˌəʈaːsˈʌʈaː
مڃي	mˈʌɲi
مکڻ	məkʰˈʌɳ
هونئن	hoːnˈʌn
هيٺيون	heːʈʰjˈoːn
وڌايو	ʋədʰˈaːjoː
يعقوب	jaːqˈoːb
يهودين	jˌəhoːdˈiːn
يونائيٽيڊ	jˌoːnaːiʈˈiːɖ
يڪدم	jˌəkədˈʌm
ٺهرائي	ʈʰˌəhərˈaːi
ٺيڪ	ʈʰˈeːk
ٻول	bˈoːl
پروڊيوسر	pˌəroːɖjoːsˈʌr
چونڊون	coːnɖˈoːn
کی	kʰˈeː
ڪاغذ	kaːɣˈʌz
ڪاٺيون	kaːʈʰjˈoːn
ڪور	kˈoːr
گهاٽو	ɡəhˈaːʈoː
گھربل	ɡʰˌərəbˈʌl
گھرو	ɡʰˈʌroː
ڳولي	ɡˈoːli
ابتڙ	ˌabət̪ˈʌr.
اختر	axt̪ˈʌr
ايڊيشن	ˌeːɖiʃˈʌn
بحر	bəhˈʌr
بلدياتي	bˌəldjˈaːt̪i
بندرگاهه	bˌəndərɡaːhˈʌh
بنهه	bˌənəhˈʌh
تجربن	t̪ˌəɟərəbˈʌn
تدريس	t̪ˌədrˈiːs
حقيقتن	hˌəqiqət̪ˈʌn
خراسان	xˌəraːsˈaːn
رجحان	rˌəɟhˈaːn
رحمت	rˌəhəmˈʌt̪
سرمست	sˌərəmˈʌst̪
سفير	səfˈiːr
سيوستان	sjoːst̪ˈaːn
سگهه	sˌəɡəhˈʌh
سگهڙ	sˌəɡəhˈʌr.
عنه	anˈʌh
عڪاسي	akˈaːsi
لهڻ	ləhˈʌɳ
لڳيون	ləɡjˈoːn
مائٽ	mˈaːʈ
محروم	mˌəhrˈuːm
مرضي	mərˈʌzi
معاويه	maːʋˈiːh
مقالو	məqˈaːloː
ميرپورخاص	mˌeːrpˌoːrxˈaːʂ
ميسر	meːsˈʌr
هيئن	hˈiːʌ̃
ٻير	bˈeːr
ٽارين	ʈaːrˈiːn
ٽڪرن	ʈˌəkərˈʌn
پاڙن	paːr.ˈʌn
پورٽ	poːrˈʌʈ
چارڻ	caːrˈʌɳ
چاڪر	caːkˈʌr
چن	cˈʌn
ڏيهي	ɖˈeːhi
ڪارڪردگي	kˌaːrəkərdˈʌɡi
ڪانهي	kaːnˈʌhi
ڪرشن	kˌərəʃˈʌn
ڪوفي	kˈoːfi
گاڏي	ɡˈaːɖi
گنج	ɡənˈʌɟ
گهربل	ɡˌəhərəbˈʌl
گوبند	ɡoːbˈʌnd
آس	ˈaːs
آچر	aːcˈʌr
آڇ	ˈaːcʰ
اترئين	ˌat̪ərˈiːn
ازم	azˈʌm
انجنيئر	ˌanəɟniˈɪr
انجنيئرنگ	ˌanəɟniˈɪrənɡ
بادشاهت	bˈaːdʃˌaːhət̪
بعضي	bˈaːzi
تجربا	t̪ˌəɟərbˈaː
تنوير	t̪ənʋˈiːr
جيوت	ɟjˈoːt̪
حمل	həmˈʌl
خانو	xˈaːnoː
خوشبودار	xˈʊʃbˈoːdaːr
درگاھ	dˌərɡˈaːh
رحيم	rəhˈiːm
رسالا	rəsˈaːlaː
سارو	sˈaːroː
سهڻا	səhˈʌɳaː
سينيٽ	seːnˈiːʈ
سٽون	səʈˈoːn
صديون	ʂədjˈoːn
صوفين	ʂoːfˈiːn
عبيدالله	abˈiːdaːlˌələh
فيلڊ	feːlˈʌɖ
قربان	qˌərbˈaːn
مخلوق	mˌəxlˈuːq
ملائڻ	mˌəlaːˈɪɳ
ملاح	mˈʌlaːh
منفرد	mˌənəfˈʌrd
منٽ	mənˈʌʈ
مهر	məhˈʌr
نارنگي	naːrˈʌnɡi
ناز	nˈaːz
نظرين	naʐˈarin
نياز	njˈaːz
نگران	nˌəɡrˈaːn
ورھاست	ʋˌərhˈaːst̪
وڙهڻ	ʋˌər.əhˈʌɳ
ٻوڏ	bˈoːɖ
ٻچا	bˈʌcaː
ٻڪريون	bˌəkrjˈoːn
ٽڪري	ʈəkˈʌri
ڀنڀور	bʰˌənbʰˈuːr
ڇپيا	cʰˈʌpjaː
ڊگھي	ɖˈʌɡʰi
ڏسندي	ɖɪsˈʌndi
کاتو	kʰˈaːt̪oː
ڪمار	kəmˈaːr
گريڊ	ɡərˈiːɖ
گنبذ	ɡənbˈʌz
آرمي	aːrˈʌmi
آڌار	aːdʰˈaːr
احتجاج	ˌɛht̪əɟˈaːɟ
اسڪاٽلينڊ	ˌaskˌaːʈlˈiːnɖ
الطاف	ˌaltˈaːf
انب	ˈanb
انصاري	ˌanʂˈaːri
ايڪڙن	ˌeːkər.ˈʌn
بئراج	bərˈaːɟ
بنائي	bənˈaːi
بنگالي	bənɡˈaːli
بيشمار	bˈeːʃmˌaːr
بيعت	bˈiːt̪
تجربي	t̪ˌəɟərbˈiː
تخليقي	t̪ˌəxlˈiːqi
جنسون	ɟˈɪnsuːn
خاموش	xaːmˈoːʃ
خاندانن	xˌaːndaːnˈʌn
خلا	xˈʌlaː
دائمي	daːˈɪmi
دفتر	dˌəfət̪ˈʌr
دورو	dˈoːroː
ساڙي	sˈaːr.i
سڀيتا	səbʰˈiːt̪aː
سڪل	səkˈʌl
شهنشاهه	ʃˌəhənʃaːhˈʌh
طبقو	təbˈʌqoː
طوفان	toːfˈaːn
طويل	tʋˈeːl
عبدالعزيز	ˌabdˌaːlaːzˈiːz
غريبن	ɣˌəribˈʌn
فنڪارن	fˌənkaːrˈʌn
فڪري	fəkˈʌri
قلمبند	qˌələmbˈʌnd
لڪل	ləkˈʌl
متن	mət̪ˈʌn
محفل	mˈɛhfˌɪl
مزاحمت	mˌəzaːhəmˈʌt̪
مزدور	mˌəzdˈuːr
معاف	mˈaːf
ملندا	məlˈʌndaː
مليون	məljˈoːn
مهاڳ	məhˈaːɡ
موزون	moːzˈoːn
موڪل	moːkˈʌl
ميجر	meːɟˈʌr
نج	nˈʌɟ
نسب	nəsˈʌb
نصيب	nəʂˈiːb
نفسيات	nˌəfsiˈaːt
نمائش	nˈʊmaːˈɪʃ
نڪرندا	nˈɪkrndaː
ورتا	ʋərˈʌt̪aː
يافته	jˌaːfət̪ˈʌh
ٽريننگ	ʈˌərinˈʌnɡ
ٽيهه	ʈeːhˈʌh
پاٽ	pˈaːʈ
پلو	pˈʌloː
پني	pˈʌni
پنھنجا	pənhnˈʌɟaː
ٿلهو	ʈəlˈʌhoː
ٿورا	tʰˈoːraː
ٿيس	tʰˈeːs
چيل	cˈeːl
ڪارخانا	kˌaːrxˈaːnaː
ڪاريگر	kˌaːriɡˈʌr
ڪردارن	kˌərdaːrˈʌn
ڪلهوڙا	kˌəlhˈuːr.aː
گيس	ɡˈeːs
ڳاڙها	ɡaːr.ˈʌhaː
ڳچ	ɡˈʌc
ھم	hˈʌm
اجتماعي	ˌɪɟtɪmaːˈaːi
اڳئين	ˌaɡˈiːn
بچڻ	bəcˈʌɳ
تياري	t̪jˈaːri
جزن	ɟəzˈʌn
جسمن	ɟˌəsəmˈʌn
جوهر	ɟoːhˈʌr
خيالي	xjˈaːli
دستاويز	dˌəst̪aːʋˈiːz
ديس	dˈeːs
رايل	rˈaːjal
روينيو	rʋˈeːnjoː
ريڊ	rˈeːɖ
ساهت	saːhˈʌt̪
سرفراز	sˌərəfrˈaːz
سمي	sˈʌmi
سيريز	seːrˈiːz
سپهه	sˌəpəhˈʌh
سڌارا	sədʰˈaːraː
شهرين	ʃˌəhərˈiːn
شورو	ʃˈoːroː
عدم	adˈʌm
عنصرن	ˌanəʂərˈʌn
عهدو	ahˈʌdoː
فائونڊيشن	fˌaːoːnɖiʃˈʌn
فارغ	faːrˈʌɣ
لوڪن	loːkˈʌn
ليڊر	leːɖˈʌr
ماکي	mˈaːkʰi
مثالي	məsˈaːli
مريدن	mˌəridˈʌn
ناصر	naːʂˈʌr
ننگرپارڪر	nˌənɡərpaːrəkˈʌr
نڪتا	nəkˈʌt̪aː
هلندا	həlˈʌndaː
هلچل	hˌələcˈʌl
واپارين	ʋˌaːpaːrˈiːn
وجهڻ	ʋˌəɟəhˈʌɳ
ورهاست	ʋˌərhˈaːst̪
يھودين	jˌəhoːdˈiːn
پاڙو	pˈaːr.oː
پبلشر	pˌəbələʃˈʌr
پراڻ	pərˈaːɳ
پريشان	pˌəriʃˈaːn
چاڙهي	caːr.ˈʌhi
ڍڪيل	ɖʰˈʌkjal
ڦڦڙن	pʰˌəpʰər.ˈʌn
ڪمري	kəmˈʌri
آرمينيا	ˌaːrmˈiːnjaː
آزمائي	ˌaːzmˈaːi
آفريڪي	ˌaːfrˈiːki
آهر	aːhˈʌr
بادشاه	bˈaːdʃˌaːh
بادشاهن	bˈaːdʃˌaːhən
باز	bˈaːz
باقاعده	bˈaːqˈaːjdh
بم	bˈʌm
جزا	ɟˈʌzaː
حڪومتن	hˌəkoːmət̪ˈʌn
خالص	xaːlˈʌʂ
دنگ	dˈʌnɡ
دوري	dˈoːri
ديرو	dˈeːroː
رجب	rəɟˈʌb
سائيٽ	saːˈiːʈ
سانگهڙ	sˌaːnɡəhˈʌr.
ساڻن	saːɳˈʌn
ساھ	sˈaːh
سفارتي	sˌəfaːrˈʌt̪i
سڪا	sˈʌkaː
سڪون	səkˈoːn
شاخن	ʃaːxˈʌn
شرف	ʃərˈʌf
صنفن	ʂˌənəfˈʌn
طبقاتي	tˌəbqˈaːt̪i
عيد	aˈiːd
غذا	ɣˈʌzaː
فاتح	fˌaːt̪ˈah
فروغ	fərˈoːɣ
ليلا	lˈeːlaː
ماحولياتي	mˌaːhoːljˈaːt̪i
ماھر	maːhˈʌr
مفهوم	mˌəfhˈuːm
ملائيشيا	mˌəlaːˈiːʃjaː
منع	mˈʌnaː
ميون	mjˈoːn
نئيگ	nəˈiːɡ
ناسي	nˈaːsi
نظاماڻي	nɪʐˈaːmaːɳˌiː
نوشهري	nˌoːʃəhˈʌri
هون	hˈoːn
هيرو	hˈeːroː
واڳون	ʋaːɡˈoːn
وغيرہ	ʋˌəɣirˈʌh
ويدن	ʋeːdˈʌn
ويس	ʋˈeːs
ويڪرو	ʋeːkˈʌroː
وڃائي	ʋəɲˈaːi
ٽوڙي	ʈˈoːr.i
ڀوري	bʰˈoːri
ڄائي	ɟˈaːi
چئني	cˈʌni
چيا	cjˈaː
ڏجن	ɖəɟˈʌn
کائيندو	kʰaːˈiːndoː
ڪٿان	kətʰˈaːn
ڪڍندا	kəɖʰˈʌndaː
گاج	ɡˈaːɟ
گريجوئيشن	ɡˌəriɟˌoːiʃˈʌn
ھوائي	hʋˈaːi
اجرڪ	ˌaɟərˈʌk
ارغونن	ˌarɣoːnˈʌn
اوسر	uːsˈʌr
اڪرم	ˌakərˈʌm
اڪيلي	akˈiːli
اھڙن	ˌahər.ˈʌn
بچيل	bacˈɪal
تاثر	t̪aːsˈʌr
تبديلين	t̪ˌəbdilˈiːn
تفسير	t̪ˌəfsˈiːr
توحيد	t̪oːhˈiːd
تير	t̪ˈeːr
تڪراري	t̪ˌəkrˈaːri
تڪميل	t̪əkˈʌmjal
جنسن	ɟˈɪnsn
جوڳو	ɟˈoːɡoː
رسمون	rˌəsmˈuːn
رليز	rəlˈiːz
زيور	zjˈoːr
سالياني	saːljˈaːni
سجاده	sˌəɟaːdˈʌh
سرون	sərˈoːn
سمجهندا	sˌəməɟəhˈʌndaː
سنڀالي	sˌənbʰˈaːli
سينگار	seːnɡˈaːr
سکيو	sˈʌkʰjoː
شيشي	ʃˈeːʃi
شڪاري	ʃəkˈaːri
صفائي	ʂəfˈaːi
صفحي	ʂəfˈʌhi
صوبيدار	ʂuːbˈiːdaːr
عقيدن	ˌaqidˈʌn
قابو	qaːbˈoː
قانونن	qˌaːnoːnˈʌn
قبرن	qˌəbərˈʌn
محصول	mˌəhʂˈuːl
مطالبو	mʊtˈaːlɪbˌoː
مظهر	mˌəʐəhˈʌr
مفادن	mˌəfaːdˈʌn
مڙني	mər.ˈʌni
نيويارڪ	njʋjaːrˈʌk
هٿي	hˈʌtʰi
ورثو	ʋərˈʌsoː
ويسٽ	ʋeːsˈʌʈ
ٽاريون	ʈaːrjˈoːn
پابند	paːbˈʌnd
ٿڙ	ʈˈʌr.
ڀرڳڙي	bʰˌərəɡˈʌr.i
ڌارين	dʰaːrˈiːn
ڏسو	ɖˈɪsoː
ڏيارڻ	ɖjaːrˈʌɳ
کڏ	kʰˈʌɖ
ڪبير	kəbˈiːr
ڪپڙن	kˌəpər.ˈʌn
گرام	ɡərˈaːm
گروهن	ɡˌəroːhˈʌn
گھڻ	ɡʰˈʌɳ
ڳايا	ɡˈaːjaː
ھندي	hˈʌndi
اس	ˈas
اشرف	ˌaʃərˈʌf
اضافي	ɪzˈaːfi
امتياز	ˌamt̪jˈaːz
اوج	ˈuːɟ
ب	bˈeː
بادشاھت	bˈaːdʃˌaːhət̪
بناوت	bˌənaːˈoːt̪
تاريخن	t̪ˌaːrixˈʌn
تقريب	t̪ˌəqrˈiːb
تلاش	t̪əlˈaːʃ
حادثي	haːdˈʌsi
دخل	dəxˈʌl
راڳي	rˈaːɡi
ريشمي	reːʃˈʌmi
رٿ	rˈʌʈ
ساوا	sˈaːʋaː
سلون	səlˈoːn
شريعت	ʃərˈiːt̪
شهزادي	ʃˌəhəzˈaːdi
شوڪت	ʃoːkˈʌt̪
شڪر	ʃəkˈʌr
شھيد	ʃəhˈiːd
طبعي	təbˈaːi
ظفر	ʐəfˈʌr
عبدالملڪ	ˌabdˌaːləməlˈʌk
فرمان	fˌərmˈaːn
فوجين	foːɟˈiːn
فون	fˈoːn
قادري	qaːdˈʌri
لوھ	lˈoːh
مترجم	mˌət̪ərəɟˈʌm
موري	mˈoːri
نازڪ	naːzˈʌk
ننڍڙن	nˌənəɖʰər.ˈʌn
نڪي	nˈʌki
وزيرن	ʋˌəzirˈʌn
وڍي	ʋˈʌɖʰi
يونيورسٽين	jˌoːnjoːrˌəsʈˈiːn
ٻيلا	bˈeːlaː
ٻٻر	bəbˈʌr
پڙهائڻ	pˌər.haːˈɪɳ
چاليهه	cˌaːlihˈʌh
ڦريون	pʰərjˈoːn
کلي	kʰˈʌli
کوليو	kʰˈoːljoː
ڪوبہ	koːbˈʌh
ڪوريا	kˈoːrjaː
ڪٽي	kˈʌʈi
ھجن	həɟˈʌn
ارادي	arˈaːdi
اگر	aɡˈʌr
تامل	t̪aːmˈʌl
ترجيح	t̪ərˈʌɟih
تھذيب	t̪ˌəhzˈiːb
جنگين	ɟənɡˈiːn
حميد	həmˈiːd
دائرو	daːˈɪroː
دلي	dˈʌli
دودي	dˈoːdi
ذهين	zəhˈiːn
رهواسي	rəhʋˈaːsi
رڌي	rˈʌdʰi
رھندي	rəhˈʌndi
سلام	səlˈaːm
سنئون	sˌənˈoːn
سنگيت	sənɡˈiːt̪
سولنگي	soːlˈʌnɡi
سگهندا	sˌəɡəhˈʌndaː
سڱ	səˈŋ̩
عاقل	aːqˈʌl
علحده	ˌaləhədˈʌh
فردن	fərdˈʌn
فعل	fˈaːl
قريب	qərˈiːb
ليکيو	lˈeːkʰjoː
لڏپلاڻ	lˌəɖəplˈaːɳ
مدرسن	mˌədərəsˈʌn
مذهبن	mˌəzəhəbˈʌn
ميري	mˈeːri
وجهندا	ʋˌəɟəhˈʌndaː
وجھي	ʋəɟˈʌhi
ويران	ʋeːrˈaːn
ٽيڪس	ʈeːkˈʌs
پائڻ	paːˈɪɳ
پڙهندو	pˌər.əhˈʌndoː
پڳ	pˈʌɡ
ڄاتو	ɟˈaːt̪oː
چنيسر	cˌənisˈʌr
ڇوجو	cʰˈoːɟoː
ڊيموڪريٽڪ	ɖˌeːmoːkriʈˈʌk
ڏور	ɖˈoːr
ڪارڪنن	kˌaːrəkənˈʌn
ڪرايائين	kˌəraːjaːˈiːn
ڪوھ	kˈoːh
ڪڇي	kˈʌcʰi
ڳائڻي	ɡaːˈɪɳi
ھيٺين	heːʈʰˈiːn
آنڊن	aːnɖˈʌn
ابوبڪر	abˈoːbəkˌər
اظھار	ˌaʐhˈaːr
انتقال	ˌɪntɪqˈaːl
اٽي	ˈaʈi
برابري	bˌəraːbˈʌri
بلوچي	bəlˈoːci
بوقت	bˈoːqət̪
بگڙيل	bəɡˈʌr.jal
تحريڪن	t̪ˌəhrikˈʌn
تشڪيل	t̪əʃˈʌkjal
تنھنڪري	t̪ˌənhnəkˈʌri
تڙ	t̪ˈʌr.
جڙي	ɟˈʌr.i
حاصلات	hˌaːʂəlˈaːt
حياتياتي	hjaːt̪jˈaːt̪i
خاصيتون	xˌaːʂit̪ˈoːn
خبرون	xˌəbrˈuːn
خزانو	xəzˈaːnoː
دار	dˈaːr
ديسي	dˈeːsi
راس	rˈaːs
رند	rˈʌnd
روڊن	roːɖˈʌn
ستر	sət̪ˈʌr
سمجهن	sˌəməɟəhˈʌn
سنڌن	sˈɪndhn
سهولت	sˌəhoːlˈʌt̪
سچائي	səcˈaːi
سڏجن	sˌəɖəɟˈʌn
سڏي	sˈʌɖi
سڪائي	səkˈaːi
صفت	ʂɪfˈata
ضمير	zəmˈiːr
عجائب	ˌaɟaːˈɪb
عدالتي	ˌadaːlˈʌt̪i
عقيدت	ˌaqidˈʌt̪
غربت	ɣˌərəbˈʌt̪
فزڪس	fˌəzəkˈʌs
قيصر	qeːʂˈʌr
مشن	məʃˈʌn
منشي	mənˈʌʃi
منصوبي	mˌənʂuːbˈiː
موٽ	mˈoːʈ
موڙ	mˈoːr.
نامو	nˈaːmoː
ندين	nədˈiːn
نھايت	nhaːˈiːt̪
هار	hˈaːr
هلال	həlˈaːl
ورهائجي	ʋˌərhaːˈɪɟi
ويٺي	ʋˈeːʈʰi
وڌيو	ʋˈʌdʰjoː
ٺٽو	ʈʰˈʌʈoː
ٻارڻ	baːrˈʌɳ
ٻجن	bəɟˈʌn
ٽائيم	ʈaːˈiːm
ٽرسٽ	ʈˌərəsˈʌʈ
ٽيلي	ʈˈeːli
پوريون	poːrjˈoːn
پوکبو	pˌoːkʰbˈoː
پڙهندڙ	pˌər.əhəndˈʌr.
ڀتين	bʰət̪ˈiːn
ڀٽن	bʰəʈˈʌn
چٽسالي	cˌəʈsˈaːli
کاري	kʰˈaːri
ڪرنل	kˌərənˈʌl
ڪيلشم	kˌeːləʃˈʌm
ڪيٿولڪ	kˌeːtʰoːlˈʌk
گانا	ɡˈaːnaː
ھا	hˈaː
آڪسفورڊ	ˌaːkəsfoːrˈʌɖ
احسان	ɛhsˈaːn
اسلم	ˌasəlˈʌm
الاول	ˌalaːˈoːl
انفرادي	ˌanəfrˈaːdi
اوترو	uːt̪ˈʌroː
اوھان	uːhˈaːn
باغي	bˈaːɣi
بدلجي	badˈalɟi
بلغم	bˌələɣˈʌm
تعلقن	t̪ˌaːləqˈʌn
تنتي	t̪ənˈʌt̪i
جهاد	ɟəhˈaːd
جيترا	ɟeːt̪ˈʌraː
حالات	hˌaːlˈaːt
حفيظ	həfˈiːʐ
خانه	xaːnˈʌh
خانگي	xˈaːnɡi
خلائي	xəlˈaːi
دان	dˈaːn
رسمي	rəsˈʌmi
رقص	rəqˈʌʂ
زيب	zˈeːb
سامي	sˈaːmi
ستارن	sɪtˈaːrn
سراج	sərˈaːɟ
سرحدي	sˌərəhˈʌdi
سٺ	sˈʌʈʰ
سچي	sˈʌci
شخصي	ʃˈaxʂi
شدت	ʃədˈʌt̪
شموليت	ʃˌəmoːlˈiːt̪
عليہ	alˈiːh
فرشن	fˌərəʃˈʌn
قرباني	qˌərbˈaːni
لس	lˈʌs
لساني	ləsˈaːni
ما	mˈaː
مار	mˈaːr
مثنوي	məsˈʌnʋi
معرفت	mˌaːrəfˈʌt̪
نئشنل	nˌəʃənˈʌl
نائين	naːˈiːn
نام	nˈaːm
ناهن	naːhˈʌn
نشانيون	nɪʃˈaːnjoːn
وهڻ	ʋəhˈʌɳ
ويهين	ʋˈiːhĩː
وڌندي	ʋədʰˈʌndi
ٺهيو	ʈʰˈʌhjoː
ٽامي	ʈˈaːmi
ٽنهي	ʈənˈʌhi
ٽيڪ	ʈˈeːk
پالي	pˈaːli
پريزيڊنٽ	pˌərizˌiːɖənˈʌʈ
پوئلڳ	poːˈɪləɡ
پيء	pˈeː
ڀڳوان	bʰəɡʋˈaːn
ڄاڻائي	ɟaːɳˈaːi
چانورن	cˌaːnoːrˈʌn
چوڏهن	cˌoːɖəhˈʌn
چيئرمئن	ceːˈɪrəmˌən
چينل	ceːnˈʌl
ڇڏيون	cʰəɖjˈoːn
ڇڪتاڻ	cʰˌəkt̪ˈaːɳ
ڊگھو	ɖˈʌɡʰoː
ڌنڌو	dʰˈʌndʰoː
کٽ	kʰˈʌʈ
ڪافين	kaːfˈiːn
ڪافيون	kaːfjˈoːn
ڪمان	kəmˈaːn
گهوڙا	ɡəhˈoːr.aː
ڳولڻ	ɡoːlˈʌɳ
ڳڙهي	ɡər.ˈʌhi
ھلندڙ	hˌələndˈʌr.
آء	ˈaː
آبهوا	aːbˈʌhʋaː
آبي	aːbˈiː
آفتاب	ˌaːft̪ˈaːb
آوازن	ˌaːʋaːzˈʌn
آڱر	ˌaːŋ̩ˈʌr
اسلاميه	ˌɪslˈaːmih
اطلاع	atˈʌlaː
اعتماد	ˌeːtɪmˈaːd
اناج	anˈaːɟ
اوتار	uːt̪ˈaːr
ايڏي	ˈeːɖi
اٿي	ˈatʰi
اڳوڻو	aɡˈoːɳoː
بابر	bˈaːbɪr
بنارس	bˌənaːrˈʌs
تماچي	t̪əmˈaːci
تڏهين	t̪ˌəɖhˈiːn
جلدن	ɟˌələdˈʌn
جماعتن	ɟˌəmaːaːt̪ˈʌn
جيون	ɟjˈoːn
حامد	haːmˈʌd
خزاني	xəzˈaːni
دانشور	dˌaːnʃˈoːr
راج	rˈaːɟ
رستا	rˈʌst̪aː
رطوبت	rˌətoːbˈʌt̪
سائوٿ	saːˈoːʈ
سامھون	sˌaːmhˈoːn
ساڳيا	sˈaːɡjaː
سريلنڪا	sˌərilənˈʌkaː
سسئي	səsˈʌi
سگھيو	sˈʌɡʰjoː
شاهڪار	ʃˌaːhəkˈaːr
شهاب	ʃəhˈaːb
صديقي	ʂədˈiːqi
طارق	taːrˈʌq
طبقن	tˌəbəqˈʌn
طبيب	təbˈiːb
طرفن	tˌərəfˈʌn
عظمت	ˌaʐəmˈʌt̪
غلطي	ɣəlˈʌti
قيدين	qeːdˈiːn
ليڪ	lˈeːk
ليڪچرار	lˌeːkəcrˈaːr
مداخلت	mˌədaːxəlˈʌt̪
مرحلن	mˌərəhəlˈʌn
مشرقي	mˈaʃrˌɪqi
مقدمو	mʊqˈadmoː
موقعن	moːqˈaːn
مڪلي	məkˈʌli
نورمحمد	nˌoːrəmˌəhəmˈʌd
نيرون	neːrˈoːn
هوشيار	hoːʃjˈaːr
هڪڙا	həkˈʌr.aː
وارياسي	ʋaːrjˈaːsi
ويئر	ʋeːˈɪr
ويهن	ʋeːhˈʌn
وٺندڙ	ʋˌəʈʰəndˈʌr.
يھودي	jəhˈoːdi
ٺاهيون	ʈʰaːhjˈoːn
پاسا	pˈaːsaː
پاڙيسري	pˌaːr.isˈʌri
پڇاڙي	pəcʰˈaːr.i
ٿئيس	ʈəˈiːs
ٿامس	tʰaːmˈʌs
ٿڌو	ʈˈʌdʰoː
ڏندن	ɖəndˈʌn
ڏڪار	ɖəkˈaːr
ڦيرائي	pʰeːrˈaːi
کانئن	kʰaːnˈʌn
ڪاربان	kˌaːrbˈaːn
ڪلهوڙو	kˌəlhˈuːr.oː
ڪنن	kənˈʌn
ڪنڌ	kˈʌndʰ
ڪوڙي	kˈoːr.i
گذاريائين	ɡˌəzaːrjaːˈiːn
گرلس	ɡˌərəlˈʌs
گهرجن	ɡˌəhərəɟˈʌn
گهيرو	ɡəhˈiːroː
آصف	aːʂˈʌf
آڳاٽن	ˌaːɡaːʈˈʌn
اختيارن	ˌaxt̪jaːrˈʌn
اداڪارا	ˌadaːkˈaːraː
اعلي	ˈaːli
انگلنڊ	ˌanɡəlˈʌnɖ
اڀري	abʰˈʌri
اڪ	ˈak
تفاوت	t̪ˌəfaːˈoːt̪
جتن	ɟət̪ˈʌn
جذب	ɟəzˈʌb
جشن	ɟəʃˈʌn
جمھوريه	ɟˌəmhuːrˈiːh
خارجي	xaːrˈʌɟi
خانن	xaːnˈʌn
داڻن	daːɳˈʌn
رڪاوٽ	rˌəkaːˈoːʈ
ساهتيه	sˌaːhət̪ˈiːh
سدا	sˈʌdaː
سومار	soːmˈaːr
سيتا	sˈeːt̪aː
سيرت	seːrˈʌt̪
سڏ	sˈʌɖ
سگريٽ	sˌəɡrˈiːʈ
سھولت	sˌəhoːlˈʌt̪
شفيع	ʃˈʌfi
عربستان	ˌarəbˈɪstaːn
فوٽان	foːʈˈaːn
قبو	qəbˈoː
لاشاري	laːʃˈaːri
لينن	leːnˈʌn
ليکي	lˈeːkʰi
لڌا	lˈʌdʰaː
ماس	mˈaːs
محترمه	mˌəhət̪ˌərəmˈʌh
مزاحيه	mˌəzaːhˈiːh
مسعود	mˌəsaːˈoːd
مشغول	mˌəʃɣˈuːl
مقرري	mˌəqərˈʌri
منجھان	mˌənəɟhˈaːn
موجودگي	moːɟˈuːdɡi
نارائڻ	nˌaːraːˈɪɳ
نثري	nəsˈʌri
نقشي	nəqˈʌʃi
هڻندا	həɳˈʌndaː
وس	ʋˈʌs
وفد	ʋəfˈʌd
ويڪرائي	ʋˌeːkrˈaːi
ٻيلن	beːlˈʌn
ٽرانزسٽر	ʈˌəraːnˌəzəsəʈˈʌr
پائونڊ	paːˈoːnɖ
پارلياماني	pˌaːrljaːmˈaːni
پتي	pˈʌt̪i
پردي	pˈʌrdi
پريم	pərˈiːm
پشتو	pˈʌʃt̪oː
پنڊت	pənɖˈʌt̪
پهچائي	pˌəhəcˈaːi
پيس	pˈeːs
پيپلزپارٽي	pˌeːpəlˌəzpaːrˈʌʈi
پچڻ	pəcˈʌɳ
ڄيٺمل	ɟˌeːʈʰəmˈʌl
چرپر	cˌərəpˈʌr
چوڻي	cˈoːɳi
چڙهڻ	cˌər.əhˈʌɳ
ڇوڪريون	cʰˌoːkrjˈoːn
ڊگريون	ɖˌəɡrjˈoːn
ڍنڍن	ɖʰˌənəɖʰˈʌn
ڏوڪري	ɖoːkˈʌri
ڪئپٽن	kˌəpəʈˈʌn
ڪانڪريٽ	kˌaːnəkrˈiːʈ
ڪنور	kənˈoːr
ڪورونا	koːrˈoːnaː
گنجائش	ɡˌənɟaːˈɪʃ
گني	ɡˈʌni
گهاٽا	ɡəhˈaːʈaː
گهڻ	ɡəhˈʌɳ
گولڊ	ɡoːlˈʌɖ
گھرن	ɡʰərˈʌn
ڳڻپ	ɡəɳˈʌp
ھالا	hˈaːlaː
ھنڌن	həndʰˈʌn
آڪسائيڊ	ˌaːksaːˈiːɖ
آڻين	aːɳˈiːn
اخبارون	ˌaxbˈaːroːn
افتتاح	ɪftˈɪt̪aːh
افزائي	ˌafzˈaːi
الملڪ	ˌaləməlˈʌk
اندرين	ˌandərˈiːn
اوچي	ˈuːci
ايشيائي	eːʃjˈaːi
ايڏو	ˈeːɖoː
اگني	aɡˈʌni
برفاني	bˌərfˈaːni
تسلسل	t̪ˌəsələsˈʌl
توڻي	t̪ˈoːɳi
جلوس	ɟəlˈoːs
حوالن	haʋˈaːln
خواهشن	xʋˌaːhəʃˈʌn
خوبين	xoːbˈiːn
دھلي	dəhˈʌli
رهاڪن	rˌəhaːkˈʌn
رٿا	rˈʌtʰaː
سئنيما	sənˈiːmaː
سبق	səbˈʌq
سترهين	sˌət̪ərhˈiːn
سرحدون	sˌərəhdˈoːn
سرمد	sˌərəmˈʌd
سفارش	sˌəfaːrˈʌʃ
سمايل	səmˈaːjal
سوشل	soːʃˈʌl
شوقين	ʃoːqˈiːn
طاقتن	tˌaːqət̪ˈʌn
عبور	abˈoːr
عرس	arˈʌs
غلامن	ɣˌəlaːmˈʌn
فائدا	faːˈɪdaː
فاطمه	fˌaːtəmˈʌh
فضا	fˈʌzaː
فيصل	feːʂˈʌl
قبائلي	qəbˈaːɪlˌiː
لهجي	ləhˈʌɟi
مدي	mˈʌdi
مشاهدو	mˌəʃaːhˈʌdoː
مشتاق	məʃt̪ˈaːq
مشرف	mˌəʃərˈʌf
مظفر	mˌəʐəfˈʌr
منظوري	mˌanʐˈuːri
مونکي	moːnˈʌkʰi
مگسي	məɡˈʌsi
نصيرآباد	nˌəʂiraːbˈaːd
نندي	nˈʌndi
نيپئر	neːpˈʌr
هالن	haːlˈʌn
هدايتڪار	hˌədaːˌiːt̪kˈaːr
وديا	ʋˈʌdjaː
وسندي	ʋəsˈʌndi
ويهاريو	ʋeːhˈaːrjoː
وٺن	ʋəʈʰˈʌn
پرائيمري	pˌəraːimˈʌri
پرستي	pərˈʌst̪i
پلاٽ	pəlˈaːʈ
پوکيندا	poːkʰˈiːndaː
پيرو	pˈeːroː
پچائي	pəcˈaːi
پڌرا	pədʰˈʌraː
ڄامشوري	ɟˌaːmʃˈoːri
چئون	cəˈoːn
چاندي	cˈaːndi
چاهيو	cˈaːhjoː
چشتي	cˈʌʃt̪i
چوڪ	cˈoːk
چٽو	cˈʌʈoː
چڱا	cəˈŋ̩aː
ڏيکارڻ	ɖˌeːkʰaːrˈʌɳ
ڏيڻو	ɖˈeːɳoː
ڏٺا	ɖˈʌʈʰaː
ڦرلٽ	pʰˌərəlˈʌʈ
ڪالي	kˈaːli
ڪاوڙ	kaːˈoːr.
ڪتي	kˈʌt̪i
ڪميونٽي	kˌəmjoːnˈʌʈi
ڪنارو	kənˈaːroː
ڪهڪشان	kˌəhəkʃˈaːn
ڪپهه	kˌəpəhˈʌh
گلگت	ɡˌələɡˈʌt̪
گيتن	ɡeːt̪ˈʌn
آتش	ˈaːtɪʃ
آندل	aːndˈʌl
اردن	ardˈʌn
اسٽوڊنٽس	ˌasʈˌoːɖənəʈˈʌs
اعتراض	ˌeːtɪrˈaːz
اوپيرا	uːpˈiːraː
ايجوڪيشن	ˌeːɟoːkiʃˈʌn
ايڊورڊ	ˌeːɖoːrˈʌɖ
تجارت	t̪ˌəɟaːrˈʌt̪
تناسب	t̪ˌənaːsˈʌb
تنهنجو	t̪ˌənəhənˈʌɟoː
جائز	ɟaːˈɪz
جاپان	ɟaːpˈaːn
جاگرافي	ɟˌaːɡrˈaːfi
حملن	hˌəməlˈʌn
خارش	xaːrˈʌʃ
خليل	xˈʌljal
خوشحال	xˈʊʃhaːl
ذريعن	zərˈiːn
راء	rˈaː
راشد	raːʃˈʌd
زمينداري	zˌəmindˈaːri
سما	sˈʌmaː
سيدن	seːdˈʌn
سپاهين	sˌəpaːhˈiːn
سکي	sˈʌkʰi
سڳورن	sˌəɡoːrˈʌn
شيعن	ʃˈiːn
ضد	zˈʌd
عمران	ˈʊmraːn
فري	fˈʌri
قائل	qaːˈɪl
قانع	qˈaːneː
قيامت	qjaːmˈʌt̪
لاڙي	lˈaːr.i
لذت	ləzˈʌt̪
لپي	lˈʌpi
لڌو	lˈʌdʰoː
لڳايا	ləɡˈaːjaː
ماٿر	maːʈˈʌr
مبتلا	mˌəbət̪ˈʌlaː
متحرڪ	mˌət̪əhərˈʌk
مدو	mˈʌdoː
مشهوري	mˌəʃhˈuːri
مفاد	məfˈaːd
مندرن	mˌəndərˈʌn
منزلون	mˈanzˌɪloːn
نشانو	nɪʃˈaːnoː
نوبل	noːbˈʌl
هاسٽل	hˌaːsəʈˈʌl
ووڊ	ʋˈoːɖ
وکر	ʋəkʰˈʌr
يونانين	jˌoːnaːnˈiːn
ٺاھيا	ʈʰˈaːhjaː
ٺهندو	ʈʰəhˈʌndoː
ٽيهن	ʈeːhˈʌn
پاور	paːˈoːr
پوليٽيڪل	pˌoːliʈikˈʌl
پيلي	pˈeːli
پھريان	pˌəhrjˈaːn
ڀڃي	bʰˈʌɲi
ڄمي	ɟˈʌmi
چارج	caːrˈʌɟ
چمڪندڙ	cˌəməkəndˈʌr.
چور	cˈoːr
ڍورو	ɖʰˈoːroː
ڪائي	kˈaːi
ڪارن	kaːrˈʌn
ڪبي	kəbˈiː
ڪريون	kərjˈoːn
ڪلھوڙن	kˌəlhuːr.ˈʌn
ڪوهستان	kˌoːhəˈɪstaːn
گانو	ɡˈaːnoː
گهرڙن	ɡˌəhərər.ˈʌn
ڳئون	ɡəˈoːn
ڳري	ɡˈʌri
ڳنڍ	ɡənˈʌɖʰ
اجل	aɟˈʌl
ارڙهين	ˌarər.hˈiːn
استعيفا	ˌast̪aːˈiːfaː
اسي	ˈasi
اسپيني	ˌaspˈiːni
افسانوي	ˌafsˈaːnʋi
التمش	ˌalət̪əmˈʌʃ
الڪرام	ˌaləkrˈaːm
انتها	ɪntˈɪhaː
ايترا	eːt̪ˈʌraː
اڏي	ˈaɖi
باعث	bˈaːaːs
بخارا	bəxˈaːraː
بصر	bəʂˈʌr
بيدل	bˈeːdəl
تعين	t̪aːˈiːn
جئين	ɟəˈiːn
جمعي	ɟəmˈaːi
جوهي	ɟˈoːhi
جيلاني	ɟeːlˈaːni
جڏهين	ɟˌəɖhˈiːn
حوالو	haʋˈaːloː
حيران	heːrˈaːn
حيض	hˈeːz
دفنايو	dˌəfnˈaːjoː
ذميواري	zəmjʋˈaːri
ذميواريون	zˌəmjʋaːrjˈoːn
رابطو	raːbˈʌtoː
رابطي	raːbˈʌti
رتن	rət̪ˈʌn
روهڙي	roːhˈʌr.i
رھائش	rˌəhaːˈɪʃ
زباني	zəbˈaːni
سادو	sˈaːdoː
سرائي	sərˈaːi
سلامت	sˌəlaːmˈʌt̪
سنڀالڻ	sˌənbʰaːlˈʌɳ
سولو	sˈoːloː
سچو	sˈʌcoː
سگهندي	sˌəɡəhˈʌndi
شاديون	ʃaːdjˈoːn
شينهن	ʃˌeːnəhˈʌn
صبر	ʂəbˈʌr
صبغت	ʂˌəbəɣˈʌt̪
ضرورتن	zˌaruːrət̪ˈʌn
عارف	aːrˈʌf
عبدالرزاق	ˌabdˌaːlərzˈaːq
غم	ɣˈʌm
فارس	faːrˈʌs
فصلن	fˌəʂəlˈʌn
فوجون	foːɟˈoːn
قصا	qˈʌʂaː
لاھور	laːhˈoːr
مالا	mˈaːlaː
محب	məhˈʌb
معاملا	maːmˈʌlaː
موٽيو	mˈoːʈjoː
ميهڙ	meːhˈʌr.
ميڙ	mˈeːr.
مٿانهون	mˌətʰaːnhˈoːn
نافذ	naːfˈʌz
نيل	nˈeːl
هضم	həzˈʌm
هيري	hˈeːri
وشنو	ʋəʃˈʌnoː
وصيت	ʋəʂˈiːt̪
ولايتي	ʋˌəlaːˈiːt̪i
وٺ	ʋˈʌʈʰ
وچان	ʋəcˈaːn
ٽٽي	ʈˈʌʈi
پارٽين	pˌaːrʈˈiːn
پرنٽ	pˌərənˈʌʈ
پوشاڪ	poːʃˈaːk
پيرس	peːrˈʌs
پٽيون	pəʈjˈoːn
پڙهيا	pər.ˈʌhjaː
ٿيٽر	tʰeːʈˈʌr
ڀريا	bʰˈʌrjaː
ڀلائي	bʰəlˈaːi
چادر	caːdˈʌr
ڇاڇري	cʰaːcʰˈʌri
ڊينمارڪ	ɖˌeːnmaːrˈʌk
ڦاسي	pʰˈaːsi
کتري	kʰət̪ˈʌri
ڪنڊا	kˈʌnɖaː
ڪونج	koːnˈʌɟ
ڪڪڙ	kəkˈʌr.
گرھن	ɡˌərəhˈʌn
گهوڙن	ɡˌəhoːr.ˈʌn
گڏهه	ɡˌəɖəhˈʌh
آساني	aːsˈaːni
آنند	aːnˈʌnd
آڳاٽو	aːɡˈaːʈoː
ارباب	ˌarbˈaːb
اسد	asˈʌd
اسٽوپا	ˌasʈˈoːpaː
افلاطون	ˌaflaːtˈoːn
البم	ˌaləbˈʌm
السنڌ	ˌaləsˈʌndʰ
انجيل	anˈʌɟjal
انجڻ	ˌanəɟˈʌɳ
انڊونيشيا	ˌɪnɖoːnˈiːʃjaː
انگيز	anɡˈiːz
بادل	bˈaːdəl
برآمد	bˌəraːmˈʌd
برهمڻن	bˌərəhˌəməɳˈʌn
بلتستان	bˌələt̪ˈɪstaːn
تاليف	t̪aːlˈiːf
تشريحي	t̪ˌəʃrˈiːhi
ججن	ɟəɟˈʌn
جولائي	ɟoːlˈaːi
حرن	hərˈʌn
خالد	xaːlˈʌd
خانان	xaːnˈaːn
خوبيون	xoːbjˈoːn
خوشبو	xˈʊʃbˈoː
داخلي	daːxˈʌli
درجن	dˈarɟn
درياهي	dərjˈaːhi
دشمنن	dˌəʃəmənˈʌn
راڳڻي	raːɡˈʌɳi
رهواسين	rˌəhʋaːsˈiːn
رياضي	rjˈaːzi
زميندارن	zˌəmindaːrˈʌn
سرگرميون	sˌarɡˈarmjoːn
سمجهندو	sˌəməɟəhˈʌndoː
سمجهه	sˌəməɟəhˈʌh
سمجھ	sˌəməɟˈʌh
سمجھڻ	sˌəməɟəhˈʌɳ
سورت	soːrˈʌt̪
سياحن	sjaːhˈʌn
سيارن	sjaːrˈʌn
سيارو	sjˈaːroː
سکڻ	səkʰˈʌɳ
عبد	abˈʌd
عبدالستار	ˌabdˌaːlst̪ˈaːr
عبرت	ˌabərˈʌt̪
عملن	ˌaməlˈʌn
فلڪي	fəlˈʌki
قصن	qəʂˈʌn
قول	qˈoːl
لالواڻي	laːlʋˈaːɳi
ليفٽيننٽ	lˌeːfʈˌiːnənˈʌʈ
متفق	mˌət̪əfˈʌq
مخزن	mˌəxəzˈʌn
مسجدن	mˈasɟˌɪdn
مشتري	məʃt̪ˈʌri
مليس	məlˈiːs
ملڪاڻي	mˌəlkˈaːɳi
مني	mˈʌni
مهاتما	mˌəhaːt̪ˈʌmaː
مهن	məhˈʌn
مومل	moːmˈʌl
موڪلڻ	mˌoːkəlˈʌɳ
نارٿ	naːrˈʌʈ
نباتات	nəbˈaːtˈaːt
نجي	nˈʌɟi
نسخو	nəsˈʌxoː
نظربند	naʐˈarbənd
نم	nˈʌm
هاڪاري	haːkˈaːri
هيٺئين	hˌeːʈʰˈiːn
هٿرادو	hˌəʈrˈaːdoː
وچين	ʋəcˈiːn
ٺھي	ʈʰˈʌhi
پا	pˈaː
پاليسين	pˌaːlisˈiːn
پهلو	pəhˈʌloː
پڇيو	pˈʌcʰjoː
پڪڙي	pəkˈʌr.i
ڀرت	bʰərˈʌt̪
چاچي	cˈaːci
چوري	cˈoːri
چپ	cˈʌp
ڌن	dʰˈʌn
ڏيپلي	ɖeːpˈʌli
ڪپھ	kəpˈʌh
ڪڍندو	kəɖʰˈʌndoː
گفتگو	ɡˌəfət̪ˈʌɡoː
ڳڙھ	ɡˈʌr.h
ھندوستان	hˌənduːst̪ˈaːn
ھڪٻئي	hˌəkəbˈʌi
آخرت	ˌaːxərˈʌt̪
آريه	aːrˈiːh
آني	ˈaːni
اطاعت	ˌataːˈaːt̪
اغوا	ˈaɣʋaː
اللہ	ˈallaːh
ايڪو	ˈeːkoː
ايگزيڪيوٽو	ˌeːɡzikjˈoːʈoː
اپڀرنش	ˌapəbʰˌərənˈʌʃ
اکري	akʰˈʌri
بائيبل	bˈaːibˌəl
بالي	bˈaːli
بصري	bəʂˈʌri
بنگلاديش	bˌənɡəlaːdˈiːʃ
بواسير	bʋˈaːsir
بيماريون	bˈeːmaːrjˌoːn
بيٺا	bˈeːʈʰaː
بچل	bəcˈʌl
بڻجڻ	bˌəɳəɟˈʌɳ
تباهي	t̪əbˈaːhi
تتر	t̪ət̪ˈʌr
تعلقا	t̪aːlˈʌqaː
تفريح	t̪əfˈʌrih
جارجيا	ɟaːrˈʌɟjaː
جانشين	ɟˌaːnʃˈiːn
جزو	ɟˈʌzoː
جمهوريه	ɟˌəmhuːrˈiːh
حوالا	haʋˈaːlaː
داغ	dˈaːɣ
ذميداري	zˌəmidˈaːri
رايا	rˈaːjaː
رح	rəˈah
رشي	rˈʌʃi
رعيت	raːˈiːt̪
رهنديون	rˌəhəndjˈoːn
روسو	rˈoːsoː
ساليانو	saːljˈaːnoː
سرائيڪي	sˌəraːˈiːki
سرحدن	sˌərəhədˈʌn
سهولتون	sˌəhoːlt̪ˈoːn
سورج	soːrˈʌɟ
سوشلزم	sˌoːʃələzˈʌm
سوڀ	sˈoːbʰ
سوچڻ	soːcˈʌɳ
سيشن	seːʃˈʌn
شادين	ʃaːdˈiːn
ضمانت	zˌəmaːnˈʌt̪
عمرو	ˈʊmroː
عملدارن	ˌaməldaːrˈʌn
قافيي	qˈaːfji
لائبرري	lˌaːɪbərˈʌri
لسي	lˈʌsi
لکندا	ləkʰˈʌndaː
مؤرخن	mˌəa͡ʊrəxˈʌn
مامون	maːmˈoːn
ماھرن	mˌaːhərˈʌn
مدرسه	mˌədərəsˈʌh
مزو	mˈʌzoː
مشوري	məʃˈoːri
مفتي	məfˈʌt̪i
مقالي	məqˈaːli
مقناطيسي	mˌəqnaːtˈiːsi
منتخب	mˌənət̪əxˈʌb
منصوبو	mˌənʂuːbˈoː
منٽن	mˌənəʈˈʌn
مٺا	mˈʌʈʰaː
مڪان	məkˈaːn
ناٽيڪل	nˌaːʈikˈʌl
نظارو	nəʐˈaːroː
نقاد	nəqˈaːd
نقشبندي	nˌəqəʃəbˈʌndi
نيپال	neːpˈaːl
هٿيارن	hˌətʰjaːrˈʌn
واضع	ʋˈaːzeː
وفا	ʋˈʌfaː
وهندڙ	ʋˌəhəndˈʌr.
وڪيپيڊيا	ʋˌəkipˈiːɖjaː
ي	jˈeː
ٻارهين	bˌaːrhˈiːn
ٻوڙ	bˈoːr.
ٻڌندا	bədʰˈʌndaː
ٽرمپ	ʈərˈʌmp
پختو	pˈʌxt̪oː
پرڳڻو	pˌərəɡˈʌɳoː
پهلوان	pˌəhəlʋˈaːn
پياري	pjˈaːri
پيداواري	pˌeːdaːʋˈaːri
پيروي	pˈeːrʋi
پڙهائي	pˌər.hˈaːi
پڙهندڙن	pˌər.əhˌəndər.ˈʌn
پھتو	pəhˈʌt̪oː
ڀرڻ	bʰərˈʌɳ
ڊڪشنري	ɖˌəkəʃənˈʌri
ڍل	ɖʰˈʌl
ڏسبو	ɖˌɪsbˈoː
ڪاوش	kaːˈoːʃ
ڪاٺياواڙ	kˌaːʈʰjaːʋˈaːr.
ڪرايون	kˌəraːjˈoːn
ڪريان	kərjˈaːn
ڪمائي	kəmˈaːi
ڪوارٽر	kʋˌaːrəʈˈʌr
گلابي	ɡˌəlaːbˈiː
گهيري	ɡəhˈiːri
گورنري	ɡˌoːrənˈʌri
گھڻن	ɡʰəɳˈʌn
ڳائيندو	ɡaːˈiːndoː
ڳالھائي	ɡˌaːlhˈaːi
اثرن	ˌasərˈʌn
اعجاز	aːɟˈaːz
البته	ˌaləbət̪ˈʌh
القرآن	ˌaləqrˈaːn
اليگزينڊر	ˌaliɡzinɖˈʌr
امڙ	amˈʌr.
انيس	anˈiːs
ايتريقدر	ˌeːt̪rˌiːqədˈʌr
ايستائين	ˌeːst̪aːˈiːn
بقا	bˈʌqaː
ترت	t̪ərˈʌt̪
ترجمان	t̪ˌərəɟmˈaːn
ترميم	t̪ˌərmˈiːm
جادو	ɟˈaːdoː
ججهو	ɟəɟˈʌhoː
جهنڊي	ɟəhˈʌnɖi
جيتن	ɟeːt̪ˈʌn
حواسن	hʋaːsˈʌn
خاصيتن	xˌaːʂit̪ˈʌn
خصوصيت	xˌəʂoːʂˈiːt̪
خوبصورتي	xˌoːbʂoːrˈʌt̪i
دونهين	dˌoːnhˈiːn
ديش	dˈeːʃ
ذاتيون	zaːt̪jˈoːn
ذرا	zˈʌraː
رب	rˈʌb
روانا	rʋˈaːnaː
رواني	rʋˈaːni
روڪيو	rˈoːkjoː
زون	zˈoːn
سار	sˈaːr
سرسبز	sˌərəsəbˈʌz
سورتن	sˌoːrət̪ˈʌn
سگھندو	səɡʰˈʌndoː
سے	sˈʌeː
شاهوڪار	ʃˌaːhoːkˈaːr
صوبا	ʂuːbˈaː
طريقت	tˌəriqˈʌt̪
فاني	fˈaːni
فلسفو	fˌələsˈʌfoː
قدرن	qˌədərˈʌn
قنبر	qənbˈʌr
لاهوت	laːhˈoːt̪
لاهڻ	laːhˈʌɳ
لهر	ləhˈʌr
لکندڙ	lˌəkʰəndˈʌr.
مائونٽ	mˌaːoːnˈʌʈ
متان	mət̪ˈaːn
مذڪوره	mˌəzkuːrˈʌh
مريضن	mˌərizˈʌn
مزدورن	mˌəzduːrˈʌn
مستند	məst̪ˈʌnd
معزز	maːzˈʌz
مهدي	məhˈʌdi
موڪليا	moːkˈʌljaː
ميوا	mjʋˈaː
مڪتب	mˌəkət̪ˈʌb
ن	nˈuːn
ناٿن	naːʈˈʌn
نظرياتي	naʐˈarjaːt̪ˌiː
نفس	nəfˈʌs
نفيس	nəfˈiːs
نياڻين	njaːɳˈiːn
نيڪالي	neːkˈaːli
ورھايو	ʋˌərhˈaːjoː
وسعت	ʋəsˈaːt̪
وقتي	ʋəqˈʌt̪i
ويڙهي	ʋeːr.ˈʌhi
وڄائي	ʋəɟˈaːi
يورپين	jˌoːrpˈiːn
ٺٽوي	ʈʰˈʌʈʋi
ٻارڙن	bˌaːrər.ˈʌn
ٽئگور	ʈəɡˈoːr
پردو	pˈʌrdoː
پيرون	peːrˈoːn
پيپر	peːpˈʌr
پڌري	pədʰˈʌri
ٿاڻي	tʰˈaːɳi
ڀاڱا	bʰaːˈŋ̩aː
ڇوتہ	cʰoːt̪ˈʌh
ڇڏيندي	cʰəɖˈiːndi
ڊبل	ɖəbˈʌl
ڏيک	ɖˈeːkʰ
ڦير	pʰˈeːr
ڪاروباري	kˌaːroːbˈaːri
ڪامرس	kˌaːmərˈʌs
ڪرنسي	kərˈʌnsi
ڪمپيوٽرن	kˌəmpjoːʈərˈʌn
ڪوهه	koːhˈʌh
گانڌي	ɡˈaːndʰi
گلشن	ɡˌələʃˈʌn
گي	ɡˈeː
ڳاڙھي	ɡˈaːr.hi
ڳر	ɡˈʌr
آرمينيائي	ˌaːrminjˈaːi
آريسر	ˌaːrisˈʌr
آنو	ˈaːnoː
آکيرو	aːkʰˈiːroː
اصغر	ˌaʂəɣˈʌr
اعتراف	ˌeːtɪrˈaːf
الهند	ˌaləhˈʌnd
ام	ˈam
انجي	anˈʌɟi
اوزارن	ˌuːzaːrˈʌn
اڳواٽ	aɡʋˈaːʈ
بابل	bˈaːbɪl
بازي	bˈaːzi
بالا	bˈaːlaː
برڪت	bˌərəkˈʌt̪
بهادري	bˌəhaːdˈʌri
تاريخدانن	t̪ˌaːrixdaːnˈʌn
تعارف	t̪aːrˈʌf
جسامت	ɟˌəsaːmˈʌt̪
جوڙن	ɟoːr.ˈʌn
جوڻيجي	ɟoːɳˈiːɟi
جيئرو	ɟeːˈɪroː
حجاز	həɟˈaːz
خالق	xaːlˈʌq
درميان	dˌərmjˈaːn
دورن	doːrˈʌn
ذخيرا	zəxˈiːraː
ذيلي	zˈeːli
رائي	rˈaːi
رتوديرو	rˌət̪oːdˈiːroː
رسي	rˈʌsi
رهنمائي	rˌəhənmˈaːi
رکجي	rəkʰˈʌɟi
زرخيز	zˌərxˈiːz
ستارو	sɪtˈaːroː
سينيئر	sˌeːniˈɪr
سڏبي	sˌəɖbˈiː
صفحو	ʂəfˈʌhoː
ظالم	ʐaːlˈʌm
عادت	aːdˈʌt̪
فنا	fˈʌnaː
فنڊ	fˈʌnɖ
فيصلن	fˌeːʂəlˈʌn
قديمه	qˌədimˈʌh
قمر	qəmˈʌr
لئمبرڪ	lˌəmbərˈʌk
لذيذ	ləzˈiːz
لي	lˈeː
لکڻي	ləkʰˈʌɳi
محفلن	mˈɛhfˌɪln
محلي	məhˈʌli
مدت	mədˈʌt̪
مرڪزن	mˌərəkəzˈʌn
مصرع	məʂˈʌraː
معين	maːˈiːn
منصب	mˌənəʂˈʌb
مهاڀارت	mˌəhaːbʰaːrˈʌt̪
موسمي	moːsˈʌmi
مٿانهين	mˌətʰaːnhˈiːn
نا	nˈaː
ناٿ	nˈaːʈ
نصيحت	nˌəʂihˈʌt̪
نڪرندي	nˈɪkrndi
هال	hˈaːl
واڳيل	ʋˈaːɡjal
وبا	ʋəbˈaː
وليد	ʋəlˈiːd
وهندي	ʋəhˈʌndi
وٺندي	ʋəʈʰˈʌndi
وڙهندي	ʋˌər.əhˈʌndi
وڪڙ	ʋəkˈʌr.
وڪڻي	ʋəkˈʌɳi
يمن	jəmˈʌn
ٻيلو	bˈeːloː
ٻچن	bəcˈʌn
پئماني	pəmˈaːni
پرفارمنس	pˌərfˌaːrəmˈʌns
پسنديده	pˌəsndidˈʌh
پهچايو	pˌəhəcˈaːjoː
پولو	pˈoːloː
پونديون	poːndjˈoːn
پگهار	pˌəɡhˈaːr
ٿلهي	ʈəlˈʌhi
ٿورن	tʰoːrˈʌn
ٿولھھ	tʰˌoːləhˈʌh
چالو	cˈaːloː
چرٻي	cərˈʌbi
چٽي	cˈʌʈi
ڇتين	cʰət̪ˈiːn
ڊزائين	ɖˌəzaːˈiːn
ڊگهيون	ɖˌəɡhjˈoːn
ڌماڪي	dʰəmˈaːki
ڍڪڻ	ɖʰəkˈʌɳ
ڏاڍ	ɖˈaːɖʰ
ڏسندا	ɖɪsˈʌndaː
کڻندو	kʰəɳˈʌndoː
ڪارخانن	kˌaːrxaːnˈʌn
ڪانگ	kˈaːnɡ
ڪجن	kəɟˈʌn
ڪرڻا	kərˈʌɳaː
ڪمرن	kˌəmərˈʌn
ڪوئيٽا	koːˈiːʈaː
ڪڙي	kˈʌr.i
ڪھاڻي	kəhˈaːɳi
گرنٿ	ɡˌərənˈʌʈ
گو	ɡˈoː
گوادر	ɡʋaːdˈʌr
گيتا	ɡˈeːt̪aː
گھرجن	ɡʰˌərəɟˈʌn
ڳالهائين	ɡˌaːlhaːˈiːn
ڳوٺاڻي	ɡoːʈʰˈaːɳi
ھڪڙي	həkˈʌr.i
آذربائيجاني	ˌaːzərbˈaːiɟˌaːni
اترين	ˌat̪rˈiːn
احساسن	ˌɛhsaːsˈʌn
ارڙهن	ˌarər.əhˈʌn
اسٽار	ˌasʈˈaːr
اقليت	ˌaqlˈiːt̪
النساء	alˈʌnsaː
اليڪٽرانڪ	ˌalikˌəʈraːnˈʌk
انٽرويو	ˌanəʈˈʌrʋjoː
اچو	ˈacoː
اڪريل	akˈʌrjal
بل	bˈʌl
بنت	bənˈʌt̪
بهاولپور	bˌəhaːˌoːlpˈoːr
بيهندا	bˈeːhəndˌaː
ت	tˈeː
ترڪيب	t̪ˌərkˈiːb
تصنيفن	t̪ˌəʂnifˈʌn
تقويت	t̪əqʋˈiːt̪
جاچ	ɟˈaːc
جدوجھد	ɟˌədoːɟəhˈʌd
جرنل	ɟˌərənˈʌl
جمشيد	ɟˌəmʃˈiːd
جيسلمير	ɟˌeːsəlmˈiːr
جيڪر	ɟeːkˈʌr
خور	xˈoːr
خيرات	xˌeːrˈaːt
دارا	dˈaːraː
داستانن	dˌaːst̪aːnˈʌn
ذري	zˈʌri
را	rˈaː
راجپوتانا	rˌaːɟpoːt̪ˈaːnaː
روضي	rˈoːzi
رکيائون	rˌəkʰjaːˈoːn
رھيون	rəhjˈoːn
سرمائي	sˌərmˈaːi
سعيدآباد	sˌaːidaːbˈaːd
سمورين	sˌəmoːrˈiːn
سموريون	sˌəmoːrjˈoːn
سواري	sʋˈaːri
سورهين	sˌoːrhˈiːn
سيريل	sˈeːrjal
سيل	sˈeːl
سڌريل	sədʰˈʌrjal
شيڪسپيئر	ʃˌeːkəspiˈɪr
طلاق	təlˈaːq
عثمانيه	ˌasmaːnˈiːh
علوي	ˈalʋi
عيسائين	ˌaisaːˈiːn
قاف	qˈaːf
قومپرست	qˌoːmpərˈʌst̪
قيمتن	qˌeːmət̪ˈʌn
لنگ	lˈʌnɡ
ليڪچر	lˌeːkəcˈʌr
لکڻيون	lˌəkʰɳjˈoːn
مخالفن	mʊxˈaːlɪfn
مريخ	mərˈiːx
منڊي	mˈʌnɖi
مها	mˈʌhaː
مهاجر	mˌəhaːɟˈʌr
مڃيل	mˈʌɲjal
مھينو	məhˈiːnoː
ناراض	naːrˈaːz
نارين	naːrˈiːn
نانڪ	naːnˈʌk
نروار	nərʋˈaːr
نشانين	nɪʃˈaːnin
نصرت	nˌəʂərˈʌt̪
نڙ	nˈʌr.
هشام	həʃˈaːm
هيئت	heːˈɪt̪
ورڻ	ʋərˈʌɳ
وصف	ʋəʂˈʌf
وڄائيندا	ʋˌəɟaːˈiːndaː
وڙهي	ʋər.ˈʌhi
ٺل	ʈʰˈʌl
ٻاري	bˈaːri
ٻاھرين	bˌaːhrˈiːn
ٻني	bˈʌni
ٻنين	bənˈiːn
ٻيڙيون	beːr.jˈoːn
ٽولي	ʈˈoːli
پتڻ	pət̪ˈʌɳ
پلوٽو	pəlˈoːʈoː
پنهنجين	pʌ̃hnɟˈiːn
پويون	pʋjˈoːn
ٿانون	tʰaːnˈoːn
ڀڄائي	bʰəɟˈaːi
چندو	cˈʌndoː
ڇوڪرا	cʰoːkˈʌraː
ڇپرايو	cʰˌəprˈaːjoː
ڇڏجن	cʰˌəɖəɟˈʌn
ڍڪي	ɖʰˈʌki
ڍڳي	ɖʰˈʌɡi
کو	kʰˈoː
ڪابينا	kaːbˈiːnaː
ڪارنامو	kˌaːrnˈaːmoː
گاڏين	ɡaːɖˈiːn
گذاريو	ɡəzˈaːrjoː
گذران	ɡˌəzrˈaːn
گمان	ɡəmˈaːn
گهوٽي	ɡəhˈoːʈi
ڳائيندي	ɡaːˈiːndi
آريائي	aːrjˈaːi
ائڪٽ	ˌaːɪkˈʌʈ
انت	anˈʌt̪
انگلش	ˌanɡəlˈʌʃ
اونھاري	uːnhˈaːri
ايرانين	ˌeːraːnˈiːn
اڏيل	ˈaɖjal
بستي	bˈʌst̪i
بطوطه	bˌətoːtˈʌh
بندش	bəndˈʌʃ
بڻيل	bˈʌɳjal
بھادر	bˌəhaːdˈʌr
تاريخدان	t̪ˌaːrixdˈaːn
تسلط	t̪ˌəsəlˈʌt
توھان	t̪oːhˈaːn
جئان	ɟəˈaːn
جاسوسي	ɟaːsˈoːsi
جنگيون	ɟənɡjˈoːn
جهانگير	ɟˌəhaːnɡˈiːr
جهوني	ɟəhˈoːni
جھازن	ɟˌəhaːzˈʌn
خطو	xˈʌtoː
خوبي	xoːbˈiː
دادا	dˈaːdaː
دراوڙي	dˌəraːˈoːr.i
دماغي	dəmˈaːɣi
رانديون	raːndjˈoːn
راڻو	rˈaːɳoː
ردعمل	rˌədaːmˈʌl
رستم	rəst̪ˈʌm
روزي	rˈoːzi
زلزلي	zˌalzˈali
سامراج	sˌaːmrˈaːɟ
ساک	sˈaːkʰ
سنئين	sˌənˈiːn
سيارا	sjˈaːraː
سيف	sˈeːf
سڄڻ	səɟˈʌɳ
سگھجن	sˌəɡʰəɟˈʌn
شاهد	ʃaːhˈʌd
صفرا	ʂəfˈʌraː
صنعتن	ʂˌənaːt̪ˈʌn
ضم	zˈʌm
عبدالحق	ˌabdˌaːləhˈʌq
عبراني	ˌabrˈaːni
عروض	arˈoːz
عمدو	amˈʌdoː
غارن	ɣaːrˈʌn
فرمايائون	fˌərmˌaːjaːˈoːn
فضيلت	fˌəzilˈʌt̪
فلسطيني	fˌələstˈiːni
فورم	foːrˈʌm
فھرست	fˌəhərˈʌst̪
قاعدا	qˈaːjdaː
لائي	lˈaːi
لاچار	laːcˈaːr
لهجو	ləhˈʌɟoː
ليول	ljˈoːl
ليکڪا	leːkʰˈʌkaː
محدث	mˌəhədˈʌs
مشرق	mˈaʃrˌɪq
معنائون	mˌaːnaːˈoːn
منڍ	mənˈʌɖʰ
مهاجرن	mˌəhaːɟərˈʌn
مهاراجا	mˌəhaːrˈaːɟaː
موقف	moːqˈʌf
موڙي	mˈoːr.i
مي	mˈeː
ميروخان	mˌeːroːxˈaːn
ميڊل	meːɖˈʌl
ناممڪن	nˌaːməməkˈʌn
ناياب	naːjˈaːb
نشاندهي	nɪʃˈaːndəhˌiː
نظريا	naʐˈarjaː
هلايو	həlˈaːjoː
هلڪو	həlˈʌkoː
هڪجهڙائي	hˌəkəɟˌəhər.ˈaːi
واپسي	ʋaːpˈʌsi
ورتيون	ʋˌərt̪jˈoːn
وندر	ʋəndˈʌr
وينس	ʋˈeːns
وڙهيو	ʋər.ˈʌhjoː
وھي	ʋˈʌhi
ٻور	bˈoːr
ٽائيپ	ʈaːˈiːp
پرويز	pərʋˈiːz
پرين	pərˈiːn
پرڪاش	pˌərkˈaːʃ
پھرئين	pˌəhərˈiːn
ڀاڳ	bʰˈaːɡ
ڇپجڻ	cʰˌəpəɟˈʌɳ
ڌنڌي	dʰˈʌndʰi
ڏيو	ɖjˈoː
ڏھاڪي	ɖəhˈaːki
ڦٽ	pʰˈʌʈ
کوسو	kʰˈoːsoː
کوٽي	kʰˈoːʈi
ڪانگو	kˈaːnɡoː
ڪاٺين	kaːʈʰˈiːn
ڪشي	kˈʌʃi
ڪمرشل	kˌəmərəʃˈʌl
ڪوٺي	kˈoːʈʰi
ڪڙڇ	kər.ˈʌcʰ
گهريلو	ɡˌəhərˈiːloː
گوري	ɡˈoːri
گولو	ɡˈoːloː
گھرڙي	ɡʰərˈʌr.i
ھزارين	hˌəzaːrˈiːn
ھيٺان	heːʈʰˈaːn
آسماني	ˌaːsmˈaːni
اقتصاديات	ˌɪqtɪʂˌaːdiˈaːt
المعروف	ˌalmaːrˈoːf
انتظار	ˌɪntɪʐˈaːr
ايواني	eːʋˈaːni
بزم	bəzˈʌm
بلبل	bˌələbˈʌl
بنيو	bˈʌnjoː
بنگلي	bənɡˈʌli
بوڪ	bˈoːk
بينڪ	bˈeːnək
بيھي	bˈeːhi
بڪ	bˈʌk
ثانوي	sˈaːnʋi
جاگيردار	ɟˌaːɡirdˈaːr
جاگيرداري	ɟˌaːɡirdˈaːri
جعفري	ɟaːfˈʌri
جملو	ɟˈʊmloː
جهنڊو	ɟəhˈʌnɖoː
جويي	ɟʋjˈeː
جھنگلي	ɟˌəhənɡˈʌli
حاضري	haːzˈʌri
حلقن	hˌələqˈʌn
خرابي	xˌəraːbˈiː
خواه	xʋˈaːh
درسي	dərˈʌsi
درويشن	dˌərʋiʃˈʌn
درگاه	dˌərɡˈaːh
ديري	dˈeːri
راهي	rˈaːhi
رچرڊ	rˌəcərˈʌɖ
رکيون	rəkʰjˈoːn
رھاڪو	rəhˈaːkoː
ساحل	saːhˈʌl
ساقي	sˈaːqi
سربراهي	sˌərəbrˈaːhi
سلهاڙيل	sˌəlhˈaːr.jal
سنگاپور	sˌənɡaːpˈoːr
سهوليت	sˌəhoːlˈiːt̪
سويت	sʋˈeːt̪
سڪن	səkˈʌn
سڪو	sˈʌkoː
سڪونت	sˌəkoːnˈʌt̪
سڳوري	səɡˈoːri
سھولتن	sˌəhoːlət̪ˈʌn
شال	ʃˈaːl
شفاف	ʃəfˈaːf
شمشير	ʃˌəmʃˈiːr
شڪتي	ʃəkˈʌt̪i
شڪليون	ʃˌəkljˈoːn
صوفياڻي	ʂoːfjˈaːɳi
ضرب	zərˈʌb
ضلع	zˈʌlaː
عين	aˈiːn
فائنل	fˌaːɪnˈʌl
فاصلو	faːʂˈʌloː
فسادن	fˌəsaːdˈʌn
فقه	fəqˈʌh
قافيو	qˈaːfjoː
لالچ	laːlˈʌc
مارو	mˈaːroː
ماريا	mˈaːrjaː
ماسٽرس	mˌaːsəʈərˈʌs
ماڻڻ	maːɳˈʌɳ
محلات	mˌəhəlˈaːt
مشابهت	mˌəʃaːbəhˈʌt̪
معاشرتي	mˌaːʃərˈʌt̪i
مقدمي	mʊqˈadmi
ملھايو	mˌəlhˈaːjoː
موبائل	moːbˈaːɪl
موڪليندو	mˌoːklˈiːndoː
ناليوارو	naːljʋˈaːroː
ناليواري	naːljʋˈaːri
نسخا	nəsˈʌxaː
نوراني	noːrˈaːni
هاڪڙو	haːkˈʌr.oː
هل	hˈʌl
همايون	hˌəmaːjˈoːn
هوڏانهن	hˌoːɖaːnəhˈʌn
هيلٿ	heːlˈʌʈ
هٽي	hˈʌʈi
ورق	ʋərˈʌq
ورڪ	ʋərˈʌk
وسايو	ʋəsˈaːjoː
وسي	ʋˈʌsi
وسيلو	ʋəsˈiːloː
وڌائين	ʋˌədʰaːˈiːn
يوٽوپيا	joːʈˈoːpjaː
ٺاٺ	ʈʰˈaːʈʰ
ٺٽ	ʈʰˈʌʈ
ٻاھران	bˌaːhrˈaːn
ٻيئي	bˈeːi
ٽوڙڻ	ʈoːr.ˈʌɳ
پندرهين	pˌəndərhˈiːn
پهچ	pəhˈʌc
پوڪرداس	pˌoːkrdˈaːs
پٺي	pˈʌʈʰi
پٽين	pəʈˈiːn
ٿڃ	ʈˈʌɲ
ڀلو	bʰˈʌloː
چونڊيندا	coːnɖˈiːndaː
چڙهيل	cər.ˈʌhjal
ڇپايا	cʰəpˈaːjaː
ڇڏينديون	cʰˌəɖindjˈoːn
ڊالرن	ɖˌaːlərˈʌn
ڊسڪ	ɖəsˈʌk
ڌي	dʰˈeː
ڏهرن	ɖˌəhərˈʌn
ڏٺي	ɖˈʌʈʰi
کسي	kʰˈʌsi
کنيا	kʰˈʌnjaː
ڪائونسلر	kˌaːoːnsəlˈʌr
ڪارناما	kˌaːrnˈaːmaː
ڪامن	kaːmˈʌn
ڪرن	kərˈʌn
ڪلهه	kˌələhˈʌh
ڪلياڻ	kəljˈaːɳ
ڪولمبيا	kˌoːlmbjˈaː
ڪينجهر	kˌeːnəɟəhˈʌr
گھيريل	ɡʰˈeːrjal
آيتون	ˌaːit̪ˈoːn
ارسطو	ˌarəsˈʌtoː
ارشاد	ˌarʃˈaːd
اسرائيلي	ˌasraːˈiːli
اسڪيم	ˌaskˈiːm
اعزازي	eːzˈaːzi
افسانا	ˌafsˈaːnaː
الرحمان	ˌalərˌəhmˈaːn
ايئرپورٽ	eːˈɪrpˌoːrəʈ
اٽلي	aʈˈʌli
اپٻيٽ	ˌapbˈiːʈ
با	bˈaː
بالغ	bˈaːləɣ
بخشي	bəxˈʌʃi
برباد	bˌərbˈaːd
بهرام	bˌəhərˈaːm
بيشڪ	bˈeːʃək
تاثير	t̪aːsˈiːr
جاگيرون	ɟˌaːɡirˈoːn
جيئري	ɟeːˈɪri
جيمز	ɟeːmˈʌz
حاڪميت	hˌaːkmˈiːt̪
حقدار	hˌəqdˈaːr
حڪومتون	hˌəkoːmt̪ˈoːn
خاڪ	xˈaːk
خواهه	xʋaːhˈʌh
خيبر	xeːbˈʌr
دروازن	dˌərʋaːzˈʌn
دريائي	dərjˈaːi
دستياب	dəst̪jˈaːb
دعوا	dˈaːʋaː
رابرٽ	rˌaːbərˈʌʈ
رک	rˈʌkʰ
سائمن	sˌaːɪmˈʌn
ساڌو	sˈaːdʰoː
سختي	sˈʌxt̪i
سرگرمي	sˌarɡˈarmi
سلسليوار	sˈɪlsˌɪljʋaːr
سولائي	soːlˈaːi
سوني	sˈoːni
سوٽ	sˈoːʈ
سوچي	sˈoːci
سڙي	sˈʌr.i
شجاع	ʃˈʌɟaː
شيعه	ʃˈiːh
شيوا	ʃjʋˈaː
شھنشاھ	ʃˌəhənʃˈaːh
عرق	arˈʌq
علامتن	ˌalaːmət̪ˈʌn
عمدي	amˈʌdi
فاروق	faːrˈoːq
فلڪيات	fˌəlkiˈaːt
قيدي	qˈeːdi
لنگر	lənɡˈʌr
لکندي	ləkʰˈʌndi
مئل	mˈʌl
مارڪ	maːrˈʌk
محسن	mˈoːhsˌɪn
مسافرن	mˌəsaːfərˈʌn
مسلڪ	mˌəsəlˈʌk
مشورو	məʃˈoːroː
معتبر	mˌaːt̪əbˈʌr
ملير	məlˈiːr
ملٽري	mˌələʈˈʌri
منگولن	mˌənɡuːlˈʌn
مولود	moːlˈoːd
موٽڻ	moːʈˈʌɳ
ميگزين	mˌeːɡzˈiːn
مٽائي	məʈˈaːi
ناريل	nˈaːrjal
نديون	nədjˈoːn
نوڪرين	nˌoːkrˈiːn
نگاهه	nˌəɡaːhˈʌh
هاٿي	hˈaːtʰi
هوريان	hoːrjˈaːn
هوٽل	hoːʈˈʌl
وحي	ʋˈʌhi
وصول	ʋəʂˈoːl
وير	ʋˈeːr
وڻج	ʋəɳˈʌɟ
ياسين	jaːsˈiːn
يعقوبي	jˌaːqoːbˈiː
ٺهن	ʈʰəhˈʌn
ٻئين	bəˈiːn
ٻهراڙين	bˌəhəraːr.ˈiːn
ٽيليفون	ʈˌeːlifˈoːn
پاري	pˈaːri
پايو	pˈaːjoː
پرک	pərˈʌkʰ
پلانٽ	pˌəlaːnˈʌʈ
پوکيو	pˈoːkʰjoː
پيلا	pˈeːlaː
پٺتي	pəʈʰˈʌt̪i
پڪل	pəkˈʌl
ڀرجي	bʰərˈʌɟi
ڄاول	ɟaːˈoːl
چاچو	cˈaːcoː
ڇوته	cʰoːt̪ˈʌh
ڍڪ	ɖʰˈʌk
ڏاهپ	ɖaːhˈʌp
ڏنائون	ɖˌənaːˈoːn
ڏنڊ	ɖˈʌnɖ
ڏٺائين	ɖˌəʈʰaːˈiːn
ڦليلي	pʰəlˈiːli
ڪئمپ	kˈʌmp
ڪارل	kaːrˈʌl
ڪاڙهي	kaːr.ˈʌhi
ڪربلا	kˌərəbˈʌlaː
ڪچا	kˈʌcaː
ڪھڙي	kəhˈʌr.i
گدو	ɡˈʌdoː
گهراڻو	ɡˌəhərˈaːɳoː
گچ	ɡˈʌc
ڳالهائيندڙن	ɡˌaːlhˌaːindər.ˈʌn
ڳالھائيندڙ	ɡˌaːlhˌaːindˈʌr.
ڳوٺاڻن	ɡˌoːʈʰaːɳˈʌn
آبشار	ˌaːbʃˈaːr
آستان	aːst̪ˈaːn
آڱرين	ˌaːŋ̩rˈiːn
آڻ	ˈaːɳ
اختلافن	ˌɪxtɪlaːfˈʌn
الهيار	ˌalhjˈaːr
الياس	aljˈaːs
انچارج	ˌancaːrˈʌɟ
اهائي	ahˈaːi
اڄوڪي	aɟˈoːki
اڏو	ˈaɖoː
اڳين	aɡˈiːn
بادام	bˈaːdaːm
بجار	bəɟˈaːr
برساتي	bˌərsˈaːt̪i
بلا	bˈʌlaː
بليڪ	bəlˈiːk
بلڪہ	bˌələkˈʌh
بيدي	bˈeːdi
بيوس	bjˈoːs
بچايو	bəcˈaːjoː
بڻيا	bˈʌɳjaː
تبت	t̪əbˈʌt̪
ترانو	t̪ərˈaːnoː
تصويرن	t̪ˌəʂʋirˈʌn
تقريرون	t̪ˌəqrirˈoːn
تور	t̪ˈoːr
تيسين	t̪eːsˈiːn
جهلڻ	ɟˌəhəlˈʌɳ
جوزف	ɟoːzˈʌf
حلقي	həlˈʌqi
خادم	xaːdˈʌm
درٻاري	dˌərbˈaːri
دست	dˈʌst̪
دعائون	daːˈoːn
دڙن	dər.ˈʌn
راجسٿان	rˌaːɟəstʰˈaːn
راوي	rˈaːʋi
رهيل	rˈʌhjal
رکبو	rˌəkʰbˈoː
زيد	zˈeːd
ساگر	saːɡˈʌr
ستاري	sɪtˈaːri
ستت	sət̪ˈʌt̪
سردي	sˈʌrdi
سرواڻ	sərʋˈaːɳ
سنهي	sənˈʌhi
سومر	soːmˈʌr
سڌارن	sˌədʰaːrˈʌn
سڙهه	sˌər.əhˈʌh
شعبان	ʃˈɔbaːn
شعبو	ʃˈɔboː
صاحبي	ʂˌaːhbˈiː
صفر	ʂəfˈʌr
صه	ʂˈʌh
ضابطي	zaːbˈʌti
عزيزن	ˌazizˈʌn
عقيدتمند	ˌaqidˌət̪əmˈʌnd
علامتي	ˌalaːmˈʌt̪i
غلامي	ɣəlˈaːmi
غوث	ɣˈoːs
لازم	laːzˈʌm
مئجسٽريٽ	mˌəɟəsˌəʈrˈiːʈ
مئگزين	mˌəɡzˈiːn
مالدار	mˌaːldˈaːr
مجاهدن	mˌəɟaːhədˈʌn
مجموعا	məɟˈʌmʋaː
محور	məhˈoːr
مراڪش	mˌəraːkˈʌʃ
مطلق	mˌətəlˈʌq
معاشيات	mˌaːʃiˈaːt
معاملو	maːmˈʌloː
منصوب	mˌənʂˈuːb
موافق	mʋaːfˈʌq
مورو	mˈoːroː
ميونسپلٽي	mjˌoːnsəpəlˈʌʈi
ميچ	mˈeːc
مھراڻ	mˌəhrˈaːɳ
ناروي	nˈaːrʋi
نتيجن	nˌət̪iɟˈʌn
نقشن	nˌəqəʃˈʌn
ني	nˈeː
نيرو	nˈeːroː
نيٽ	nˈeːʈ
نگارن	nˌəɡaːrˈʌn
هرات	hˌərˈaːt
هنيو	hˈʌnjoː
وارھ	ʋaːrˈʌh
وال	ʋˈaːl
وجهه	ʋˌəɟəhˈʌh
وسڪاري	ʋˌəskˈaːri
ولين	ʋəlˈiːn
ويدڪ	ʋeːdˈʌk
وڌا	ʋˈʌdʰaː
يافتہ	jˌaːfət̪ˈʌh
يقيني	jəqˈiːni
ٻاڦ	bˈaːpʰ
ٻوڙي	bˈoːr.i
ٻھراڙي	bˌəhrˈaːr.i
ٽيسٽ	ʈeːsˈʌʈ
ٽپال	ʈəpˈaːl
پسمنظر	pˌəsmˌanʐˈar
پوئلڳن	poːˈɪləɡˌən
پورچوگيزن	pˌoːrcoːɡizˈʌn
پيوند	pjˈoːnd
پچ	pˈʌc
پھتا	pəhˈʌt̪aː
ڀڄڻ	bʰəɟˈʌɳ
چشمن	cˌəʃəmˈʌn
ڇاپيو	cʰˈaːpjoː
ڇڪي	cʰˈʌki
ڊوڙ	ɖˈoːr.
ڌاڙيلن	dʰˌaːr.ilˈʌn
ڏڻ	ɖˈʌɳ
ڪاپيون	kaːpjˈoːn
ڪجه	kəɟˈʌh
ڪفن	kəfˈʌn
ڪونڊين	koːnɖˈiːn
ڪونہ	koːnˈʌh
ڪوهن	koːhˈʌn
ڪچهري	kˌəcəhˈʌri
ڪڙو	kˈʌr.oː
ڪھڪشان	kˌəhəkʃˈaːn
گزيٽيئر	ɡˌəziʈiˈɪr
گهرج	ɡˌəhərˈʌɟ
ڳلي	ɡˈʌli
ھ	dˌɔcaʃmˈiːheː
ھجرت	hˌəɟərˈʌt̪
ھيء	hˈeː
ھٿن	həʈˈʌn
آرا	ˈaːraː
آفريقا	ˌaːfrˈiːqaː
آهين	aːhˈiːn
ائسوسيئيشن	ˌaːɪsˌoːsiiʃˈʌn
اتريون	ˌat̪rjˈoːn
اجاگر	ˌaɟaːɡˈʌr
اسٽاڪ	ˌasʈˈaːk
اسپنوزا	ˌasəpnˈoːzaː
الثاني	ˌalsˈaːni
انتھائي	ˌɪntɪhˈaːi
انڊسٽري	ˌɪnɖasʈˈʌri
اوهين	uːhˈiːn
ايجنسي	eːɟˈʌnsi
ايلزبيٿ	ˌeːləzbˈiːʈ
ايليا	ˈeːljaː
اپ	ˈap
اپر	apˈʌr
اڳيئي	aɡˈiːi
باغين	bˈaːɣin
بانس	bˈaːns
بلال	bəlˈaːl
بيڪار	bˈeːkaːr
بڻي	bˈʌɳi
تاريخون	t̪ˌaːrixˈoːn
تال	t̪ˈaːl
ترجماني	t̪ˌərəɟmˈaːni
تصوراتي	t̪ˌəʂoːrˈaːt̪i
تصورن	t̪ˌəʂoːrˈʌn
تيرٿ	t̪eːrˈʌʈ
جاپاني	ɟaːpˈaːni
جلاب	ɟəlˈaːb
جمادي	ɟəmˈaːdi
جملن	ɟˈʊmln
جنھنڪري	ɟˌənhnəkˈʌri
جهل	ɟəhˈʌl
جيڏا	ɟˈeːɖaː
خانا	xˈaːnaː
خدابخش	xˌədaːbəxˈʌʃ
خليفه	xˌəlifˈʌh
درآمد	dˌəraːmˈʌd
درياهن	dˌərjaːhˈʌn
دسترس	dˌəst̪ərˈʌs
دفاعي	dˈɪfaːˌiː
دلين	dəlˈiːn
دوائون	dʋaːˈoːn
دوهي	dˈoːhi
ديهانت	dˌeːhaːnˈʌt̪
ذائقو	zaːˈɪqoː
ذهانت	zˌəhaːnˈʌt̪
راجستان	rˌaːɟˈɪstaːn
رضوي	rˈʌzʋi
روزانه	rˌoːzaːnˈʌh
روين	rʋˈeːn
رٻڙ	rəbˈʌr.
زيتون	zeːt̪ˈoːn
سازي	sˈaːzi
سانگ	sˈaːnɡ
ساوڪ	saːˈoːk
سرڪل	sˌərəkˈʌl
سفرنامي	sˌəfərnˈaːmi
سلا	sˈʌlaː
سماع	sˈʌmaː
سنڌيڪا	sɪndhˈiːkaː
سهائتا	sˌəhaːˈɪt̪aː
سورھين	sˌoːrhˈiːn
سياحتي	sjaːhˈʌt̪i
سياستدانن	sjˌaːst̪ədaːnˈʌn
سپرد	sʊpˈʊrd
صاحبن	ʂˌaːhəbˈʌn
صحافتي	ʂˌəhaːfˈʌt̪i
ضبط	zəbˈʌt
عبدالواحد	ˌabdˌaːlʋaːhˈʌd
عجب	aɟˈʌb
علت	alˈʌt̪
غزلن	ɣˌəzəlˈʌn
قلعا	qˈʌlaː
لئي	lˈʌi
لنگھ	lˈʌnɡʰ
لٽ	lˈʌʈ
مؤرخ	mˌəa͡ʊrˈʌx
مالياتي	maːljˈaːt̪i
مبني	məbˈʌni
مجسمو	mˌəɟəsˈʌmoː
مدراس	mˌədrˈaːs
مرهم	mˌərəhˈʌm
مست	mˈʌst̪
مشاهدي	mˌəʃaːhˈʌdi
معمول	maːmˈoːl
منتر	mˌənət̪ˈʌr
موٽر	moːʈˈʌr
مڇين	məcʰˈiːn
مکي	mˈʌkʰi
مکيہ	məkʰˈiːh
مڻ	mˈʌɳ
نجات	nˌəɟˈaːt
نجم	nəɟˈʌm
نظمن	nˌəʐəmˈʌn
نڀايو	nəbʰˈaːjoː
وارهه	ʋˌaːrəhˈʌh
واقفيت	ʋˌaːqfˈiːt̪
واه	ʋˈaːh
وايون	ʋaːjˈoːn
واٽر	ʋaːʈˈʌr
وسيلا	ʋəsˈiːlaː
وقفي	ʋəqˈʌfi
ونگ	ʋˈʌnɡ
ويھي	ʋˈeːhi
وڃڻو	ʋəɲˈʌɳoː
وچئين	ʋˌəcˈiːn
وڪري	ʋəkˈʌri
ٻارنهن	bˌaːrənəhˈʌn
ٻارھن	bˌaːrəhˈʌn
پادري	paːdˈʌri
پرائي	pərˈaːi
پريت	pərˈiːt̪
پنھجي	pˈʌnhɟi
پوين	pʋˈeːn
ٿڌ	ʈˈʌdʰ
ڀيرومل	bʰˌeːroːmˈʌl
ڀٽون	bʰəʈˈoːn
ڄاڻڻ	ɟaːɳˈʌɳ
چاري	cˈaːri
چنا	cˈʌnaː
چهنب	cəhˈʌnb
ڇاپا	cʰˈaːpaː
ڊزائن	ɖˌəzaːˈɪn
ڍانچو	ɖʰˈaːncoː
کائين	kʰaːˈiːn
کوسي	kʰˈoːsi
کولڻ	kʰoːlˈʌɳ
کيڏي	kʰˈeːɖi
ڪابينه	kaːbˈiːnəh
ڪابہ	kaːbˈɪh
ڪانفرنسن	kˌaːnəfˌərənsˈʌn
ڪروڙين	kˌəroːr.ˈiːn
ڪمزوري	kˌəmzˈuːri
ڪنڊي	kˈʌnɖi
ڪيپٽن	kˌeːpəʈˈʌn
ڪٺو	kˈʌʈʰoː
ڪھاڻين	kˌəhaːɳˈiːn
گدلاڻ	ɡˌədlˈaːɳ
گذاريندو	ɡˌəzaːrˈiːndoː
گند	ɡˈʌnd
ھٿيار	hətʰjˈaːr
ھڪڙو	həkˈʌr.oː
آبادين	aːbˈaːdin
آرڪيالاجي	ˌaːrkjaːlˈaːɟi
آگاهه	ˌaːɡaːhˈʌh
آڱريون	ˌaːŋ̩rjˈoːn
ائٽمي	aʈˈʌmi
اثرانداز	ˌasraːndˈaːz
اسلوب	ˌaslˈoːb
اسٽيل	asˈʌʈjal
اسڪرپٽ	ˌasəkˌərəpˈʌʈ
اطالوي	atˈaːlʋi
ال	ˈal
اليڪٽرڪ	ˌalikˌəʈərˈʌk
امانت	ˌamaːnˈʌt̪
اوتري	uːt̪ˈʌri
ايڪشن	ˌeːkəʃˈʌn
اٺون	aʈʰˈoːn
اٿائين	ˌatʰaːˈiːn
اڀرڻ	ˌabʰərˈʌɳ
اڳٺ	aɡˈʌʈʰ
باگي	bˈaːɡi
باگڙي	bˈaːɡr.ˌiː
برطانيه	bˌərtaːnˈiːh
برنس	bərˈʌns
برپا	bərˈʌpaː
بزنس	bəzˈʌns
بچيو	bˈʌcjoː
بھار	bəhˈaːr
تمدن	t̪ˌəmədˈʌn
تهذيبن	t̪ˌəhəzibˈʌn
جر	ɟˈʌr
جـي	ɟˈiːmlˈetəcʰˈahacˈaːrbˈʊr.ijˈeː
جلاوطن	ɟˌəlaːoːtˈʌn
جولاء	ɟˈoːlaː
جھڙا	ɟəhˈʌr.aː
حليم	həlˈiːm
حڪيمن	hˌəkimˈʌn
خاڪو	xˈaːkoː
خراج	xərˈaːɟ
خلق	xəlˈʌq
خليفن	xˌəlifˈʌn
خوشحالي	xˈʊʃhaːlˌiː
دؤران	dˌəa͡ʊrˈaːn
دستي	dˈʌst̪i
دوزخ	doːzˈʌx
ديوناگري	djˌoːnaːɡˈʌri
ذوق	zˈoːq
رابطن	rˌaːbətˈʌn
راڄڌاني	rˌaːɟdʰˈaːni
رسيو	rˈʌsjoː
رويو	rʋjˈoː
رياض	rjˈaːz
رڪنن	rˌəkənˈʌn
زبر	zəbˈʌr
زين	zˈeːn
ستار	sɪtˈaːr
سرسوتي	sˌərsˈuːt̪i
سفرنامو	sˌəfərnˈaːmoː
سقراط	sˌəqrˈaːt
سوڍن	soːɖʰˈʌn
سيڪيولر	sˌeːkjoːlˈʌr
سگهوئي	sˌəɡhˈoːi
شهدادڪوٽ	ʃˌəhədˌaːdkˈoːʈ
شيام	ʃjˈaːm
صاحبه	ʂˌaːhəbˈʌh
صف	ʂˈʌf
ضابطو	zaːbˈʌtoː
ضايع	zˈaːjaː
عامل	aːmˈʌl
غيبي	ɣeːbˈiː
فرقن	fˌərəqˈʌn
قائداعظم	qˌaːɪdˌaːaːʐˈʌm
قريش	qərˈiːʃ
لاٿو	lˈaːtʰoː
ليمي	lˈeːmi
ليپ	lˈeːp
ليڪچرر	lˌeːkəcərˈʌr
لٿو	lˈʌtʰoː
مارائي	maːrˈaːi
مالڪن	mˌaːləkˈʌn
ماڙي	mˈaːr.i
ماڻهون	mˌaːɳhˈoːn
مزيدار	mˌəzidˈaːr
مستحڪم	mˌəst̪əhəkˈʌm
مقالن	mˌəqaːlˈʌn
مقبرا	mˌəqəbˈʌraː
منجهه	mˌənəɟəhˈʌh
منطق	mˌənətˈʌq
مهاڻا	məhˈaːɳaː
ميئر	meːˈɪr
ميدانن	mˌeːdaːnˈʌn
ميڻ	mˈeːɳ
مھارت	mˌəhaːrˈʌt̪
نازي	nˈaːzi
نسيم	nəsˈiːm
نصب	nəʂˈʌb
نظرانداز	naʐˈaraːndˌaːz
نعرو	nˈaːroː
نمائندن	nˈʊmaːˈɪndən
نين	nˈeːn
هاڻوڪو	haːɳˈoːkoː
همراهه	hˌəmraːhˈʌh
هميشہ	hˌəmiʃˈʌh
هوم	hˈoːm
هيرا	hˈeːraː
واکاڻ	ʋaːkʰˈaːɳ
ورهائڻ	ʋˌərhaːˈɪɳ
ورھائي	ʋˌərhˈaːi
ويم	ʋˈeːm
ويٽنام	ʋˌeːʈnˈaːm
وڪٽوريا	ʋˌəkʈˈoːrjaː
يارهن	jˌaːrəhˈʌn
يارهين	jˌaːrhˈiːn
يوروپي	joːrˈoːpi
ٺاهيندڙ	ʈʰˌaːhindˈʌr.
ٺهرايل	ʈʰˌəhərˈaːjal
ٻڏي	bˈʌɖi
ٻڪرين	bˌəkrˈiːn
ٽڪرو	ʈəkˈʌroː
پاتو	pˈaːt̪oː
پالڻ	paːlˈʌɳ
پرمار	pˌərmˈaːr
پنجويهه	pˌənɟʋihˈʌh
پنهجي	pˌənəhˈʌɟi
پهاڙن	pˌəhaːr.ˈʌn
پولينڊ	poːlˈiːnɖ
پوڄاري	poːɟˈaːri
پڪا	pˈʌkaː
ڀڄن	bʰəɟˈʌn
ڄاتل	ɟaːt̪ˈʌl
ڄڻا	ɟˈʌɳaː
چوڌري	coːdʰˈʌri
چڪ	cˈʌk
ڇٽي	cʰˈʌʈi
ڇڏيائون	cʰˌəɖjaːˈoːn
ڊان	ɖˈaːn
ڊاک	ɖˈaːkʰ
ڌمال	dʰəmˈaːl
ڍنگ	ɖʰˈʌnɡ
ڏن	ɖˈʌn
ڏهاڙو	ɖəhˈaːr.oː
ڏهاڪو	ɖəhˈaːkoː
ڦوڳ	pʰˈoːɡ
ڦيرو	pʰˈeːroː
کرل	kʰərˈʌl
ڪتابت	kˌɪtaːbˈʌt̪
ڪرائيندو	kˌəraːˈiːndoː
ڪمپنين	kˌəmpənˈiːn
ڪنگڊم	kˌənɡəɖˈʌm
ڪيليفورنيا	kˌeːlifoːrˈʌnjaː
گاڏيون	ɡaːɖjˈoːn
گرائونڊ	ɡˌəraːˈoːnɖ
گهٽائڻ	ɡˌəhəʈaːˈɪɳ
گويا	ɡʋjˈaː
گڏجاڻي	ɡˌəɖɟˈaːɳi
گھري	ɡʰˈʌri
ڳالهائيندا	ɡˌaːlhaːˈiːndaː
ڳانڍاپو	ɡˌaːnɖʰˈaːpoː
ھليو	hˈʌljoː
ھندن	həndˈʌn
ھڏڪي	həɖˈʌki
آشرم	ˌaːʃərˈʌm
آنن	aːnˈʌn
آڊيو	ˈaːɖjoː
آکاڻي	aːkʰˈaːɳi
آڪاش	aːkˈaːʃ
آگري	aːɡˈʌri
آڳاٽا	aːɡˈaːʈaː
احسن	ɛhsˈʌn
ادراڪ	ˌadrˈaːk
استحصال	ˌɪstɛhʂˈaːl
اسپارٽا	ˌaspaːrˈʌʈaː
اسڪردو	ˌasəkˈʌrdoː
افساني	ˌafsˈaːni
افضل	ˌafəzˈʌl
الانا	alˈaːnaː
اندرئين	ˌandərˈiːn
اينٽي	eːnˈʌʈi
اپت	apˈʌt̪
اپيل	ˈapjal
بئڪٽيريا	bˌəkʈˈiːrjaː
بارود	bˈaːroːd
بحران	bˌəhrˈaːn
برک	bərˈʌkʰ
بندوق	bəndˈuːq
بهتري	bˌəhət̪ˈʌri
بيضوي	bˈeːzʋi
بيل	bˈeːl
بيهندو	bˈeːhəndˌoː
تارون	t̪aːrˈoːn
تجزيو	t̪əɟˈʌzjoː
تذڪره	t̪ˌəzəkərˈʌh
ترڪن	t̪ˌərəkˈʌn
تصنيفون	t̪ˌəʂnifˈoːn
تهذيبي	t̪ˌəhəzibˈiː
تڏهوڪي	t̪ˌəɖhˈuːki
جذبو	ɟˌəzbˈoː
جمھوريت	ɟˌəmhuːrˈiːt̪
جواهر	ɟˈaʋaːhˌər
جوت	ɟˈoːt̪
جيلن	ɟeːlˈʌn
حاتم	haːt̪ˈʌm
حر	hˈʌr
حساس	həsˈaːs
خاصخيلي	xˌaːʂxˈiːli
خواجا	xʋˈaːɟaː
خوشگوار	xˈʊʃɡʋaːr
خوفناڪ	xˌoːfnˈaːk
خوني	xˈoːni
داغستان	dˌaːɣˈɪstaːn
دلڪش	dˌələkˈʌʃ
دڙا	dˈʌr.aː
رهڻي	rəhˈʌɳi
رونق	roːnˈʌq
روپين	roːpˈiːn
رڇ	rˈʌcʰ
رکنديون	rˌəkʰndjˈoːn
رڻپٽ	rˌəɳəpˈʌʈ
زبردستي	zˌəbərdˈʌst̪i
زندهه	zˈɪndhəh
زينت	zeːnˈʌt̪
ساساني	saːsˈaːni
سببان	sˌəbbˈaːn
سترھين	sˌət̪ərhˈiːn
سخاوت	sˌəxaːˈoːt̪
سرمائيداري	sˌərmˌaːidˈaːri
سلسلن	sˈɪlsˌɪln
سم	sˈʌm
سمرقند	sˌəmərəqˈʌnd
سنهو	sənˈʌhoː
سوالن	sʋaːlˈʌn
سورهيه	sˌoːrhˈiːh
سوز	sˈoːz
سينگاريل	seːnɡˈaːrjal
سڌ	sˈʌdʰ
سڏائڻ	sˌəɖaːˈɪɳ
سڏيا	sˈʌɖjaː
سگهبو	sˌəɡəhəbˈoː
شاھراھ	ʃˌaːhrˈaːh
شخصيتون	ʃˈaxʂit̪ˌoːn
شده	ʃədˈʌh
شرعي	ʃərˈaːi
شماري	ʃəmˈaːri
شنڪر	ʃˌənəkˈʌr
شهدادپور	ʃˌəhədˌaːdpˈoːr
شهزادو	ʃˌəhəzˈaːdoː
شيرازي	ʃeːrˈaːzi
شيعا	ʃˈiːaː
شھرين	ʃˌəhrˈiːn
صوف	ʂˈoːf
ضرورتون	zˌaruːrt̪ˈoːn
عادل	aːdˈʌl
عبدالغفور	ˌabdˌaːləɣfˈoːr
عيسائيت	ˌaisaːˈiːt̪
غائب	ɣaːˈɪb
غدود	ɣədˈoːd
فريم	fərˈiːm
فل	fˈʌl
قبا	qəbˈaː
قبي	qəbˈiː
قسمت	qˌəsəmˈʌt̪
قلعن	qəlˈaːn
لاتعداد	lˌaːt̪aːdˈaːd
لاکو	lˈaːkʰoː
ليبر	leːbˈʌr
لکتن	lˌəkʰət̪ˈʌn
مادا	mˈaːdaː
مادن	maːdˈʌn
مارواڙ	maːrʋˈaːr.
مايوس	maːjˈoːs
ماڻيو	mˈaːɳjoː
ماڻڪ	maːɳˈʌk
متبادل	mˌət̪bˈaːdəl
متحد	mʊtˈahɪd
مجيب	məɟˈiːb
محراب	mˌəhrˈaːb
مردان	mərdˈaːn
مرضن	mˌərəzˈʌn
مستطيل	məst̪ˈʌtjal
مسند	məsˈʌnd
مشق	məʃˈʌq
مفصل	mˌəfəʂˈʌl
مفڪر	mˌəfəkˈʌr
ملايو	məlˈaːjoː
مملڪت	mˌəmələkˈʌt̪
مهاڀاري	mˌəhaːbʰˈaːri
ميرس	meːrˈʌs
ميزبان	mˌeːzbˈaːn
ميزباني	mˌeːzbˈaːni
ناتو	nˈaːt̪oː
نشي	nˈʌʃi
نمائنده	nˈʊmaːˈɪndəh
نمائندو	nˈʊmaːˈɪndoː
نيري	nˈeːri
هائي	hˈaːi
هموار	həmʋˈaːr
هوش	hˈoːʃ
هير	hˈeːr
واجب	ʋaːɟˈʌb
واهن	ʋaːhˈʌn
وجهندڙ	ʋˌəɟəhəndˈʌr.
وريل	ʋˈʌrjal
ورڇ	ʋərˈʌcʰ
ورڪس	ʋˌərəkˈʌs
وساري	ʋəsˈaːri
وسڻ	ʋəsˈʌɳ
وشنداس	ʋˌəʃndˈaːs
ويانا	ʋjˈaːnaː
ويلز	ʋeːlˈʌz
ويھ	ʋˈeːh
ٺاهين	ʈʰaːhˈiːn
ٺلهه	ʈʰˌələhˈʌh
ٻيڙو	bˈeːr.oː
ٽيوب	ʈjˈoːb
پئدا	pˈʌdaː
پاڙا	pˈaːr.aː
پنير	pənˈiːr
پنھنجن	pˌənhnəɟˈʌn
پهاڙي	pəhˈaːr.i
پورچوگيزي	pˌoːrcoːɡˈiːzi
پيارو	pjˈaːroː
پيشو	pˈeːʃoː
پٺاڻن	pˌəʈʰaːɳˈʌn
پڙهندا	pˌər.əhˈʌndaː
ڄميل	ɟˈʌmjal
چنڊن	cənɖˈʌn
چيلهه	cˌeːləhˈʌh
چٽ	cˈʌʈ
ڇانو	cʰˈaːnoː
ڇانوڻي	cʰaːnˈoːɳi
ڇني	cʰˈʌni
ڇڏيل	cʰˈʌɖjal
ڊچ	ɖˈʌc
ڏهر	ɖəhˈʌr
ڏينديون	ɖeːndjˈoːn
ڦاٽي	pʰˈaːʈi
ڦيري	pʰˈeːri
کنڀ	kʰənˈʌbʰ
کنگهه	kʰˌənɡəhˈʌh
ڪارنامن	kˌaːrnaːmˈʌn
ڪعبي	kaːbˈiː
ڪلا	kˈʌlaː
ڪمند	kəmˈʌnd
ڪوالالمپور	kʋˌaːlaːlmpˈoːr
ڪڪرن	kˌəkərˈʌn
گذاريا	ɡəzˈaːrjaː
گردي	ɡˈʌrdi
گريٽر	ɡˌəriʈˈʌr
گهريو	ɡəhˈʌrjoː
گهمڻ	ɡˌəhəmˈʌɳ
گهٽائي	ɡˌəhəʈˈaːi
گهٽجڻ	ɡˌəhəʈəɟˈʌɳ
گهٽين	ɡˌəhəʈˈiːn
گهڻين	ɡˌəhəɳˈiːn
گھڻيون	ɡʰəɳjˈoːn
ڳجهارت	ɡˌəɟhaːrˈʌt̪
ڳنڍي	ɡənˈʌɖʰi
ڳچي	ɡˈʌci
ھائوس	haːˈoːs
یا	jˈaː
آب	ˈaːb
آدرشي	ˌaːdərˈʌʃi
آرائين	ˌaːraːˈiːn
آرامي	aːrˈaːmi
آرٽسٽ	ˌaːrəʈəsˈʌʈ
آفيسون	ˌaːfisˈoːn
آڏواڻي	aːɖʋˈaːɳi
ائٽم	aʈˈʌm
اباڻو	abˈaːɳoː
ابدي	abˈʌdi
احتياط	ɛht̪jˈaːt
اداڪارن	ˌadaːkaːrˈʌn
اسٽيڊيم	ˌasʈiɖˈiːm
اقليتن	ˌaqlit̪ˈʌn
انبن	anbˈʌn
انجير	ˌanɟˈiːr
انھي	ˈanhi
اوڏ	ˈuːɖ
اوڻويھين	ˌuːɳʋihˈiːn
اٽو	ˈaʈoː
اڃ	ˈaɲ
باطني	bˈaːtnˌiː
باقراڻي	bˈaːqrˌaːɳi
بد	bˈʌd
برعڪس	bˌəraːkˈʌs
برگ	bərˈʌɡ
بزرگوار	bˈʊzʊɾɡʋˌaːr
بلڪي	bəlˈʌki
بنجڻ	bˌənəɟˈʌɳ
بندرگاھ	bˌəndərɡˈaːh
بيھڪ	bˈeːhək
بگ	bˈʌɡ
ترخانن	t̪ˌərxaːnˈʌn
تفريحي	t̪ˌəfrˈiːhi
تنظيمون	t̪ˌənʐimˈoːn
تيرهن	t̪ˌeːrəhˈʌn
تڪليفن	t̪ˌəklifˈʌn
تڪليفون	t̪ˌəklifˈoːn
جذبات	ɟˌəzəbˈaːt
جز	ɟˈʌz
جهليندو	ɟˌəhəlˈiːndoː
جهوڪ	ɟəhˈoːk
حقيقتون	hˌəqiqt̪ˈoːn
حوا	hʋˈaː
خضدار	xˌəzdˈaːr
خودمختياري	xˈʊdməxt̪jˌaːri
درهم	dˌərəhˈʌm
دستخط	dˌəst̪əxˈʌt
دلير	dəlˈiːr
دودو	dˈoːdoː
دولتمند	dˌoːlət̪əmˈʌnd
رسائي	rəsˈaːi
رني	rˈʌni
رنگي	rˈʌnɡi
روھڙي	roːhˈʌr.i
ريتن	reːt̪ˈʌn
رپين	rəpˈiːn
رکڻو	rəkʰˈʌɳoː
زوردار	zoːrdˈaːr
ساراهيو	saːrˈaːhjoː
سست	sˈʌst̪
سستي	sˈʌst̪i
سفارتڪار	sˌəfaːrˌət̪kˈaːr
سمنڊن	sˌəmənɖˈʌn
سنان	sənˈaːn
سنهيون	sˌənhjˈoːn
سهوليتون	sˌəhoːlit̪ˈoːn
سوراخن	sˌoːraːxˈʌn
سوڌو	sˈoːdʰoː
سيزر	seːzˈʌr
سڏڻ	səɖˈʌɳ
سڪندراعظم	sˌəkəndˌəraːaːʐˈʌm
سڪڻ	səkˈʌɳ
سگھون	səɡʰˈoːn
شاعره	ʃaːˈaːɪrh
شور	ʃˈoːr
شيراز	ʃeːrˈaːz
شگر	ʃəɡˈʌr
شھزادي	ʃˌəhzˈaːdi
صورتن	ʂˌoːrət̪ˈʌn
عبدالغفار	ˌabdˌaːləɣfˈaːr
عددي	adˈʌdi
علامہ	ˌalaːmˈʌh
عمودي	amˈoːdi
عھدو	ahˈʌdoː
فائرنگ	fˌaːɪrˈʌnɡ
فائيل	fˈaːjal
فرقو	fərˈʌqoː
فرنٽ	fˌərənˈʌʈ
فلاسافي	fˌəlaːsˈaːfi
قوتن	qoːt̪ˈʌn
لسو	lˈʌsoː
لنڪ	lənˈʌk
لنڪا	lənˈʌkaː
لهندو	ləhˈʌndoː
ليجسليٽو	lˌeːɟəslˈiːʈoː
ماسا	mˈaːsaː
محض	məhˈʌz
مرحلو	mˌərəhˈʌloː
مساوات	mˌəsaːoːˈaːt
مسڪين	mˌəskˈiːn
مشترڪه	mˌəʃt̪ərəkˈʌh
مصنوعي	mˌəʂnʋˈaːi
معاھدي	maːhˈʌdi
معدني	maːdˈʌni
مغرب	mˈaɣrˌɪb
موبائيل	moːbˈaːjal
مولچند	mˌoːləcˈʌnd
مينھن	mˈeːnhn
مھل	məhˈʌl
ناتا	nˈaːt̪aː
ناھن	naːhˈʌn
نباتاتي	nəbˈaːt̪aːt̪ˌiː
نرالي	nərˈaːli
نزلي	nəzˈʌli
نظرئي	naʐˈari
نوڪر	noːkˈʌr
هرڻ	hərˈʌɳ
هستي	hˈʌst̪i
هندوستاني	hˌɪnduːst̪ˈaːni
هوائون	hʋaːˈoːn
هينري	heːnˈʌri
هڏ	hˈʌɖ
والاري	ʋaːlˈaːri
واڱڻائي	ʋˌaːŋ̩ɳˈaːi
ويجھي	ʋeːɟˈʌhi
ويهندا	ʋeːhˈʌndaː
وٽن	ʋəʈˈʌn
ٻنهين	bˌənhˈiːn
ٻيڙا	bˈeːr.aː
ٽئي	ʈˈʌi
ٽڪيٽ	ʈəkˈiːʈ
پئسو	pˈʌsoː
پابنديون	pˌaːbndjˈoːn
پاڳاري	paːɡˈaːri
پرائيويٽ	pˌəraːjʋˈiːʈ
پرنس	pərˈʌns
پروجيڪٽ	pˌəroːɟikˈʌʈ
پرکڻ	pˌərəkʰˈʌɳ
پلاسٽڪ	pˌəlaːsəʈˈʌk
پولنگ	poːlˈʌnɡ
پڙهايو	pˌər.hˈaːjoː
پڙهندي	pˌər.əhˈʌndi
پکڙي	pəkʰˈʌr.i
پھچڻ	pˌəhəcˈʌɳ
ڀان	bʰˈaːn
ڀاڄين	bʰaːɟˈiːn
ڄم	ɟˈʌm
چوپائي	coːpˈaːi
چيس	cˈeːs
ڇاڙهه	cʰˌaːr.əhˈʌh
ڇند	cʰˈʌnd
ڇهون	cʰəhˈoːn
ڇپي	cʰˈʌpi
ڊبليو	ɖəbˈʌljoː
ڌا	dʰˈaː
ڌام	dʰˈaːm
ڌاڳي	dʰˈaːɡi
ڏسون	ɖɪsˈoːn
ڏيهه	ɖeːhˈʌh
ڦاٽ	pʰˈaːʈ
ڦيرڦار	pʰˌeːrpʰˈaːr
کر	kʰˈʌr
کهڙي	kʰəhˈʌr.i
کٽيو	kʰˈʌʈjoː
کٽڻ	kʰəʈˈʌɳ
کڻندا	kʰəɳˈʌndaː
ڪلر	kəlˈʌr
ڪوچ	kˈoːc
ڪينال	keːnˈaːl
گذرندو	ɡˌəzərˈʌndoː
گروپن	ɡˌəroːpˈʌn
گهرايو	ɡˌəhərˈaːjoː
گھرڙن	ɡʰˌərər.ˈʌn
گھوڙي	ɡʰˈoːr.i
ڳوڙهن	ɡˌoːr.əhˈʌn
ڳڻيو	ɡˈʌɳjoː
ھلائڻ	hˌəlaːˈɪɳ
ھيڊوجن	hˌeːɖoːɟˈʌn
آئل	aːˈɪl
آرڊر	ˌaːrəɖˈʌr
آرڪيالاجيڪل	ˌaːrkjˌaːlaːɟikˈʌl
آرگنائيزيشن	ˌaːrəɡnaːˌiːziʃˈʌn
آفيسن	ˌaːfisˈʌn
آور	aːˈoːr
آڏ	ˈaːɖ
اسٽيٽس	ˌasʈiʈˈʌs
اشارا	aʃˈaːraː
اقوام	aqʋˈaːm
امروهي	ˌamrˈoːhi
اموي	ˈamʋi
امڪاني	ˌamkˈaːni
انسپيڪٽر	ˌansəpˌiːkəʈˈʌr
اولهندي	ˌuːləhˈʌndi
اٿينز	ˌatʰinˈʌz
اڏاوتي	ˌaɖaːˈoːt̪i
اڳڀرو	ˌaɡəbʰˈʌroː
بانو	bˈaːnoː
بلڙي	bəlˈʌr.i
بندن	bəndˈʌn
بنگلو	bənɡˈʌloː
بيزار	bˈeːzaːr
بيٺي	bˈeːʈʰi
بکري	bəkʰˈʌri
تائيد	t̪aːˈiːd
تحريرون	t̪ˌəhrirˈoːn
تختگاهه	t̪ˌəxt̪əɡaːhˈʌh
تخيل	t̪ˈʌxjal
تراني	t̪ərˈaːni
تلڪ	t̪əlˈʌk
تپي	t̪ˈʌpi
جائداد	ɟˌaːɪdˈaːd
جمعيت	ɟˌəmaːˈiːt̪
جنازي	ɟənˈaːzi
جنڪشن	ɟˌənəkəʃˈʌn
جهيڙي	ɟəhˈiːr.i
جيري	ɟˈeːri
جٿي	ɟˈʌtʰi
داڻو	dˈaːɳoː
دهل	dəhˈʌl
ذرڙا	zərˈʌr.aː
ذميوار	zəmjʋˈaːr
ذوالحج	zʋˌaːləhˈʌɟ
رائل	raːˈɪl
رائيٽر	rˌaːiʈˈʌr
راه	rˈaːh
راولپنڊي	rˌaːoːləpˈʌnɖi
راھ	rˈaːh
رضيه	rəzˈiːh
رهائشي	rˌəhaːˈɪʃi
رهنما	rˌəhənˈʌmaː
روزو	rˈoːzoː
رومين	roːmˈiːn
ريا	rjˈaː
ريشم	reːʃˈʌm
سادات	sˌaːdˈaːt
ساراهه	sˌaːraːhˈʌh
سالڪ	saːlˈʌk
سبي	səbˈiː
ستلج	sˌət̪əlˈʌɟ
ستون	sət̪ˈoːn
ستي	sˈʌt̪i
سزائون	sˌəzaːˈoːn
سلامتي	sˌəlaːmˈʌt̪i
سمجھندا	sˌəməɟəhˈʌndaː
سنها	sənˈʌhaː
سنڀاليو	sˌənbʰˈaːljoː
سنگم	sənɡˈʌm
سوٽي	sˈoːʈi
سيال	sjˈaːl
شربت	ʃˌərəbˈʌt̪
شرڪ	ʃərˈʌk
شعرن	ʃaːrˈʌn
شھابا	ʃˌəhaːbˈaː
صابڻ	ʂaːbˈɪɳ
صدرمقام	ʂˌədərˌəmqˈaːm
طعام	tˈaːm
ظهور	ʐəhˈoːr
عبوري	abˈoːri
عضوا	ˈazʋaː
علی	ˈali
غزني	ɣəzˈʌni
فعال	fˈaːl
فهميده	fˌəhəmidˈʌh
فياض	fjˈaːz
فٽبال	fˌəʈbˈaːl
قاتل	qaːt̪ˈʌl
قاعدن	qˈaːjdn
قديمي	qədˈiːmi
لاهري	laːhˈʌri
لاڳت	laːɡˈʌt̪
لسٻيلي	lˌəsbˈiːli
لسٽ	ləsˈʌʈ
لوهي	lˈoːhi
لوھھ	loːhˈʌh
لپري	ləpˈʌri
مارڪو	maːrˈʌkoː
مجاهد	mˌəɟaːhˈʌd
محافظ	mˌəhaːfˈʌʐ
محتاج	mˌəht̪ˈaːɟ
محلو	məhˈʌloː
مسجدون	mˈasɟˌɪdoːn
معاوضو	maːˈoːzoː
معنوي	mˈaːnʋi
منارو	mənˈaːroː
مناسبت	mˌənaːsəbˈʌt̪
مهلب	mˌəhəlˈʌb
موتين	moːt̪ˈiːn
موريا	mˈoːrjaː
مولا	mˈoːlaː
ميرڪ	meːrˈʌk
ميهار	meːhˈaːr
مھينن	mˌəhinˈʌn
نائون	naːˈoːn
ناجائز	nˌaːɟaːˈɪz
نامه	naːmˈʌh
نرالو	nərˈaːloː
نسبتي	nˌəsəbˈʌt̪i
نعمت	naːmˈʌt̪
نيڪي	nˈeːki
نے	nˈʌeː
هاڪ	hˈaːk
هماليه	hˌəmaːlˈiːh
هنگامي	hənɡˈaːmi
هيڏانهن	hˌeːɖaːnəhˈʌn
هٽائي	həʈˈaːi
واشنگٽن	ʋˌaːʃənɡəʈˈʌn
واعدو	ʋaːˈaːdoː
وفادار	ʋˌəfaːdˈaːr
ويجها	ʋeːɟˈʌhaː
وڏ	ʋˈʌɖ
وڏيرو	ʋəɖˈiːroː
وڪي	ʋˈʌki
ياترا	jaːt̪ˈʌraː
ٺاھيل	ʈʰˈaːhjal
ٻوڙو	bˈoːr.oː
ٻٽي	bˈʌʈi
ٽائيٽل	ʈˌaːiʈˈʌl
ٽنگون	ʈənɡˈoːn
ٽيريٽري	ʈˌeːriʈˈʌri
ٽٽڻ	ʈəʈˈʌɳ
ٽڪريون	ʈˌəkrjˈoːn
پئسفڪ	pˌəsəfˈʌk
پاڻمرادو	pˌaːɳəmrˈaːdoː
پراڻيون	pˌəraːɳjˈoːn
پرن	pərˈʌn
پرهيز	pˌərhˈiːz
پرچا	pˈʌrcaː
پرڳڻن	pˌərəɡəɳˈʌn
پليجو	pəlˈiːɟoː
پوتر	poːt̪ˈʌr
پورهئي	pˌoːrəhˈʌi
پوکجي	poːkʰˈʌɟi
پيتي	pˈeːt̪i
پڙھڻ	pər.hˈʌɳ
ڀلا	bʰˈʌlaː
چئنل	cənˈʌl
چاليهن	cˌaːlihˈʌn
چري	cˈʌri
چندن	cəndˈʌn
چڪاس	cəkˈaːs
ڇاڻي	cʰˈaːɳi
ڇڏائي	cʰəɖˈaːi
ڊاڪٽرن	ɖˌaːkəʈərˈʌn
ڊاڪٽريٽ	ɖˌaːkəʈrˈiːʈ
ڊيوڊ	ɖjˈoːɖ
ڊگرين	ɖˌəɡrˈiːn
ڌوئي	dʰˈoːi
ڌڻ	dʰˈʌɳ
ڏندڻ	ɖəndˈʌɳ
ڦرين	pʰərˈiːn
ڦهليل	pʰəhˈʌljal
ڦوڪ	pʰˈoːk
کائينديون	kʰˌaːindjˈoːn
کاڌن	kʰaːdʰˈʌn
کنڊن	kʰənɖˈʌn
ڪال	kˈaːl
ڪلارڪ	kˌəlaːrˈʌk
ڪنيت	kənˈiːt̪
ڪول	kˈoːl
ڪولهي	koːlˈʌhi
ڪٽ	kˈʌʈ
ڪڍيا	kˈʌɖʰjaː
ڪھاڻيون	kˌəhaːɳjˈoːn
گذرندي	ɡˌəzərˈʌndi
گهاٽ	ɡəhˈaːʈ
گوريلا	ɡoːrˈiːlaː
گھٽجي	ɡʰəʈˈʌɟi
ڳايل	ɡˈaːjal
ھيٺيون	heːʈʰjˈoːn
آئرش	ˌaːɪrˈʌʃ
آئوٽرام	ˌaːoːʈrˈaːm
آسام	aːsˈaːm
آفندي	aːfˈʌndi
آفيم	aːfˈiːm
اجمير	ˌaɟmˈiːr
اخذ	axˈʌz
ارتقائي	ˌɪrtɪqˈaːi
ارڙھين	ˌarr.hˈiːn
اسٽاف	ˌasʈˈaːf
اسٽور	ˌasʈˈoːr
افسانن	ˌafsaːnˈʌn
امرڪوٽ	ˌamərkˈoːʈ
انتظاميا	ˌɪntɪʐˈaːmjaː
انتظاميه	ˌɪntɪʐaːmˈiːh
انگور	anɡˈoːr
اوطاق	uːtˈaːq
اونداهي	uːndˈaːhi
ايڊيٽوريل	ˌeːɖiʈˈoːrjal
اڱڻ	ˌaŋ̩ˈʌɳ
بابن	bˈaːbɪn
بجيٽ	bəɟˈiːʈ
بحالي	bəhˈaːli
بختيار	bəxt̪jˈaːr
بدلو	bədˈʌloː
بدوي	bˈʌdʋi
بيورو	bjˈoːroː
بيڪ	bˈeːk
ترار	t̪ərˈaːr
تندن	t̪əndˈʌn
ثقافتن	sˌəqaːfət̪ˈʌn
جاميٽري	ɟˌaːmiʈˈʌri
جست	ɟˈʌst̪
جنڊ	ɟˈʌnɖ
جوڙايو	ɟoːr.ˈaːjoː
جوڙيندا	ɟoːr.ˈiːndaː
جوڳا	ɟˈoːɡaː
جھنگ	ɟəhˈʌnɡ
حاوي	hˈaːʋi
حشو	hˈʌʃoː
حنفي	hənˈʌfi
خدائي	xədˈaːi
خصوصيتن	xˌəʂoːʂit̪ˈʌn
دهشت	dəhˈʌʃt̪
ديوبند	djoːbˈʌnd
رافيل	rˈaːfjal
رباني	rəbˈaːni
رديف	rədˈiːf
رشين	rəʃˈiːn
رلي	rˈʌli
رهاڻ	rəhˈaːɳ
رٽائرمينٽ	rˌəʈaːˌɪrminˈʌʈ
رٽائرڊ	rˌəʈaːɪrˈʌɖ
رکجن	rˌəkʰəɟˈʌn
سارنگ	saːrˈʌnɡ
ساڳين	saːɡˈiːn
سرو	sˈʌroː
سعد	sˈaːd
سماٽ	səmˈaːʈ
سنڌوندي	sɪndhˈuːndi
سواء	sʋˈaː
سوامي	sʋˈaːmi
سوداگر	sˌoːdaːɡˈʌr
سورهن	sˌoːrəhˈʌn
سورٺ	soːrˈʌʈʰ
سونهري	sˌoːnəhˈʌri
سوچيو	sˈoːcjoː
سيٽلائيٽ	sˌeːʈlaːˈiːʈ
سڏائيندا	sˌəɖaːˈiːndaː
شيرين	ʃeːrˈiːn
شيطان	ʃeːtˈaːn
شڪايت	ʃˌəkaːˈiːt̪
شڪلين	ʃˌəklˈiːn
صحرائي	ʂˌəhrˈaːi
ضعيف	zaːˈiːf
عبدالحڪيم	ˌabdˌaːləhkˈiːm
عدالتون	ˌadaːlt̪ˈoːn
عذاب	azˈaːb
عطر	atˈʌr
عيسي	aˈiːsi
فرمائي	fˌərmˈaːi
فلاحي	fəlˈaːhi
فڪشن	fˌəkəʃˈʌn
قائد	qaːˈɪd
قافلي	qaːfˈʌli
قسطنطنيه	qˈɪstnətnih
قوميت	qoːmˈiːt̪
لهرن	lˌəhərˈʌn
لٺ	lˈʌʈʰ
لڳايون	lˌəɡaːjˈoːn
مائڪرو	mˌaːɪkˈʌroː
مارواڙي	maːrʋˈaːr.i
مالهي	maːlˈʌhi
مذھبن	mˌəzəhəbˈʌn
مزاح	mˈʌzaːh
مزاحيہ	mˌəzaːhˈiːh
مزي	mˈʌzi
مشاھدو	mˌəʃaːhˈʌdoː
مصيبت	mˌəʂibˈʌt̪
معتقد	mˌaːt̪əqˈʌd
معدنيات	mˌaːdniˈaːt
مفاصلو	mˌəfaːʂˈʌloː
مقبرن	mˌəqəbərˈʌn
منتقلي	mˌənət̪əqˈʌli
منزلن	mˈanzˌɪln
مٿاهون	mˌətʰaːhˈoːn
مھينا	məhˈiːnaː
نظامي	nɪʐˈaːmi
نعت	nˈaːt̪
نقد	nəqˈʌd
نقصانڪار	nˌəqʂˌaːnkˈaːr
نوبيل	noːbjˈal
نياپو	njˈaːpoː
نيپچون	nˌeːpcˈoːn
هفتن	hˌəfət̪ˈʌn
هوتچند	hˌoːt̪əcˈʌnd
وغيرھ	ʋˌəɣirˈʌh
ويجهڙائي	ʋˌeːɟəhər.ˈaːi
ويڙهيل	ʋeːr.ˈʌhjal
ويڪري	ʋeːkˈʌri
ويھين	ʋeːhˈiːn
وڃو	ʋˈʌɲoː
يڪ	jˈʌk
ٺوس	ʈʰˈoːs
ٻاراڻو	baːrˈaːɳoː
ٻڌائڻ	bˌədʰaːˈɪɳ
ٻڌندڙ	bˌədʰəndˈʌr.
ٽائيٽن	ʈˌaːiʈˈʌn
ٽائٽانڪ	ʈˌaːʈaːnˈʌk
پئسن	pəsˈʌn
پائلٽ	pˌaːɪlˈʌʈ
پائيندا	paːˈiːndaː
پائيپ	paːˈiːp
پاتا	pˈaːt̪aː
پارو	pˈaːroː
پاپ	pˈaːp
پاڻياٺ	paːɳjˈaːʈʰ
پرواهه	pˌərʋaːhˈʌh
پليجي	pəlˈiːɟi
پيلو	pˈeːloː
پٽالا	pəʈˈaːlaː
پٽاندر	pˌəʈaːndˈʌr
پچي	pˈʌci
پکڙجڻ	pˌəkʰər.əɟˈʌɳ
ٿيڻو	tʰˈeːɳoː
ڀانئجي	bʰaːnˈʌɟi
ڀيل	bʰˈeːl
چانور	caːnˈoːr
چشمو	cəʃˈʌmoː
چيئر	ceːˈɪr
چيائون	cjaːˈoːn
چيڪ	cˈeːk
چيڪي	cˈeːki
ڇاتين	cʰaːt̪ˈiːn
ڇلي	cʰˈʌli
ڇپايل	cʰəpˈaːjal
ڊارون	ɖaːrˈoːn
ڊرامه	ɖˌəraːmˈʌh
ڊهي	ɖˈʌhi
ڊين	ɖˈeːn
ڍوري	ɖʰˈoːri
ڏاڪڻ	ɖaːkˈʌɳ
ڏسندو	ɖɪsˈʌndoː
ڏهاڙي	ɖəhˈaːr.i
ڏهاڪن	ɖˌəhaːkˈʌn
ڏيا	ɖjˈaː
ڏيڏر	ɖeːɖˈʌr
ڏيکارين	ɖˌeːkʰaːrˈiːn
ڏکن	ɖəkʰˈʌn
ڏھن	ɖəhˈʌn
ڦاٽڻ	pʰaːʈˈʌɳ
ڦٽا	pʰˈʌʈaː
کارو	kʰˈaːroː
کنڊر	kʰənɖˈʌr
کوجنائن	kʰˌoːɟnaːˈɪn
کوھ	kʰˈoːh
ڪارآمد	kˌaːraːmˈʌd
ڪافر	kaːfˈʌr
ڪرت	kərˈʌt̪
ڪروموسوم	kˌəroːmoːsˈoːm
ڪرڙ	kərˈʌr.
ڪميون	kəmjˈoːn
ڪوئلي	koːˈɪli
ڪوري	kˈoːri
ڪوڙ	kˈoːr.
ڪک	kˈʌkʰ
ڪڪر	kəkˈʌr
گردن	ɡərdˈʌn
گرمين	ɡˌərmˈiːn
گناهه	ɡˌənaːhˈʌh
گنڌار	ɡəndʰˈaːr
آئوٽ	aːˈoːʈ
آجيان	aːɟjˈaːn
آرڪائيوز	ˌaːrkaːjˈoːz
آزمائش	ˌaːzmaːˈɪʃ
آلو	ˈaːloː
آپريٽنگ	ˌaːpriʈˈʌnɡ
آکاڻيون	ˌaːkʰaːɳjˈoːn
آکيرا	aːkʰˈiːraː
آڻيندو	aːɳˈiːndoː
ا	ˈalɪf
اثرائتي	ˌasraːˈɪt̪i
اداڪاره	ˌadaːkaːrˈʌh
استثنا	ˌɪstˈasnaː
اسپيڪر	ˌaspikˈʌr
اسڪائوٽ	ˌaskaːˈoːʈ
اسڪالر	ˌaskaːlˈʌr
اشاعتي	ˌaʃaːˈaːt̪i
اشوڪ	aʃˈoːk
امتيازي	ˌamt̪jˈaːzi
انگلستان	ˌanɡəlˈɪstaːn
اوني	ˈuːni
ايوانن	ˌeːʋaːnˈʌn
اٿم	aʈˈʌm
اڪرام	ˌakrˈaːm
اڳڀرائي	ˌaɡəbʰrˈaːi
اھڙين	ˌahr.ˈiːn
بدوش	bədˈoːʃ
برانچ	bərˈaːnc
براهوئي	bˌəraːhˈoːi
بري	bˈʌri
برٽن	bˌərəʈˈʌn
بلاڪ	bəlˈaːk
بلڊنگ	bˌələɖˈʌnɡ
بوائز	bʋˈaːɪz
بورڊنگ	bˈoːrəɖˌənɡ
بياض	bjˈaːz
بيلٽ	bˈeːləʈ
بيهڻ	bˈeːhəɳ
تحريرن	t̪ˌəhrirˈʌn
تحفو	t̪əhˈʌfoː
تحفي	t̪əhˈʌfi
تختو	t̪ˈʌxt̪oː
تعبير	t̪aːbˈiːr
تعصب	t̪aːʂˈʌb
تپ	t̪ˈʌp
تھن	t̪əhˈʌn
ججهي	ɟəɟˈʌhi
جستجو	ɟəst̪ˈʌɟoː
جمعو	ɟəmˈaːoː
جمن	ɟəmˈʌn
جمھوري	ɟˌəmhˈuːri
جنگجو	ɟənɡˈʌɟoː
حرارت	hˌəraːrˈʌt̪
حصول	həʂˈoːl
حلقو	həlˈʌqoː
حيواني	hjʋˈaːni
خليفا	xəlˈiːfaː
خودڪشي	xˈʊdkəʃˌiː
دانشورن	dˌaːnʃoːrˈʌn
دس	dˈʌs
دونهون	dˌoːnhˈoːn
دوهن	doːhˈʌn
ذرن	zərˈʌn
ذريعا	zərˈiːaː
رجسٽرڊ	rˌəɟəsˌəʈərˈʌɖ
رحلت	rˌəhəlˈʌt̪
رزميه	rˌəzmˈiːh
رسد	rəsˈʌd
رهبر	rˌəhəbˈʌr
روان	rʋˈaːn
رول	rˈoːl
ريڻ	rˈeːɳ
رڌل	rədʰˈʌl
رھجي	rəhˈʌɟi
سافٽويئر	sˌaːfʈʋiˈɪr
سحر	səhˈʌr
سرخ	sˈʊrx
سرٽيفڪيٽ	sˌərʈˌiːfkˈiːʈ
سرپرستي	sˌərəpərˈʌst̪i
سمجهجي	sˌəməɟəhˈʌɟi
سمجهيا	sˌəməɟˈʌhjaː
سنجر	sˌənəɟˈʌr
سهراب	sˌəhərˈaːb
سوڀو	sˈoːbʰoː
سيراب	seːrˈaːb
سيڪشن	sˌeːkəʃˈʌn
سڌاري	sədʰˈaːri
سڌارڻ	sˌədʰaːrˈʌɳ
سڌوسنئون	sˌədʰoːsˌənˈoːn
شر	ʃˈʌr
شرطن	ʃˌərətˈʌn
شعبا	ʃˈɔbaː
شوال	ʃʋˈaːl
صحتمند	ʂˌəhət̪əmˈʌnd
صحيحون	ʂˌəhihˈoːn
صدرالدين	ʂˌədrˌaːldˈiːn
صفوي	ʂˈʌfʋi
عامر	aːmˈʌr
عبدالنبي	ˌabdˌaːlnbˈiː
علاؤ	alˈaːa͡ʊ
عيش	aˈiːʃ
غلبو	ɣˌəlbˈoː
ـ	lˈetəcʰˈahacˈaːrbˈʊr.i
فائر	faːˈɪr
فرعون	fˌəraːˈoːn
فرقا	fərˈʌqaː
فهم	fəhˈʌm
قاعدو	qˈaːjdoː
قدمن	qˌədəmˈʌn
قلمن	qˌələmˈʌn
لاکي	lˈaːkʰi
لاڳاپي	laːɡˈaːpi
لٿي	lˈʌtʰi
لکنؤ	lˌəkʰənˈʌa͡ʊ
ماتر	maːt̪ˈʌr
ماسڪو	maːsˈʌkoː
ماهه	maːhˈʌh
ماٺ	mˈaːʈʰ
ماڇي	mˈaːcʰi
مخلوط	mˌəxlˈuːt
مدفون	mˌədfˈuːn
مدنظر	mˌədənəʐˈʌr
مدني	mədˈʌni
مذمت	mˌəzəmˈʌt̪
مرتبي	mˌərət̪bˈiː
مرثيا	mərˈʌsjaː
مرمر	mˌərəmˈʌr
مصطفي	mˌəʂətˈʌfi
معاهدو	maːhˈʌdoː
منجھ	mˌənəɟˈʌh
منفي	mənˈʌfi
مهرباني	mˌəhərbˈaːni
موئن	moːˈɪn
موڪليائين	mˌoːkljaːˈiːn
مينار	meːnˈaːr
مٿاڇرو	mˌətʰaːcʰˈʌroː
مڃين	məɲˈiːn
مڃيندا	məɲˈiːndaː
مڌم	mədʰˈʌm
ناني	nˈaːni
ناڪاري	naːkˈaːri
نبوت	nəbˈoːt̪
نسخي	nəsˈʌxi
نشريات	nˌəʃriˈaːt
نوشي	nˈoːʃi
نيٽورڪ	nˌeːʈoːrˈʌk
نڪرنديون	nɪkrndjˈoːn
هوائن	hʋaːˈɪn
هيڊڪوارٽر	hˌeːɖkʋˌaːrəʈˈʌr
هڏا	hˈʌɖaː
هڙاپا	hər.ˈaːpaː
هڪجهڙا	hˌəkəɟəhˈʌr.aː
هڻندو	həɳˈʌndoː
وارد	ʋˈaːrd
واسين	ʋaːsˈiːn
واڌو	ʋˈaːdʰoː
وصال	ʋəʂˈaːl
ونسي	ʋˈʌnsi
ويلفيئر	ʋˌeːlfiˈɪr
وڃجي	ʋəɲˈʌɟi
وچون	ʋəcˈoːn
وچڙ	ʋəcˈʌr.
وڇائي	ʋəcʰˈaːi
وڇوڙي	ʋəcʰˈoːr.i
وڪڻڻ	ʋˌəkəɳˈʌɳ
يارنهن	jˌaːrənəhˈʌn
يارڪ	jaːrˈʌk
ٺاهيندو	ʈʰaːhˈiːndoː
ٺاھ	ʈʰˈaːh
ٻڌائين	bˌədʰaːˈiːn
ٻڌائيندو	bˌədʰaːˈiːndoː
ٻڌايل	bədʰˈaːjal
ٻڌمت	bˌədʰəmˈʌt̪
ٻڍل	bəɖʰˈʌl
ٽلٽي	ʈəlˈʌʈi
ٽنگ	ʈˈʌnɡ
ٽوٽل	ʈoːʈˈʌl
ٽيڪسٽ	ʈˌeːkəsˈʌʈ
پارسين	pˌaːrsˈiːn
پانڊون	paːnɖˈoːn
پرايو	pərˈaːjoː
پرفارم	pˌərfaːrˈʌm
پرمانند	pˌərmaːnˈʌnd
پريان	pərjˈaːn
پسندي	pəsˈʌndi
پنھنجون	pˌənhnəɟˈoːn
پورهيو	poːrˈʌhjoː
پوني	pˈoːni
پوڙهي	poːr.ˈʌhi
پڃري	pəɲˈʌri
پچائڻ	pˌəcaːˈɪɳ
پڙهائيندو	pˌər.haːˈiːndoː
ٿاڻو	tʰˈaːɳoː
ڀاتين	bʰaːt̪ˈiːn
ڀيٽا	bʰˈeːʈaː
ڀڳتي	bʰəɡˈʌt̪i
چارو	cˈaːroː
چاھ	cˈaːh
ڇوڪر	cʰoːkˈʌr
ڇھن	cʰəhˈʌn
ڊويزنن	ɖʋˌeːzənˈʌn
ڊگهائي	ɖˌəɡhˈaːi
ڊگھيون	ɖəɡʰjˈoːn
ڍير	ɖʰˈeːr
ڏات	ɖˈaːt̪
ڏيارام	ɖjaːrˈaːm
ڏيکاريا	ɖeːkʰˈaːrjaː
ڦٽڻ	pʰəʈˈʌɳ
کاهي	kʰˈaːhi
کاڄ	kʰˈaːɟ
کجور	kʰəɟˈoːr
کوڙي	kʰˈoːr.i
کپن	kʰəpˈʌn
کڻائي	kʰəɳˈaːi
ڪئلينڊر	kˌəlinɖˈʌr
ڪالمن	kˌaːləmˈʌn
ڪانھي	kˈaːnhi
ڪرشنا	kˌərəʃˈʌnaː
ڪرپشن	kˌərəpəʃˈʌn
ڪشور	kəʃˈoːr
ڪفر	kəfˈʌr
ڪلامن	kˌəlaːmˈʌn
ڪلهي	kəlˈʌhi
ڪليات	kˌəliˈaːt
ڪليسا	kəlˈiːsaː
ڪلچرل	kˌələcərˈʌl
ڪندس	kəndˈʌs
ڪنوينشن	kˌənʋinəʃˈʌn
ڪنڊو	kˈʌnɖoː
ڪهڙا	kəhˈʌr.aː
ڪوثر	koːsˈʌr
ڪوڙو	kˈoːr.oː
ڪيڏانهن	kˌeːɖaːnəhˈʌn
ڪٿائن	kˌətʰaːˈɪn
گرامي	ɡərˈaːmi
گز	ɡˈʌz
گلوڪار	ɡˌəloːkˈaːr
گوهر	ɡoːhˈʌr
گيٽ	ɡˈeːʈ
گپ	ɡˈʌp
گچيري	ɡəcˈiːri
گھريلو	ɡʰərˈiːloː
ڳائيندا	ɡaːˈiːndaː
ڳالھيون	ɡˌaːlhjˈoːn
ھدايت	hˌədaːˈiːt̪
ھلڪو	həlˈʌkoː
ھيٺئين	hˌeːʈʰˈiːn
ہے	hˈʌeː
آروهي	aːrˈoːhi
آري	ˈaːri
آسا	ˈaːsaː
آلي	ˈaːli
آندائين	ˌaːndaːˈiːn
آنڊي	ˈaːnɖi
آيس	aːˈiːs
آگ	ˈaːɡ
آھيون	aːhjˈoːn
ابوالقاسم	abʋˈaːlqˌaːsəm
ادائگي	ˌadaːˈɪɡi
ادارت	ˌadaːrˈʌt̪
ارنيسٽ	ˌarnisˈʌʈ
اسٽيفن	ˌasʈifˈʌn
اسپتالن	ˌasəpt̪aːlˈʌn
اسڪولي	ˌaskˈoːli
اطلاعات	ˌatlaːˈaːt̪
الفابيٽ	ˌalfaːbˈiːʈ
الهداد	ˌaləhədˈaːd
انتخاب	ˌɪntɪxˈaːb
انفراديت	ˌanəfraːdˈiːt̪
انڊو	ˈɪnɖoː
انکان	ˌankʰˈaːn
اوائل	ˌuːaːˈɪl
اولڊ	uːlˈʌɖ
اوڀرندي	ˌuːbʰərˈʌndi
ايڊ	ˈeːɖ
ايڪسپريس	ˌeːkəsˌəprˈiːs
اٽڪ	aʈˈʌk
اھڙيون	ˌahr.jˈoːn
بااختيار	bˈaːaːxt̪jˌaːr
باقر	bˈaːqər
باليووڊ	bˈaːljʋoːɖ
باگو	bˈaːɡoː
بر	bˈʌr
برفت	bˌərəfˈʌt̪
بلاذري	bˌəlaːzˈʌri
بندرن	bˌəndərˈʌn
بياني	bjˈaːni
بيس	bˈeːs
بينگال	bˈeːnɡaːl
بيٺڪون	bˈeːʈʰkˌoːn
تبليغي	t̪ˌəblˈiːɣi
تحفته	t̪ˌəhəfət̪ˈʌh
تحقيقات	t̪ˌəhqˌiːqˈaːt
تعليمات	t̪ˌaːlimˈaːt
تفھيم	t̪ˌəfhˈiːm
تند	t̪ˈʌnd
تهن	t̪əhˈʌn
توجهه	t̪ˌoːɟəhˈʌh
جمالياتي	ɟˌəmaːljˈaːt̪i
جهڙين	ɟˌəhər.ˈiːn
جوڙيا	ɟˈoːr.jaː
جھڙن	ɟˌəhər.ˈʌn
حادثو	haːdˈʌsoː
حديثن	hˌədisˈʌn
حرم	hərˈʌm
حوض	hˈoːz
خاڪي	xˈaːki
خصوصي	xəʂˈoːʂi
خلجي	xəlˈʌɟi
داؤد	daːˈa͡ʊd
دال	dˈaːl
درين	dərˈiːn
ذھن	zəhˈʌn
رابرٽس	rˌaːbərəʈˈʌs
راحت	raːhˈʌt̪
رفيق	rəfˈiːq
رونما	roːnˈʌmaː
روڳ	rˈoːɡ
ريگستاني	rˌeːɡɪstˈaːni
زبير	zəbˈiːr
زحل	zəhˈʌl
زرداري	zərdˈaːri
سؤٽ	səˈa͡ʊʈ
سالڪن	sˌaːləkˈʌn
ساڪن	saːkˈʌn
سترهن	sˌət̪ərəhˈʌn
سرشار	sˌərʃˈaːr
سرڪي	sərˈʌki
سمهڻ	sˌəməhˈʌɳ
سميجن	sˌəmiɟˈʌn
سندر	səndˈʌr
سهي	sˈʌhi
سواد	sʋˈaːd
سوڀارو	soːbʰˈaːroː
سوڊان	soːɖˈaːn
سوڻ	sˈoːɳ
سينيٽر	sˌeːniʈˈʌr
سڀيئي	səbʰˈiːi
سڌارڪ	sˌədʰaːrˈʌk
سڪ	sˈʌk
شاهراهه	ʃˌaːhəraːhˈʌh
شجرو	ʃəɟˈʌroː
شپ	ʃˈʌp
شڪوه	ʃəkˈoːh
صحرا	ʂəhˈʌraː
صنفون	ʂˌənfˈuːn
ضياء	zjˈaː
طالبان	tˌaːlbˈaːn
طاهر	taːhˈʌr
طنز	tənˈʌz
عالي	ˈaːli
عبارت	abˈaːrət̪
عبدالحسين	ˌabdˌaːləhsˈiːn
عرساڻي	ˌarsˈaːɳi
عروضي	arˈoːzi
عضوو	ˈazʋoː
عمارتي	ˌamaːrˈʌt̪i
عهديدار	ˌahədidˈaːr
عھد	ahˈʌd
غياث	ɣjˈaːs
فراھم	fˌəraːhˈʌm
فصاحت	fˌəʂaːhˈʌt̪
فقہ	fəqˈʌh
فولاد	foːlˈaːd
فيڊرل	fˌeːɖərˈʌl
قانونساز	qˌaːnoːnsˈaːz
لائڻ	laːˈɪɳ
لاس	lˈaːs
لالچند	lˌaːləcˈʌnd
لاهوتي	laːhˈoːt̪i
لاڙن	laːr.ˈʌn
ليٽويا	lˈeːʈʋjaː
لڌيون	lədʰjˈoːn
مامي	mˈaːmi
مانجهند	mˌaːnəɟəhˈʌnd
ماپڻ	maːpˈʌɳ
مثبت	mˌəsəbˈʌt̪
محمدن	mˌəhəmədˈʌn
مخلص	mˌəxəlˈʌʂ
مردم	mərdˈʌm
مروان	mərʋˈaːn
مرچ	mˈʌrc
مزاحمتي	mˌəzaːhəmˈʌt̪i
مشڪن	mˌəʃəkˈʌn
معنائن	mˌaːnaːˈɪn
ملازمن	mˌəlaːzəmˈʌn
ملاوٽ	mˌəlaːˈoːʈ
ملهائيندا	mˌəlhaːˈiːndaː
منجهيل	mˌənəɟˈʌhjal
منطقي	mˌənətˈʌqi
منگول	mənɡˈuːl
مهرن	mˌəhərˈʌn
مهمانن	mˌəhəmaːnˈʌn
موڪليندا	mˌoːklˈiːndaː
ميوزم	mjoːzˈʌm
ميين	mjˈeːn
مٺ	mˈʌʈʰ
مٿيان	mətʰjˈaːn
مھيا	mˈʌhjaː
نئن	nˈʌn
ناٽڪن	nˌaːʈəkˈʌn
ناگپور	nˌaːɡpˈoːr
نجوم	nəɟˈoːm
نزديڪ	nˌəzdˈiːk
نمائندي	nˈʊmaːˈɪndi
نمونيا	nəmˈoːnjaː
نويسي	nʋˈeːsi
هاڪڙي	haːkˈʌr.i
هزاري	həzˈaːri
هلائيندو	hˌəlaːˈiːndoː
هنڌان	həndʰˈaːn
هيروئن	hˌeːroːˈɪn
هٽايو	həʈˈaːjoː
واسي	ʋˈaːsi
وراثت	ʋˌəraːsˈʌt̪
ورلي	ʋərˈʌli
ورھائجي	ʋˌərhaːˈɪɟi
وفائي	ʋəfˈaːi
وهنوار	ʋˌəhənʋˈaːr
ووٽن	ʋoːʈˈʌn
ويجهه	ʋˌeːɟəhˈʌh
ويسر	ʋeːsˈʌr
ويڪرا	ʋeːkˈʌraː
وٺرائي	ʋˌəʈʰrˈaːi
وڪيلن	ʋˌəkilˈʌn
وھندڙ	ʋˌəhəndˈʌr.
يونيسڪو	jˌoːnisˈʌkoː
ٺارو	ʈʰˈaːroː
ٺاھيون	ʈʰaːhjˈoːn
ٻولهه	bˌoːləhˈʌh
ٻوڙن	boːr.ˈʌn
ٻھ	bˈʌh
ٽرين	ʈərˈiːn
ٽوپي	ʈˈoːpi
ٽيئي	ʈˈeːi
ٽيمن	ʈeːmˈʌn
ٽيمون	ʈeːmˈoːn
ٽپي	ʈˈʌpi
ٽڪنڊي	ʈəkˈʌnɖi
پاتل	paːt̪ˈʌl
پاتي	pˈaːt̪i
پال	pˈaːl
پالنا	paːlˈʌnaː
پاليسيون	pˌaːlisjˈoːn
پاڇو	pˈaːcʰoː
پذيرائي	pˌəzirˈaːi
پروسيسنگ	pˌəroːsisˈʌnɡ
پلان	pəlˈaːn
پناهگيرن	pˌənaːhˌəɡirˈʌn
پنجاھ	pˌənɟˈaːh
پنهنجيون	pʌ̃hnɟjˈoːn
پنڊ	pˈʌnɖ
پورچوگال	pˌoːrcoːɡˈaːl
پوش	pˈoːʃ
پوٽن	poːʈˈʌn
پيدائشي	pˌeːdaːˈɪʃi
پيري	pˈeːri
پيوتن	pjoːt̪ˈʌn
پھچائڻ	pˌəhcaːˈɪɳ
ٿانو	tʰˈaːnoː
ٿهيم	ʈəhˈiːm
ڀونگر	bʰoːnɡˈʌr
ڀينرن	bʰˌeːnərˈʌn
چاڳلا	caːɡˈʌlaː
چونڊيا	cˈoːnɖjaː
ڇانگ	cʰˈaːnɡ
ڇوڏا	cʰˈoːɖaː
ڇوڪرو	cʰoːkˈʌroː
ڇپائيندڙ	cʰˌəpaːindˈʌr.
ڇڏبو	cʰˌəɖbˈoː
ڊولپمينٽ	ɖˌoːləpminˈʌʈ
ڊيلٽا	ɖeːlˈʌʈaː
ڌوئڻ	dʰoːˈɪɳ
ڏار	ɖˈaːr
ڏير	ɖˈeːr
ڦرڙين	pʰˌərr.ˈiːn
ڦٽو	pʰˈʌʈoː
ڦڪي	pʰˈʌki
کاڌ	kʰˈaːdʰ
کاڌا	kʰˈaːdʰaː
کيڏڻ	kʰeːɖˈʌɳ
ڪاروائي	kaːrʋˈaːi
ڪارونجهر	kˌaːroːnˌəɟəhˈʌr
ڪافرن	kˌaːfərˈʌn
ڪاڇو	kˈaːcʰoː
ڪرائيندا	kˌəraːˈiːndaː
ڪرنٽ	kˌərənˈʌʈ
ڪشمڪش	kˌəʃəməkˈʌʃ
ڪمائڻ	kˌəmaːˈɪɳ
ڪميونزم	kˌəmjoːnəzˈʌm
ڪنڊياري	kənɖjˈaːri
ڪيرت	keːrˈʌt̪
ڪيمپ	kˈeːmp
ڪيڙن	keːr.ˈʌn
گذارو	ɡəzˈaːroː
گهراڻن	ɡˌəhəraːɳˈʌn
گورنرن	ɡˌoːrənərˈʌn
گيهه	ɡeːhˈʌh
گھاٽي	ɡʰˈaːʈi
گھوٽڪي	ɡʰoːʈˈʌki
ڳالهايون	ɡˌaːlhaːjˈoːn
ڳجھارت	ɡˌəɟhaːrˈʌt̪
ھلندي	həlˈʌndi
ھموار	həmʋˈaːr
ھميشه	hˌəmiʃˈʌh
ھميشہ	hˌəmiʃˈʌh
ھٿيارن	hˌətʰjaːrˈʌn
ھڏين	həɖˈiːn
آئن	aːˈɪn
آئيويٽا	aːjʋˈiːʈaː
آبدوز	ˌaːbdˈoːz
آفت	aːfˈʌt̪
آچار	aːcˈaːr
اتحادين	ˌat̪haːdˈiːn
اتهاس	ˌat̪hˈaːs
اسٽئنڊرڊ	ˌasəʈˌənɖərˈʌɖ
اسٽوڊيو	ˌasʈˈoːɖjoː
اسپيشل	ˌaspiʃˈʌl
اصلوڪي	ˌaʂlˈoːki
المقدس	ˌaləmˌəqədˈʌs
انفارميشن	ˌanfˌaːrmiʃˈʌn
انفيڪشن	ˌanfˌiːkəʃˈʌn
انوکو	anˈoːkʰoː
انڪشاف	ˌanəkʃˈaːf
اوپن	uːpˈʌn
اوڏانهن	ˌuːɖaːnəhˈʌn
ايشور	eːʃˈoːr
ايٽم	eːʈˈʌm
ايڊيوڪيشن	ˌeːɖjoːkiʃˈʌn
بارٽل	bˈaːrəʈˌəl
باس	bˈaːs
باهمي	bˈaːhəmˌiː
بجا	bˈʌɟaː
بدلائڻ	bˌədlaːˈɪɳ
برھمڻ	bˌərəhəmˈʌɳ
بيهن	bˈeːhən
بڻ	bˈʌɳ
تاجر	t̪aːɟˈʌr
تذڪرو	t̪ˌəzəkˈʌroː
ترتيبوار	t̪ˌərt̪ibʋˈaːr
تعظيم	t̪aːʐˈiːm
تقي	t̪ˈʌqi
تمغو	t̪əmˈʌɣoː
تندون	t̪əndˈuːn
تولد	t̪oːlˈʌd
تڪڙو	t̪əkˈʌr.oː
تڪڙي	t̪əkˈʌr.i
ج	ɟˈiːm
جامعه	ɟaːmˈaːh
جانچ	ɟˈaːnc
جاگيردارن	ɟˌaːɡirdaːrˈʌn
جس	ɟˈʌs
جملا	ɟˈʊmlaː
جنگن	ɟənɡˈʌn
جهونا	ɟəhˈoːnaː
جوائنٽ	ɟˈaʋaːˈɪnəʈ
جواني	ɟˈaʋaːnˌiː
جويو	ɟʋjˈoː
جوڙو	ɟˈoːr.oː
جيد	ɟˈeːd
جھلم	ɟˌəhəlˈʌm
حيوانن	hjʋaːnˈʌn
حڪمن	hˌəkəmˈʌn
خانقاهه	xˌaːnqaːhˈʌh
خدمتگار	xˌədəmˌət̪ɡˈaːr
خصوصيتون	xˌəʂoːʂit̪ˈoːn
خطبو	xˌətbˈoː
دارالعلوم	dˌaːraːlaːlˈoːm
داغن	daːɣˈʌn
درحقيقت	dˌərəhqiqˈʌt̪
دشمني	dˌəʃəmˈʌni
دلگير	dˌəlɡˈiːr
دٻائڻ	dˌəbaːˈɪɳ
ذخيرن	zˌəxirˈʌn
ذرڙن	zˌərər.ˈʌn
ذمي	zˈʌmi
ذميدار	zˌəmidˈaːr
راتين	raːt̪ˈiːn
رشتن	rəʃt̪ˈʌn
رشتو	rˈʌʃt̪oː
روزا	rˈoːzaː
رويي	rʋjˈeː
ريتون	reːt̪ˈoːn
ريڊيي	rˈeːɖji
زخم	zəxˈʌm
سادا	sˈaːdaː
سالم	saːlˈʌm
ساڃاهه	sˌaːɲaːhˈʌh
سجاد	səɟˈaːd
سرمايو	sˌərmˈaːjoː
سمٿ	səmˈʌʈ
سوئيڊن	sˌoːiɖˈʌn
سوکڙي	soːkʰˈʌr.i
سيٽن	seːʈˈʌn
سٺن	səʈʰˈʌn
سپرنٽينڊنٽ	sˌəpərˌənʈˌiːnɖənˈʌʈ
سڃاڻي	səɲˈaːɳi
سڊني	səɖˈʌni
سگھندي	səɡʰˈʌndi
شخصن	ʃˈaxʂn
صلاحيتون	ʂˌəlaːhit̪ˈoːn
صلعم	ʂəlˈaːm
صنعتون	ʂˌənaːt̪ˈoːn
طريقيڪار	tˌəriqikˈaːr
عبدالخالق	ˌabdˌaːlxaːlˈʌq
عبدالمطلب	ˌabdˌaːləmˌətəlˈʌb
عرفان	ˌarfˈaːn
علامتون	ˌalaːmt̪ˈoːn
عيال	ajˈaːl
غنيمت	ɣˌənimˈʌt̪
فائلم	fˌaːɪlˈʌm
فبروري	fˌəbrˈuːri
فلاسافر	fˌəlaːsaːfˈʌr
ق	qˈaːf
قبيلائي	qəbˈiːlaːˌiː
قسمين	qˌəsmˈiːn
قطارن	qˌətaːrˈʌn
لاڙا	lˈaːr.aː
لبرل	lˌəbərˈʌl
لتا	lˈʌt̪aː
لهرون	lˌəhərˈuːn
لڳنديون	lˌəɡndjˈoːn
لڳولڳ	lˌəɡoːlˈʌɡ
ماترائن	mˌaːt̪raːˈɪn
ماروي	mˈaːrʋi
متضاد	mˌət̪zˈaːd
محرڪ	mˌəhərˈʌk
مدرسا	mˌədərˈʌsaː
مصور	məʂˈoːr
مضبوطي	mˌəzbˈuːti
مطمئن	mˌətəmˈʌn
معاشرن	mˌaːʃərˈʌn
معيشيت	mˌaːiʃˈiːt̪
مقابلن	mˌəqaːbəlˈʌn
منجهانئس	mˌənəɟhaːnˈʌs
منهنجا	mˌənəhənˈʌɟaː
مورتي	moːrˈʌt̪i
موڪليل	moːkˈʌljal
ميراڻي	meːrˈaːɳi
مينهون	mˌeːnhˈoːn
ميونسپالٽي	mjˌoːnsəpaːlˈʌʈi
مٺاڻ	məʈʰˈaːɳ
مڙئي	mər.ˈʌi
مھر	məhˈʌr
نائو	nˈaːoː
نالين	naːlˈiːn
نان	nˈaːn
نبين	nəbˈiːn
نثار	nəsˈaːr
نديم	nədˈiːm
نذير	nəzˈiːr
نصر	nəʂˈʌr
نظارن	nˌəʐaːrˈʌn
ننڍڙيون	nˌənəɖʰr.jˈoːn
نورجهان	nˌoːrəɟhˈaːn
هائڊروجن	hˌaːɪɖroːɟˈʌn
هدايتون	hˌədaːit̪ˈoːn
هرچند	hərcˈʌnd
هرگز	hˌərəɡˈʌz
هول	hˈoːl
هيستائين	hˌeːst̪aːˈiːn
هڙتال	hˌər.t̪ˈaːl
والٽئر	ʋˌaːləʈˈʌr
واهي	ʋˈaːhi
وايومنڊل	ʋˌaːjoːmənɖˈʌl
وسندڙ	ʋˌəsəndˈʌr.
ونيونٽ	ʋˌənjoːnˈʌʈ
وچن	ʋəcˈʌn
وڌندا	ʋədʰˈʌndaː
وڌيون	ʋədʰjˈoːn
ياتري	jaːt̪ˈʌri
ٺري	ʈʰˈʌri
ٺهندا	ʈʰəhˈʌndaː
ٻارھين	bˌaːrhˈiːn
ٻاويهه	bˌaːʋihˈʌh
ٻرهل	bˌərəhˈʌl
ٻوليء	bˈoːli
ٻچو	bˈʌcoː
ٽائيلن	ʈˌaːilˈʌn
ٽوڙ	ʈˈoːr.
ٽيچر	ʈeːcˈʌr
پان	pˈaːn
پت	pˈʌt̪
پرواز	pərʋˈaːz
پريميئر	pˌərimiˈɪr
پرچي	pˈʌrci
پنو	pˈʌnoː
پهچندي	pˌəhəcˈʌndi
پورهيتن	pˌoːrhit̪ˈʌn
پيرزادي	pˌeːrzˈaːdi
پيروڪار	pˌeːroːkˈaːr
پيمائش	pˌeːmaːˈɪʃ
پيڇو	pˈeːcʰoː
پڄاڻي	pəɟˈaːɳi
پڇا	pˈʌcʰaː
پڙھي	pˈʌr.hi
ٿلھي	ʈəlˈʌhi
ٿورڙو	tʰoːrˈʌr.oː
ٿياسافيڪل	tʰjˌaːsaːfikˈʌl
ٿينس	tʰˈeːns
ڀاشا	bʰˈaːʃaː
ڄاڻن	ɟaːɳˈʌn
چئنلن	cˌənəlˈʌn
چارئي	caːrˈʌi
چانڊيا	cˈaːnɖjaː
چشمي	cəʃˈʌmi
چمپا	cˈʌmpaː
چمڪ	cəmˈʌk
چهري	cəhˈʌri
چوماسي	coːmˈaːsi
چونديون	coːndjˈoːn
چڙهائي	cˌər.hˈaːi
ڇڏائڻ	cʰˌəɖaːˈɪɳ
ڇڪ	cʰˈʌk
ڇڻي	cʰˈʌɳi
ڊجيٽل	ɖˌəɟiʈˈʌl
ڌوم	dʰˈoːm
ڍاڪا	ɖʰˈaːkaː
ڏاڍيون	ɖaːɖʰjˈoːn
ڏاڙهون	ɖˌaːr.hˈoːn
ڏاڪا	ɖˈaːkaː
ڏبو	ɖəbˈoː
ڏهون	ɖəhˈoːn
ڦھليل	pʰəhˈʌljal
ڪام	kˈaːm
ڪاٽن	kaːʈˈʌn
ڪاٿي	kˈaːtʰi
ڪرائجي	kˌəraːˈɪɟi
ڪويتا	kʋˈeːt̪aː
ڪوڙهه	kˌoːr.əhˈʌh
ڪيميا	kˈeːmjaː
ڪيمپس	keːmpˈʌs
ڪيپيٽل	kˌeːpiʈˈʌl
ڪپتان	kˌəpt̪ˈaːn
ڪپر	kəpˈʌr
ڪچهرين	kˌəcəhərˈiːn
گجر	ɡəɟˈʌr
گذرندڙ	ɡˌəzərəndˈʌr.
گريجوئيٽ	ɡˌəriɟoːˈiːʈ
گشت	ɡˈʌʃt̪
گهران	ɡˌəhərˈaːn
گهوڙو	ɡəhˈoːr.oː
گورک	ɡoːrˈʌkʰ
گپت	ɡəpˈʌt̪
گڏو	ɡˈʌɖoː
گھڻائي	ɡʰəɳˈaːi
ڳنڍيون	ɡˌənɖʰjˈoːn
ھائر	haːˈɪr
ھاري	hˈaːri
ھاڻوڪي	haːɳˈoːki
آبادڪاري	aːbˈaːdkˌaːri
آبھوا	aːbˈʌhʋaː
آقا	ˈaːqaː
آهيو	ˈaːhjoː
آيتن	ˌaːit̪ˈʌn
احاطي	ahˈaːti
اداره	ˌadaːrˈʌh
اسانجي	ˌasaːnˈʌɟi
استقبال	ˌɪstɪqbˈaːl
اسلامڪ	ˌɪslˈaːmk
اسڪاٽ	ˌaskˈaːʈ
اشاري	aʃˈaːri
الحرام	ˌaləhrˈaːm
الشان	ˌalʃˈaːn
الوجود	ˌaloːɟˈoːd
الوحيد	ˌaloːhˈiːd
الوداع	alˈoːdaː
اماڻيو	amˈaːɳjoː
امجد	ˌaməɟˈʌd
اولياء	ˈuːljaː
اونهو	uːnˈʌhoː
اوچتي	uːcˈʌt̪i
ايني	ˈeːni
ايپليڪيشن	ˌeːplˌiːkiʃˈʌn
اڀريو	abʰˈʌrjoː
اڄڪلھ	ˌaɟəkəlˈʌh
اڇلائي	ˌacʰlˈaːi
اڏام	aɖˈaːm
اڏامي	aɖˈaːmi
اڏيري	aɖˈiːri
اڪثريتي	ˌakəsrˈiːt̪i
اگهن	ˌaɡəhˈʌn
اڻويهين	ˌaɳʋihˈiːn
باد	bˈaːd
باغبان	bˈaːɣbˈaːn
بالٽڪ	bˈaːləʈˌək
بايزيد	bˈaːizˌiːd
باڪس	bˈaːkəs
بجي	bˈʌɟi
برهما	bˌərəhˈʌmaː
بروھي	bərˈoːhi
بلور	bəlˈoːr
بيجنگ	bˈeːɟənɡ
بيسنت	bˈeːsənˌət̪
بيڪس	bˈeːkəs
تاڪ	t̪ˈaːk
ترقياتي	t̪ˌərqjˈaːt̪i
تصويري	t̪əʂʋˈiːri
تلقين	t̪ˌəlqˈiːn
تناظر	t̪ˌənaːʐˈʌr
تڪرارن	t̪ˌəkraːrˈʌn
جاوا	ɟˈaːʋaː
جبري	ɟəbˈʌri
جميل	ɟˈʌmjal
جهونو	ɟəhˈoːnoː
جوابي	ɟˈaʋaːbˈiː
جينياتي	ɟeːnjˈaːt̪i
حامين	haːmˈiːn
حرام	hərˈaːm
حروف	hərˈoːf
حماد	həmˈaːd
حواس	hʋˈaːs
حياتيات	hjˌaːt̪iˈaːt
حيدري	heːdˈʌri
خانصاحب	xˌaːnʂaːhˈʌb
خانہ	xaːnˈʌh
خطا	xˈʌtaː
خميس	xəmˈiːs
خوان	xʋˈaːn
خيرو	xˈeːroː
داري	dˈaːri
دامن	daːmˈʌn
دانهون	dˌaːnhˈoːn
دراني	dərˈaːni
دراوڙن	dˌəraːoːr.ˈʌn
دري	dˈʌri
دعويدار	dˌaːʋidˈaːr
دورا	dˈoːraː
دڪانن	dˌəkaːnˈʌn
رازن	raːzˈʌn
راهو	rˈaːhoː
راين	raːˈiːn
راڳن	raːɡˈʌn
زبانون	zəbˈaːnoːn
زنجير	zˌənɟˈiːr
زڪريا	zəkˈʌrjaː
سادن	saːdˈʌn
سادگي	saːdˈʌɡi
سارين	saːrˈiːn
سازن	saːzˈʌn
ساموئي	saːmˈoːi
سانت	saːnˈʌt̪
سانگھڙ	saːnɡʰˈʌr.
ساڳ	sˈaːɡ
سبز	səbˈʌz
ستاره	sɪtˈaːrh
سفارتڪاري	sˌəfaːrˌət̪kˈaːri
سلسلا	sˈɪlsˌɪlaː
سمجھن	sˌəməɟəhˈʌn
سنگهار	sˌənɡəhˈaːr
سهارو	səhˈaːroː
سهڪاري	sˌəhəkˈaːri
سوئر	soːˈɪr
سوم	sˈoːm
سونھن	sˈoːnhn
سيلون	seːlˈoːn
سينيما	seːnˈiːmaː
سيڙپ	seːr.ˈʌp
سيڪيورٽي	sˌeːkjoːrˈʌʈi
سٿ	sˈʌʈ
سڃاتي	səɲˈaːt̪i
سڃاڻڻ	sˌəɲaːɳˈʌɳ
سڌا	sˈʌdʰaː
سگهڻ	sˌəɡəhˈʌɳ
سگھندا	səɡʰˈʌndaː
شامي	ʃˈaːmi
شاهاڻي	ʃaːhˈaːɳi
شبير	ʃəbˈiːr
شل	ʃˈʌl
شمر	ʃəmˈʌr
شيء	ʃˈeː
شھريت	ʃˌəhrˈiːt̪
صفراوي	ʂˌəfrˈaːʋi
طبعزاد	təbˈaːzaːd
عابد	aːbˈʌd
عراقي	arˈaːqi
علاوہ	ˌalaːˈoːh
غزنوي	ɣəzˈʌnʋi
فقري	fəqˈʌri
فيئر	feːˈɪr
فيشن	feːʃˈʌn
فيصد	feːʂˈʌd
فيضياب	feːzjˈaːb
قادن	qaːdˈʌn
قاعدي	qˈaːjdi
قافلا	qaːfˈʌlaː
قافيه	qaːfˈiːh
قوتون	qoːt̪ˈoːn
لنڊ	lˈʌnɖ
لهه	ləhˈʌh
لکپڙهه	lˌəkʰəpˌər.əhˈʌh
لڪائي	ləkˈaːi
لڳايل	ləɡˈaːjal
ماليڪيول	mˌaːlikjˈoːl
مامو	mˈaːmoː
مايا	mˈaːjaː
ماڻيائين	mˌaːɳjaːˈiːn
مثالن	mˌəsaːlˈʌn
مثل	məsˈʌl
مجازي	məɟˈaːzi
مجددي	mˌəɟədˈʌdi
مريم	mərˈiːm
مرچن	mərcˈʌn
مشينون	mˌəʃinˈoːn
مشڪون	mˌəʃkˈuːn
مشھوري	mˌəʃhˈuːri
مصالحو	mˌəʂaːlˈʌhoː
مصرعون	mˌəʂraːˈoːn
مصلحت	mˌəʂələhˈʌt̪
مطابقت	mˌətaːbəqˈʌt̪
مغليه	mˌəɣlˈiːh
ملاقاتون	mˌəlaːqaːt̪ˈoːn
ملاکڙو	mˌəlaːkʰˈʌr.oː
ملتاني	mˌəlt̪ˈaːni
مليريا	məlˈiːrjaː
منتظم	mˌənət̪əʐˈʌm
مهربان	mˌəhərbˈaːn
موٽواڻي	moːʈʋˈaːɳi
ميرصاحب	mˌeːrʂaːhˈʌb
مٺائي	məʈʰˈaːi
مٿاهين	mˌətʰaːhˈiːn
مٿاھين	mˌətʰaːhˈiːn
نائٽروجن	nˌaːʈroːɟˈʌn
نامعلوم	nˌaːmaːlˈoːm
نامياتي	naːmjˈaːt̪i
نمبرن	nˌəmbərˈʌn
نندو	nˈʌndoː
نوي	nʋˈeː
نوڪدار	nˌoːkdˈaːr
نياڻيون	njaːɳjˈoːn
هارڊ	haːrˈʌɖ
هاشمي	haːʃˈʌmi
هاضمي	haːzˈʌmi
هيڊي	hˈeːɖi
هڏي	hˈʌɖi
وارثن	ʋˌaːrəsˈʌn
واسطيدار	ʋˌaːstidˈaːr
واپڊا	ʋaːpˈʌɖaː
وحداني	ʋˌəhdˈaːni
وسائي	ʋəsˈaːi
وعدو	ʋˈaːdoː
ووٽر	ʋoːʈˈʌr
ويتر	ʋeːt̪ˈʌr
ويهاري	ʋeːhˈaːri
وڃائڻ	ʋˌəɲaːˈɪɳ
وڙهندو	ʋˌər.əhˈʌndoː
وڳي	ʋˈʌɡi
وھن	ʋəhˈʌn
يوگنڊا	joːɡˈʌnɖaː
ٺاھيندا	ʈʰaːhˈiːndaː
ٻاهريون	bˌaːhərjˈoːn
ٻڌايا	bədʰˈaːjaː
ٻڌجي	bədʰˈʌɟi
ٻڌن	bədʰˈʌn
ٽماهي	ʈəmˈaːhi
ٽينس	ʈˈeːns
ٽٽل	ʈəʈˈʌl
ٽڪ	ʈˈʌk
پئرس	pərˈʌs
پائوڊر	pˌaːoːɖˈʌr
پائينديون	pˌaːindjˈoːn
پراسرار	pˌəraːsrˈaːr
پرامن	pˌəraːmˈʌn
پرسرام	pˌərəsrˈaːm
پرڻو	pərˈʌɳoː
پهاڙ	pəhˈaːr.
پهاڪا	pəhˈaːkaː
پهر	pəhˈʌr
پورائي	poːrˈaːi
پيالو	pjˈaːloː
پيسا	pˈeːsaː
پيشڪش	pˌeːʃəkˈʌʃ
پينٽنگ	pˌeːnəʈˈʌnɡ
پٿري	pəʈˈʌri
پڙهيائين	pˌər.hjaːˈiːn
پڪين	pəkˈiːn
پڪيون	pəkjˈoːn
پڪڙڻ	pˌəkər.ˈʌɳ
پڳدار	pˌəɡdˈaːr
پڻي	pˈʌɳi
ڀنگ	bʰˈʌnɡ
ڀوپال	bʰoːpˈaːl
چال	cˈaːl
چالاڪ	caːlˈaːk
چاڙھي	cˈaːr.hi
چوٽيون	coːʈjˈoːn
چوڏهين	cˌoːɖhˈiːn
چوڏھين	cˌoːɖhˈiːn
چيٽ	cˈeːʈ
چٽا	cˈʌʈaː
چٽيل	cˈʌʈjal
ڇوٽڪارو	cʰˌoːʈkˈaːroː
ڇيڙن	cʰeːr.ˈʌn
ڇھون	cʰəhˈoːn
ڊانس	ɖˈaːns
ڊوائيسز	ɖʋˌaːisˈʌz
ڊوڙي	ɖˈoːr.i
ڊپلوما	ɖˌəplˈuːmaː
ڊگھائي	ɖəɡʰˈaːi
ڌاڙيل	dʰˈaːr.jal
ڌريون	dʰərjˈoːn
ڏاڏن	ɖaːɖˈʌn
ڏيڻي	ɖˈeːɳi
کارائيندا	kʰˌaːraːˈiːndaː
کنيل	kʰˈʌnjal
کوهن	kʰoːhˈʌn
کوکر	kʰoːkʰˈʌr
کٻڙ	kʰəbˈʌr.
کٽو	kʰˈʌʈoː
ڪ	kˈaːf
ڪئلشم	kˌələʃˈʌm
ڪاؤنسلون	kˌaːa͡ʊnsəlˈoːn
ڪاليجن	kˌaːliɟˈʌn
ڪامپليڪس	kˌaːmpəlikˈʌs
ڪاٿو	kˈaːtʰoː
ڪشميري	kˌəʃmˈiːri
ڪمپوز	kəmpˈuːz
ڪيمبرج	kˌeːmbərˈʌɟ
ڪينئان	kˌeːnˈaːn
ڪٺا	kˈʌʈʰaː
ڪپور	kəpˈoːr
گئسن	ɡəsˈʌn
گاري	ɡˈaːri
گال	ɡˈaːl
گذرن	ɡˌəzərˈʌn
گرانٽ	ɡˌəraːnˈʌʈ
گرجا	ɡərˈʌɟaː
گلزار	ɡˌəlzˈaːr
گهرواري	ɡˌəhərʋˈaːri
گهمي	ɡəhˈʌmi
گهڙيل	ɡəhˈʌr.jal
گورنمنٽ	ɡˌoːrənˌəmənˈʌʈ
گولائي	ɡoːlˈaːi
گير	ɡˈeːr
گڏجاڻين	ɡˌəɖɟaːɳˈiːn
ڳائينديون	ɡˌaːindjˈoːn
ڳالھين	ɡˌaːlhˈiːn
ڳاڙهن	ɡˌaːr.əhˈʌn
ڳڀ	ɡˈʌbʰ
ھاشم	haːʃˈʌm
ھجري	həɟˈʌri
ھلندو	həlˈʌndoː
ھندستاني	hˌəndəɪstˈaːni
ھيرو	hˈeːroː
ھيڊ	hˈeːɖ
ﺟﻲ	lˈetəˈefˈiːnˈaʋaˈeflˈetəˈefˈiːˈefbˈa
آئينو	aːˈiːnoː
آتما	aːt̪ˈʌmaː
آرامگاهه	ˌaːraːmɡaːhˈʌh
آسو	ˈaːsoː
آمر	aːmˈʌr
آمريت	ˌaːmrˈiːt̪
آکاڻين	ˌaːkʰaːɳˈiːn
آڪهه	ˌaːkəhˈʌh
آگاهي	aːɡˈaːhi
ابجد	ˌabəɟˈʌd
ابخازيه	ˌabxaːzˈiːh
ابوالڪلام	abʋˈaːləklaːm
اتحادي	ˌat̪hˈaːdi
اجمل	ˌaɟəmˈʌl
احڪام	ɛhkˈaːm
اخلاقيات	ˌaxlˌaːqiˈaːt
اربع	ˌarbˈaː
ارشد	ˌarəʃˈʌd
استوا	ˈast̪ʋaː
اسٽاپ	ˌasʈˈaːp
اسٽريٽ	ˌasəʈrˈiːʈ
اسپيس	ˌaspˈiːs
اسڪرين	ˌasəkrˈiːn
اصلوڪو	ˌaʂlˈoːkoː
اصليت	ˌaʂlˈiːt̪
افيڪٽ	ˌafikˈʌʈ
التحصيل	ˌalət̪əhˈʌʂjal
العابدين	ˌalaːbdˈiːn
العين	ˌalaːˈiːn
الفاظ	ˌalfˈaːʐ
امامت	ˌamaːmˈʌt̪
اميه	amˈiːh
انڊيز	ɪnɖˈiːz
اهن	ahˈʌn
اوسي	ˈuːsi
اونهي	uːnˈʌhi
اوڀارين	ˌuːbʰaːrˈiːn
ايتريون	ˌeːt̪rjˈoːn
ايريا	ˈeːrjaː
اٿڻ	aʈˈʌɳ
اڏيو	ˈaɖjoː
اڪليز	ˌaklˈiːz
اڳيون	aɡjˈoːn
بادي	bˈaːdi
باريڪ	bˈaːrik
بالڪل	bˈaːləkˌəl
بانين	bˈaːnin
بخارن	bˌəxaːrˈʌn
برائي	bərˈaːi
برادرين	bˌəraːdrˈiːn
برجن	bˌərəɟˈʌn
برطرف	bˌərətərˈʌf
بستري	bəst̪ˈʌri
بسم	bəsˈʌm
بلبن	bˌələbˈʌn
بيدار	bˈeːdaːr
بيروني	bˈeːroːnˌiː
بيٺڪ	bˈeːʈʰək
تبصرو	t̪ˌəbəʂˈʌroː
تعليمدان	t̪ˌaːlimdˈaːn
تعميرات	t̪ˌaːmirˈaːt
تلائن	t̪ˌəlaːˈɪn
تلور	t̪əlˈoːr
تهران	t̪ˌəhərˈaːn
جادوگر	ɟˌaːdoːɡˈʌr
جاچڻ	ɟaːcˈʌɳ
جبر	ɟəbˈʌr
جذباتي	ɟˌəzbˈaːt̪i
جلندڙ	ɟˌələndˈʌr.
جماعتون	ɟˌəmaːaːt̪ˈoːn
جماعتي	ɟˌəmaːˈaːt̪i
جنهنکي	ɟˌənəhənˈʌkʰi
جوئر	ɟoːˈɪr
جوڌپور	ɟˌoːdʰpˈoːr
جوڙائي	ɟoːr.ˈaːi
جڙيو	ɟˈʌr.joː
خال	xˈaːl
خانم	xaːnˈʌm
خانپور	xaːnpˈoːr
خبرن	xˌəbərˈʌn
خلطن	xˌələtˈʌn
خنجر	xˌənəɟˈʌr
خيام	xjˈaːm
داعي	daːˈaːi
دانش	daːnˈʌʃ
دربار	dˌərbˈaːr
دريائن	dˌərjaːˈɪn
دليلن	dˌəlilˈʌn
دهشتگرد	dˌəhəʃt̪əɡˈʌrd
دهلوي	dəhˈʌlʋi
دوها	dˈoːhaː
دٻاء	dˈʌbaː
دٻي	dˈʌbi
دڳ	dˈʌɡ
دھشتگردي	dˌəhəʃt̪əɡˈʌrdi
ذخيري	zəxˈiːri
ذرو	zˈʌroː
راتيون	raːt̪jˈoːn
رانديگرن	rˌaːndiɡərˈʌn
رتي	rˈʌt̪i
روحانيت	rˌoːhaːnˈiːt̪
رياضت	rjaːzˈʌt̪
رپورٽر	rˌəpoːrəʈˈʌr
رڍن	rəɖʰˈʌn
رڍون	rəɖʰˈoːn
رھائشي	rˌəhaːˈɪʃi
زئي	zˈʌi
زمانن	zˌəmaːnˈʌn
سئي	sˈʌi
سابق	saːbˈɪq
سارا	sˈaːraː
سام	sˈaːm
ساهتي	saːhˈʌt̪i
سبزي	səbˈʌzi
سبڻ	səbˈʌɳ
سخن	səxˈʌn
سرجري	sˌərəɟˈʌri
سورنهن	sˌoːrənəhˈʌn
سونا	sˈoːnaː
سويڊن	sʋeːɖˈʌn
سيالڪوٽ	sjˌaːlkˈoːʈ
سينئر	seːnˈʌr
سينا	sˈeːnaː
سيکاريو	seːkʰˈaːrjoː
سيڪٽر	sˌeːkəʈˈʌr
سٽا	sˈʌʈaː
سڏائي	səɖˈaːi
سگهارو	sˌəɡhˈaːroː
سگهڙن	sˌəɡəhər.ˈʌn
سگھ	sˈʌɡʰ
سھڪار	sˌəhkˈaːr
سھڻي	səhˈʌɳi
شاهدي	ʃaːhˈʌdi
شفا	ʃˈʌfaː
شهيدن	ʃˌəhidˈʌn
صدمو	ʂədˈʌmoː
صغير	ʂəɣˈiːr
طرفين	tˌərfˈiːn
ظلمن	ʐˌələmˈʌn
عبدالحميد	ˌabdˌaːləhmˈiːd
عبدالطيف	ˌabdˌaːltˈiːf
عدل	adˈʌl
عشقيه	ˌaʃqˈiːh
علوم	alˈoːm
غسان	ɣəsˈaːn
غيرآباد	ɣˌeːraːbˈaːd
فاعل	faːˈaːl
فرار	fərˈaːr
فراق	fərˈaːq
فرحت	fˌərəhˈʌt̪
فرضي	fərˈʌzi
فوري	fˈoːri
فوٽو	fˈoːʈoː
فوڊ	fˈoːɖ
قطارون	qˌətaːrˈoːn
لائيف	laːˈiːf
لائيو	lˈaːjoː
لالا	lˈaːlaː
لالو	lˈaːloː
لوڪلبورڊ	lˌoːkəlbˈoːrəɖ
ليک	lˈeːkʰ
ليکجي	leːkʰˈʌɟi
لٿوينيا	lətʰʋˈiːnjaː
لڪشمي	lˌəkəʃˈʌmi
ماخذ	maːxˈʌz
مايو	mˈaːjoː
متي	mˈʌt̪i
مجرب	mˌəɟərˈʌb
مجنون	mˌəɟnˈuːn
مدائني	mˌədaːˈɪni
مداح	mˈʌdaːh
مدح	mˌədˈah
مزارن	mˌəzaːrˈʌn
مسدس	mˌəsədˈʌs
مسڪن	mˌəsəkˈʌn
مشاهدن	mˌəʃaːhədˈʌn
مصرعن	mˌəʂrˈaːn
مظاهرا	mˌəʐaːhˈʌraː
مغز	məɣˈʌz
مقابلا	mˌəqaːbˈʌlaː
مقالات	mˌəqaːlˈaːt
مقيم	məqˈiːm
ملھ	məlˈʌh
منسوخ	mənsˈuːx
منشور	mˌənʃˈuːr
منو	mˈʌnoː
منور	mənˈoːr
منگهارام	mˌənɡəhaːrˈaːm
منھنجي	mənhnˈʌɟi
مودي	mˈoːdi
مورتيون	mˌoːrt̪jˈoːn
مورخ	moːrˈʌx
مورخن	mˌoːrəxˈʌn
ميربحر	mˌeːrəbəhˈʌr
مٽيارين	mˌəʈjaːrˈiːn
مڌيه	mədʰˈiːh
ناقابل	nˌaːqaːbˈʌl
نال	nˈaːl
نلي	nˈʌli
نمڪين	nˌəmkˈiːn
نند	nˈʌnd
ننھن	nˈʌnhn
نوابشاھ	nˈaʋaːbʃaːh
نوابن	nˈaʋaːbˌən
نيت	nˈeːt̪
نيپيئر	nˌeːpiˈɪr
نڪتي	nəkˈʌt̪i
هلائيندا	hˌəlaːˈiːndaː
هلت	həlˈʌt̪
هوبهو	hoːbˈʌhoː
هيرانند	hˌeːraːnˈʌnd
هيڏي	hˈeːɖi
هڏن	həɖˈʌn
هڏين	həɖˈiːn
واقعات	ʋaːqˈaːt̪
واڻي	ʋˈaːɳi
وجهجي	ʋˌəɟəhˈʌɟi
ورسي	ʋərˈʌsi
وسنديون	ʋˌəsndjˈoːn
ويجهن	ʋˌeːɟəhˈʌn
ويلڻ	ʋeːlˈʌɳ
وٺو	ʋˈʌʈʰoː
وچولو	ʋəcˈoːloː
يارھن	jˌaːrəhˈʌn
يوروپا	joːrˈoːpaː
ٺهرايا	ʈʰˌəhərˈaːjaː
ٺيٺ	ʈʰˈeːʈʰ
ٺيڪي	ʈʰˈeːki
ٻرڙي	bərˈʌr.i
ٻولن	boːlˈʌn
ٻوڌي	bˈoːdʰi
ٽاري	ʈˈaːri
ٽرانسپورٽ	ʈˌəraːnsˌəpoːrˈʌʈ
ٽراپيڪل	ʈˌəraːpikˈʌl
ٽريفڪ	ʈˌərifˈʌk
ٽنڊوالهيار	ʈˌənɖʋaːlhjˈaːr
ٽه	ʈˈʌh
ٽو	ʈˈoː
ٽيڪنيڪل	ʈˌeːknikˈʌl
پئسي	pˈʌsi
پاليو	pˈaːljoː
پالڪ	paːlˈʌk
پاهڙ	paːhˈʌr.
پايون	paːjˈoːn
پاٺ	pˈaːʈʰ
پتا	pˈʌt̪aː
پختون	pəxt̪ˈuːn
پراڻين	pˌəraːɳˈiːn
پرچو	pˈʌrcoː
پناھ	pənˈaːh
پهلوئن	pˌəhəloːˈɪn
پهچندو	pˌəhəcˈʌndoː
پهڻ	pəhˈʌɳ
پورهيت	pˌoːrhˈiːt̪
پول	pˈoːl
پوٽر	poːʈˈʌr
پيٽر	peːʈˈʌr
پيچ	pˈeːc
پٽو	pˈʌʈoː
پڇڻ	pəcʰˈʌɳ
پڙھيو	pˈʌr.hjoː
پکيڙڻ	pˌəkʰir.ˈʌɳ
ٿورڙي	tʰoːrˈʌr.i
ٿولهه	tʰˌoːləhˈʌh
ڀاٽيا	bʰˈaːʈjaː
ڀرو	bʰˈʌroː
ڀروسو	bʰərˈoːsoː
ڀومي	bʰˈoːmi
ڀڳل	bʰəɡˈʌl
چانڊيي	cˈaːnɖji
چترال	cˌət̪rˈaːl
چراغ	cərˈaːɣ
چشما	cəʃˈʌmaː
چلم	cəlˈʌm
چنگيز	cənɡˈiːz
چهرو	cəhˈʌroː
چوويهه	cʋʋeːhˈʌh
چوڻيون	coːɳjˈoːn
چيئرپرسن	ceːˈɪrəpˌərəsˌən
ڇاپاڪي	cʰaːpˈaːki
ڇاڻ	cʰˈaːɳ
ڇتي	cʰˈʌt̪i
ڇڄي	cʰˈʌɟi
ڊنڊي	ɖˈʌnɖi
ڌاتن	dʰaːt̪ˈʌn
ڌاڳو	dʰˈaːɡoː
ڌڪي	dʰˈʌki
ڍانچي	ɖʰˈaːnci
ڍورن	ɖʰoːrˈʌn
ڏياريو	ɖjˈaːrjoː
ڏيان	ɖjˈaːn
ڏيون	ɖjˈoːn
ڦرڻ	pʰərˈʌɳ
کائجي	kʰaːˈɪɟi
کاتن	kʰaːt̪ˈʌn
کارائڻ	kʰˌaːraːˈɪɳ
کنڀن	kʰˌənəbʰˈʌn
کنگھ	kʰˈʌnɡʰ
کهڙو	kʰəhˈʌr.oː
کيرائين	kʰˌeːraːˈiːn
ڪارائتو	kˌaːraːˈɪt̪oː
ڪارخانو	kˌaːrxˈaːnoː
ڪارروائي	kˌaːrrʋˈaːi
ڪاريگرن	kˌaːriɡərˈʌn
ڪارگر	kˌaːrəɡˈʌr
ڪاما	kˈaːmaː
ڪتبا	kˌət̪bˈaː
ڪتبو	kˌət̪bˈoː
ڪجھھ	kˌəɟəhˈʌh
ڪروڙن	kˌəroːr.ˈʌn
ڪش	kˈʌʃ
ڪمايو	kəmˈaːjoː
ڪميونيڪيشن	kˌəmjoːnˌiːkiʃˈʌn
ڪنڀار	kˌənbʰˈaːr
ڪنگ	kˈʌnɡ
ڪوسٽ	koːsˈʌʈ
ڪولن	koːlˈʌn
ڪوٽڏجي	kˌoːʈəɖˈʌɟi
ڪيلينڊر	kˌeːlinɖˈʌr
ڪيپ	kˈeːp
ڪيچ	kˈeːc
ڪچيون	kəcjˈoːn
گانن	ɡaːnˈʌn
گاه	ɡˈaːh
گرلز	ɡˌərəlˈʌz
گروھن	ɡˌəroːhˈʌn
گندرف	ɡˌəndərˈʌf
گهرڙي	ɡˌəhərˈʌr.i
گوئي	ɡˈoːi
گوليون	ɡoːljˈoːn
گيان	ɡjˈaːn
ڳائيندڙ	ɡˌaːindˈʌr.
ڳاتو	ɡˈaːt̪oː
ھال	hˈaːl
ھڻڻ	həɳˈʌɳ
آنديون	aːndjˈoːn
آنڌرا	aːndʰˈʌraː
اتم	at̪ˈʌm
اسٽوريج	ˌasʈoːrˈiːɟ
اشتر	aʃt̪ˈʌr
اعتقاد	ˌeːtɪqˈaːd
افغاني	ˌafɣˈaːni
اقرار	ˌaqrˈaːr
الفريڊ	ˌaləfrˈiːɖ
الهندو	ˌaləhˈʌndoː
اليزي	alˈiːzi
اليڪٽران	ˌalikˌəʈrˈaːn
اندرا	andˈʌraː
اندريون	ˌandərjˈoːn
انگي	ˈanɡi
اولھندي	ˌuːləhˈʌndi
اومان	uːmˈaːn
ايلسا	eːlˈʌsaː
ايٽمي	eːʈˈʌmi
ايڊيوڪيشنل	ˌeːɖjoːkˌiːʃənˈʌl
ايڪن	eːkˈʌn
اپگرھ	ˌapəɡərˈʌh
اڪاين	ˌakaːˈiːn
اھڃاڻ	ˌahɲˈaːɳ
بربر	bˌərəbˈʌr
برخلاف	bˌərəxlˈaːf
برطانيہ	bˌərtaːnˈiːh
برما	bərˈʌmaː
برهم	bˌərəhˈʌm
بروهين	bˌəroːhˈiːn
برکا	bərˈʌkʰaː
بظاهر	bˌəʐaːhˈʌr
بقول	bəqˈoːl
بلغمي	bˌələɣˈʌmi
بندو	bˈʌndoː
بنيا	bˈʌnjaː
بٺي	bˈʌʈʰi
بڻياد	bəɳjˈaːd
تابڪاري	t̪ˌaːbkˈaːri
تازا	t̪ˈaːzaː
تجربيڪار	t̪ˌəɟərbˈiːkaːr
تحرڪ	t̪ˌəhərˈʌk
تربت	t̪ˌərəbˈʌt̪
ترسي	t̪ərˈʌsi
ترن	t̪ərˈʌn
ترنم	t̪ˌərənˈʌm
ترياق	t̪ərjˈaːq
ترڪمانستان	t̪ˌərəkmaːnˈɪstaːn
تميم	t̪əmˈiːm
توبون	t̪oːbˈoːn
تيزاب	t̪eːzˈaːb
تيلگو	t̪eːlˈʌɡoː
تکي	t̪ˈʌkʰi
ثابتي	saːbˈʌt̪i
جابر	ɟaːbˈɪr
جاتي	ɟˈaːt̪i
جاويد	ɟaːʋˈiːd
جبلت	ɟˌəbəlˈʌt̪
جزوي	ɟˈʌzʋi
جند	ɟˈʌnd
جهنگلن	ɟˌəhənɡəlˈʌn
جيني	ɟˈeːni
جيوتي	ɟjˈoːt̪i
جيڏي	ɟˈeːɖi
جڏنهن	ɟˌəɖənəhˈʌn
حارث	haːrˈʌs
حافظي	haːfˈʌʐi
حديثون	hˌədisˈoːn
حس	hˈʌs
حلال	həlˈaːl
حمد	həmˈʌd
حمزه	hˌəməzˈʌh
حنيف	hənˈiːf
خاصي	xˈaːʂi
خورشيد	xˌoːrʃˈiːd
خيز	xˈeːz
دالين	daːlˈiːn
داڻي	dˈaːɳi
دراوڙ	dˌəraːˈoːr.
درجہ	dˈarɟh
درزي	dərˈʌzi
دستاربندي	dˌəst̪aːrəbˈʌndi
دستاويزي	dˌəst̪aːʋˈiːzi
ديوارون	djʋaːrˈoːn
دٻائي	dəbˈaːi
ذوالقعد	zʋˌaːlqˈaːd
ر	rˈeː
راست	rˈaːst̪
رايو	rˈaːjoː
رسايو	rəsˈaːjoː
رفت	rˈafət
رندن	rəndˈʌn
رهڻو	rəhˈʌɳoː
رومانس	roːmˈaːns
روٽ	rˈoːʈ
ريتي	rˈeːt̪i
رڍ	rˈʌɖʰ
رکما	rəkʰˈʌmaː
رکندڙن	rˌəkʰəndər.ˈʌn
زار	zˈaːr
زبون	zəbˈoːn
زرتشتي	zˌərət̪ˈʌʃt̪i
زنجيرن	zˌənɟirˈʌn
زندہ	zˈɪndh
زينب	zˈeːnb
سارس	saːrˈʌs
ساندهه	sˌaːndəhˈʌh
ستارا	sɪtˈaːraː
سرفهرست	sˌərəfˌəhərˈʌst̪
سرمائيدار	sˌərmˌaːidˈaːr
سرچشمو	sˌərcəʃˈʌmoː
سعادت	saːdˈʌt̪
سمجهاڻي	sˌəməɟhˈaːɳi
سنڀاليندو	sˌənbʰaːlˈiːndoː
سنڌالاجي	sˌɪndhaːlˈaːɟi
سنڌڙي	sˈɪndhr.i
سنگهڻ	sˌənɡəhˈʌɳ
سنہ	sənˈʌh
سهاري	səhˈaːri
سولنڪي	sˌoːlənˈʌki
سولي	sˈoːli
سونو	sˈoːnoː
سڄا	sˈʌɟaː
سڙيل	sˈʌr.jal
سگھبو	sˌəɡʰbˈoː
شاهہ	ʃaːhˈʌh
شعوري	ʃaːˈoːri
شفقت	ʃˌəfəqˈʌt̪
شھاب	ʃəhˈaːb
صحافين	ʂˌəhaːfˈiːn
صوبدار	ʂˌuːbdˈaːr
طاري	tˈaːri
عباسين	abˈaːsin
عدالتن	ˌadaːlət̪ˈʌn
عزم	azˈʌm
عضوي	ˈazʋi
علاقائي	ˌalaːqˈaːi
غسل	ɣəsˈʌl
غيرت	ɣeːrˈʌt̪
فاطمي	faːtˈʌmi
فاطمہ	fˌaːtəmˈʌh
فالج	faːlˈʌɟ
فرات	fˌərˈaːt
فردوس	fərdˈuːs
فريڊرڪ	fˌəriɖərˈʌk
فطرتي	fˌətərˈʌt̪i
فلڪياتي	fˌəlkjˈaːt̪i
فنون	fənˈoːn
فيس	fˈeːs
فيڪٽري	fˌeːkəʈˈʌri
فٽن	fəʈˈʌn
قافيہ	qaːfˈiːh
قانونسازي	qˌaːnoːnsˈaːzi
قرارداد	qˌəraːrdˈaːd
قرب	qərˈʌb
لاهيندي	laːhˈiːndi
لاٽ	lˈaːʈ
لبريشن	lˌəbriʃˈʌn
ليٿو	lˈeːtʰoː
ليکبو	lˌeːkʰbˈoː
ليکيا	lˈeːkʰjaː
لڌي	lˈʌdʰi
ماپن	maːpˈʌn
ماڙ	mˈaːr.
مجمدار	mˌəɟəmdˈaːr
محال	məhˈaːl
محاورو	mˌəhaːˈoːroː
محصولن	mˌəhʂuːlˈʌn
محنتي	mˌəhənˈʌt̪i
محي	mˈʌhi
مدافعت	mˌədaːfˈaːt̪
مدفن	mˌədəfˈʌn
مدن	mədˈʌn
مرتبو	mˌərət̪bˈoː
مسالي	məsˈaːli
مسرور	mˌəsrˈuːr
مشاعرن	mˌəʃaːˈaːɪrn
مشينن	mˌəʃinˈʌn
مصالحن	mˌəʂaːləhˈʌn
مصالحي	mˌəʂaːlˈʌhi
معزول	maːzˈoːl
مقصود	mˌəqʂˈuːd
ملائڪن	mˌəlaːɪkˈʌn
ملان	məlˈaːn
ملنديون	mˌəlndjˈoːn
ملهائي	mˌəlhˈaːi
ملهائڻ	mˌəlhaːˈɪɳ
ملوث	məlˈoːs
ملوڪ	məlˈoːk
ملڪه	mˌələkˈʌh
منٺار	mˌənʈʰˈaːr
مهاڻن	mˌəhaːɳˈʌn
مهرچند	mˌəhərcˈʌnd
موسمن	mˌoːsəmˈʌn
مول	mˈoːl
مونو	mˈoːnoː
موکي	mˈoːkʰi
موڪلائي	mˌoːklˈaːi
ميٿيو	mˈeːtʰjoː
ميگا	mˈeːɡaː
مٽائڻ	mˌəʈaːˈɪɳ
مڇيون	məcʰjˈoːn
نارا	nˈaːraː
نارو	nˈaːroː
ناڪامي	naːkˈaːmi
نبيري	nəbˈiːri
نظير	nəʐˈiːr
نعرا	nˈaːraː
نمائندا	nˈʊmaːˈɪndaː
نٿ	nˈʌʈ
نڪوٽين	nˌəkoːʈˈiːn
هئائون	hˌəaːˈoːn
هارائي	haːrˈaːi
هدايتن	hˌədaːit̪ˈʌn
همٿ	həmˈʌʈ
هڪجهڙي	hˌəkəɟəhˈʌr.i
واد	ʋˈaːd
وارڊ	ʋaːrˈʌɖ
واڻ	ʋˈaːɳ
وجهن	ʋˌəɟəhˈʌn
وجھڻ	ʋˌəɟəhˈʌɳ
وحشي	ʋəhˈʌʃi
ورائي	ʋərˈaːi
ورھاڱي	ʋˌərhaːˈŋ̩i
وسري	ʋəsˈʌri
وهم	ʋəhˈʌm
وٺجي	ʋəʈʰˈʌɟi
وڄائين	ʋˌəɟaːˈiːn
وڌيل	ʋˈʌdʰjal
وڍ	ʋˈʌɖʰ
وڏيرن	ʋˌəɖirˈʌn
وڪٽر	ʋˌəkəʈˈʌr
وگهي	ʋəɡˈʌhi
يتيم	jət̪ˈiːm
يونيڪوڊ	jˌoːnikˈoːɖ
ٺهندي	ʈʰəhˈʌndi
ٺهيا	ʈʰˈʌhjaː
ٺوڙهي	ʈʰoːr.ˈʌhi
ٺھرايو	ʈʰˌəhrˈaːjoː
ٻرڙو	bərˈʌr.oː
ٻچي	bˈʌci
ٽالپور	ʈˌaːlpˈoːr
ٽاپ	ʈˈaːp
ٽريڊ	ʈərˈiːɖ
ٽنگن	ʈənɡˈʌn
ٽيڪنالوجي	ʈˌeːknaːlˈoːɟi
پالتو	paːlˈʌt̪oː
پامير	paːmˈiːr
پرنسپل	pˌərənsəpˈʌl
پروٽان	pˌəroːʈˈaːn
پريشاني	pˌəriʃˈaːni
پرٿوي	pərˈʌtʰʋi
پستڪ	pəst̪ˈʌk
پنچم	pəncˈʌm
پوريل	pˈoːrjal
پوڻا	pˈoːɳaː
پيارجي	pjaːrˈʌɟi
پيسيفڪ	pˌeːsifˈʌk
پٺن	pəʈʰˈʌn
پٽيل	pˈʌʈjal
پڄي	pˈʌɟi
پڌرنامو	pˌədʰərnˈaːmoː
پکيڙي	pəkʰˈiːr.i
ڀتيون	bʰət̪jˈoːn
ڀورو	bʰˈoːroː
ڀيد	bʰˈeːd
ڀڃ	bʰˈʌɲ
ڀڳو	bʰˈʌɡoː
ڄاري	ɟˈaːri
چاليھ	caːlˈiːh
چاند	cˈaːnd
چانڊڪا	caːnɖˈʌkaː
چنبي	cənbˈiː
چوٽين	coːʈˈiːn
چوپايو	coːpˈaːjoː
چيز	cˈeːz
ڇاتي	cʰˈaːt̪i
ڇانيل	cʰˈaːnjal
ڇاپاڪو	cʰaːpˈaːkoː
ڇر	cʰˈʌr
ڇپر	cʰəpˈʌr
ڇڪڻ	cʰəkˈʌɳ
ڊيورنٽ	ɖjˌoːrənˈʌʈ
ڊٺل	ɖəʈʰˈʌl
ڌارا	dʰˈaːraː
ڌماڪو	dʰəmˈaːkoː
ڍاٽڪي	ɖʰaːʈˈʌki
ڍنڍون	ɖʰˌənɖʰˈoːn
ڏائڻ	ɖaːˈɪɳ
ڏاکڻو	ɖaːkʰˈʌɳoː
ڏوهي	ɖˈoːhi
ڏياچ	ɖjˈaːc
ڏينهون	ɖˌeːnhˈoːn
ڦهلجي	pʰˌəhəlˈʌɟi
کائيندڙ	kʰˌaːindˈʌr.
کارائي	kʰaːrˈaːi
کجين	kʰəɟˈiːn
کوج	kʰˈoːɟ
کوسا	kʰˈoːsaː
کونگهرن	kʰˌoːnɡəhərˈʌn
کڏي	kʰˈʌɖi
کڙ	kʰˈʌr.
ڪائونسلن	kˌaːoːnsəlˈʌn
ڪارج	kaːrˈʌɟ
ڪارخاني	kˌaːrxˈaːni
ڪاريون	kaːrjˈoːn
ڪاميٽيون	kˌaːmiʈjˈoːn
ڪان	kˈaːn
ڪاڪ	kˈaːk
ڪثير	kəsˈiːr
ڪجهہ	kˈʊɟʰʊ
ڪرايل	kərˈaːjal
ڪرمان	kˌərmˈaːn
ڪلهن	kˌələhˈʌn
ڪمرا	kəmˈʌraː
ڪنس	kˈʌns
ڪنول	kənˈoːl
ڪونوڪارپس	kˌoːnoːkˌaːrəpˈʌs
ڪيرائي	keːrˈaːi
ڪيناڊا	keːnˈaːɖaː
ڪينيا	kˈeːnjaː
ڪيٽي	kˈeːʈi
ڪٺي	kˈʌʈʰi
ڪٿ	kˈʌʈ
ڪچرو	kəcˈʌroː
ڪچن	kəcˈʌn
ڪڍن	kəɖʰˈʌn
گاهن	ɡaːhˈʌn
گاڏڙ	ɡaːɖˈʌr.
گدري	ɡədˈʌri
گرهه	ɡˌərəhˈʌh
گريٽ	ɡərˈiːʈ
گهاٽن	ɡˌəhaːʈˈʌn
گهرا	ɡəhˈʌraː
گهرائڻ	ɡˌəhəraːˈɪɳ
گهير	ɡəhˈiːr
گوئٽي	ɡˈoːʈi
گھاٽائي	ɡʰaːʈˈaːi
گھميل	ɡʰˈʌmjal
ڳالھائيندا	ɡˌaːlhaːˈiːndaː
ڳجهي	ɡəɟˈʌhi
ڳرو	ɡˈʌroː
ڳنڍين	ɡˌənɖʰˈiːn
ڳولها	ɡoːlˈʌhaː
ڳوڙها	ɡoːr.ˈʌhaː
ڳوڙهو	ɡoːr.ˈʌhoː
ڳڀيرڻ	ɡˌəbʰirˈʌɳ
ڳڻپيوڪر	ɡˌəɳpjoːkˈʌr
ھيليم	heːlˈiːm
آشا	ˈaːʃaː
آفاقي	aːfˈaːqi
آلبم	ˌaːləbˈʌm
آورن	ˌaːoːrˈʌn
آڻيندي	aːɳˈiːndi
ابا	abˈaː
ابراھام	ˌabraːhˈaːm
اخر	axˈʌr
ادريس	ˌadrˈiːs
اسٽيم	ˌasʈˈiːm
اسڪندر	ˌasəkəndˈʌr
اصلاحي	ˌɪʂlˈaːhi
اصلوڪا	ˌaʂlˈoːkaː
افسانه	ˌafsaːnˈʌh
افسانو	ˌafsˈaːnoː
الا	ˈalaː
البيروني	ˌalbˈiːroːnˌiː
العارفين	ˌalaːrfˈiːn
العلماء	ˌalaːlˈʌmaː
العلوم	ˌalaːlˈoːm
امت	amˈʌt̪
امرتسر	ˌamərˌət̪əsˈʌr
امپيريل	ampˈiːrjal
انجو	anˈʌɟoː
اوبلاسٽ	ˌuːblaːsˈʌʈ
اونڌو	ˈuːndʰoː
اوڌ	ˈuːdʰ
ايٽلانٽڪ	ˌeːʈlˌaːnəʈˈʌk
ايپ	ˈeːp
اپٽار	ˌapʈˈaːr
اٿينس	atʰˈiːns
اڏائي	aɖˈaːi
اڏيرولال	ˌaɖiroːlˈaːl
اڏڻ	aɖˈʌɳ
اڳرائي	ˌaɡrˈaːi
بائيڪاٽ	bˈaːikˌaːʈ
بازنطيني	bˈaːzəntinˌiː
باقيات	bˈaːqiˈaːt
بانڊ	bˈaːnɖ
بحرين	bˌəhrˈiːn
بختاور	bˌəxt̪aːˈoːr
بدترين	bˌədət̪rˈiːn
براڊ	bərˈaːɖ
برساتن	bˌərsaːt̪ˈʌn
برساتون	bˌərsaːt̪ˈoːn
بلب	bəlˈʌb
بنان	bənˈaːn
بهاري	bəhˈaːri
بيچلر	bˈeːcəlˌər
بٺوري	bəʈʰˈoːri
بچاء	bˈʌcaː
تائيوان	t̪aːjʋˈaːn
تاریخ	t̪aːrˈiːx
تاهم	t̪aːhˈʌm
تبصرا	t̪ˌəbəʂˈʌraː
تجرباتي	t̪ˌəɟərbˈaːt̪i
تجزيي	t̪əɟˈʌzji
تجسس	t̪ˌəɟəsˈʌs
تحريڪون	t̪ˌəhrikˈoːn
تختي	t̪ˈʌxt̪i
تختگاه	t̪ˌəxt̪əɡˈaːh
تشبيهه	t̪ˌəʃbˈiːhəh
تعميراتي	t̪ˌaːmirˈaːt̪i
تقابلي	t̪ˌəqaːbˈʌli
تقريرن	t̪ˌəqrirˈʌn
تنت	t̪ənˈʌt̪
توهين	t̪oːhˈiːn
تيلي	t̪ˈeːli
تيليگو	t̪eːlˈiːɡoː
جئن	ɟˈʌn
جاٽ	ɟˈaːʈ
جدت	ɟədˈʌt̪
جل	ɟˈʌl
جمھوريہ	ɟˌəmhuːrˈiːh
جواز	ɟˈaʋaːz
جوانن	ɟˈaʋaːnˌən
جوڙا	ɟˈoːr.aː
جوڙيون	ɟoːr.jˈoːn
جوڳ	ɟˈoːɡ
جوڳين	ɟoːɡˈiːn
جيئندي	ɟeːˈɪndi
جيئڻ	ɟeːˈɪɳ
جھان	ɟəhˈaːn
جھنڊو	ɟəhˈʌnɖoː
جھڙيون	ɟˌəhr.jˈoːn
حامل	haːmˈʌl
حجر	həɟˈʌr
حشر	həʃˈʌr
حلف	həlˈʌf
حميده	hˌəmidˈʌh
حوصلي	hoːʂˈʌli
داني	dˈaːni
دبئي	dəbˈʌi
درخت	dərˈʌxt̪
درڪار	dˌərkˈaːr
درگاهن	dˌərɡaːhˈʌn
دنیا	dˈʌnjaː
دهلن	dˌəhəlˈʌn
دو	dˈoː
دينار	deːnˈaːr
ديواني	djʋˈaːni
دٻدٻي	dˌəbədˈʌbi
رائو	rˈaːoː
رائيفل	rˌaːifˈʌl
رتبي	rˌət̪bˈiː
رحمان	rˌəhmˈaːn
رسالت	rˌəsaːlˈʌt̪
رشوت	rəʃˈoːt̪
رهيس	rəhˈiːs
رواجن	rʋaːɟˈʌn
رومال	roːmˈaːl
ريپبلڪن	rˌeːpəbˌələkˈʌn
رچنا	rəcˈʌnaː
رڪاوٽون	rˌəkaːoːʈˈoːn
رڪنيت	rˌəknˈiːt̪
زنداوستا	zˈɪndaːˌoːst̪aː
زويا	zʋjˈaː
زويگ	zʋˈeːɡ
زيورن	zjoːrˈʌn
س	sˈiːn
سئوٽ	səˈoːʈ
ساداتن	sˌaːdaːt̪ˈʌn
سامونڊري	sˌaːmoːnɖˈʌri
ساون	saːˈoːn
ساڙيو	sˈaːr.joː
ساڪري	saːkˈʌri
ستم	sət̪ˈʌm
سدن	sədˈʌn
سربيا	sˌərbjˈaː
سرهاڻ	sˌərhˈaːɳ
سلطانه	sˌəltaːnˈʌh
سماجيات	sˌəmaːɟiˈaːt
سمجهو	sˌəməɟˈʌhoː
سمو	sˈʌmoː
سنبت	sənbˈʌt̪
سنسار	sənsˈaːr
سنڍ	sənˈʌɖʰ
سنگل	sənɡˈʌl
سنگين	sənɡˈiːn
سهروردي	sˌəhərˈuːrdi
سوير	sʋˈeːr
سوچن	soːcˈʌn
سوڍا	sˈoːɖʰaː
سيوي	sjʋˈeː
سپه	səpˈʌh
سپھ	səpˈʌh
سڄاڻ	səɟˈaːɳ
سگھو	sˈʌɡʰoː
شاعراڻي	ʃaːˈaːɪrˌaːɳi
شغل	ʃəɣˈʌl
شھابن	ʃˌəhaːbˈʌn
صداقت	ʂˌədaːqˈʌt̪
صورتون	ʂˌoːrt̪ˈoːn
ضامن	zaːmˈʌn
طرحين	tˌərhˈiːn
طفيل	tˈʌfjal
عاج	ˈaːɟ
عبدالغني	ˌabdˌaːləɣˈʌni
عددن	ˌadədˈʌn
عسڪري	ˌasəkˈʌri
عصر	aʂˈʌr
عمري	ˈʊmri
غارون	ɣaːrˈoːn
غيب	ɣˈeːb
فتوا	fˈʌt̪ʋaː
فجر	fəɟˈʌr
فدا	fˈʌdaː
فرائض	fˌəraːˈɪz
فرم	fərˈʌm
فرھنگ	fˌərəhˈʌnɡ
فضائي	fəzˈaːi
فنن	fənˈʌn
فيچر	feːcˈʌr
قاصد	qaːʂˈʌd
قاضن	qaːzˈʌn
قافلن	qˌaːfəlˈʌn
قدمي	qədˈʌmi
قسط	qˈɪst
قطعي	qətˈaːi
قلب	qəlˈʌb
قياس	qjˈaːs
لاجواب	laːɟʋˈaːb
لاکا	lˈaːkʰaː
لغات	lˈʊɣaːt
لميٽيڊ	lˌəmiʈˈiːɖ
ليڊي	lˈeːɖi
لٽر	ləʈˈʌr
لٽريچر	lˌəʈricˈʌr
لڙاين	lˌər.aːˈiːn
لڪياري	ləkjˈaːri
لڳندڙ	lˌəɡəndˈʌr.
لھي	lˈʌhi
ماجسٽريٽ	mˌaːɟəsˌəʈrˈiːʈ
مالامال	mˌaːlaːmˈaːl
مانجھند	mˌaːnəɟəhˈʌnd
مبلغ	mˌəbəlˈʌɣ
مجاز	məɟˈaːz
مجذوب	mˌəɟzˈuːb
محفلون	mˈɛhfˌɪloːn
مختيارڪار	mˌəxt̪jaːrkˈaːr
مخفي	məxˈʌfi
مدينه	mˌədinˈʌh
مرادياب	mˌəraːdjˈaːb
مربي	mˌərbˈiː
مرڪ	mərˈʌk
مزور	məzˈoːr
مصنفن	mˌəʂənəfˈʌn
معاشرو	maːʃˈʌroː
معاون	maːˈoːn
معاھدو	maːhˈʌdoː
معشوق	maːʃˈoːq
معطل	maːtˈʌl
ملائڪ	mˌəlaːˈɪk
ملفوظات	mˌəlfˌuːʐˈaːt
ملٽن	mˌələʈˈʌn
ملڪا	məlˈʌkaː
منجهائن	mˌənəɟhaːˈɪn
منسلڪ	mˌənsəlˈʌk
منصوبا	mˌənʂuːbˈaː
منظرن	mˌanʐˈarn
منوره	mˌənoːrˈʌh
منير	mənˈiːr
مهين	məhˈiːn
موجد	moːɟˈʌd
موجودہ	moːɟˈuːdh
موروثي	moːrˈoːsi
موٽائي	moːʈˈaːi
ميانوال	mjaːnʋˈaːl
ميدن	meːdˈʌn
ميلا	mˈeːlaː
ميٽروپوليٽن	mˌeːʈrˌoːpoːliʈˈʌn
ميٿين	meːtʰˈiːn
مٿڀرو	mˌəʈəbʰˈʌroː
مڙي	mˈʌr.i
مڱڻهار	mˌəŋ̩ˌəɳhˈaːr
مھم	məhˈʌm
ناتي	nˈaːt̪i
ناصرالدين	nˌaːʂrˌaːldˈiːn
نبض	nəbˈʌz
نت	nˈʌt̪
نسخن	nˌəsəxˈʌn
نقطه	nˌəqətˈʌh
نهر	nəhˈʌr
نواڻ	nˈaʋaːɳ
نورالدين	nˌoːraːldˈiːn
نيوي	njʋˈeː
نيٽو	nˈeːʈoː
نيپولين	nˌeːpoːlˈiːn
نٽشي	nəʈˈʌʃi
نڙي	nˈʌr.i
هادي	hˈaːdi
هسٽري	hˌəsəʈˈʌri
هلائيندڙ	hˌəlaːindˈʌr.
هلن	həlˈʌn
همعصرن	hˌəmaːʂərˈʌn
هنري	hənˈʌri
هنيا	hˈʌnjaː
هيرڻ	heːrˈʌɳ
هٽائڻ	hˌəʈaːˈɪɳ
هٿياربند	hˌətʰjaːrəbˈʌnd
وابستگي	ʋˌaːbəst̪ˈʌɡi
والا	ʋˈaːlaː
وايو	ʋˈaːjoː
وبائي	ʋəbˈaːi
وحيد	ʋəhˈiːd
ورزش	ʋˌərəzˈʌʃ
ورهاڱو	ʋˌərhaːˈŋ̩oː
وسن	ʋəsˈʌn
وليون	ʋəljˈoːn
وهڪرن	ʋˌəhəkərˈʌn
وياج	ʋjˈaːɟ
ويهندو	ʋeːhˈʌndoː
ويچارن	ʋˌeːcaːrˈʌn
ويڪريون	ʋˌeːkrjˈoːn
وڃان	ʋəɲˈaːn
وڄايو	ʋəɟˈaːjoː
وڌنديون	ʋˌədʰndjˈoːn
وڪڻندا	ʋˌəkəɳˈʌndaː
وڳوڙن	ʋˌəɡoːr.ˈʌn
ياداشت	jaːdˈaːʃt̪
يادگيرين	jˌaːdɡirˈiːn
يوم	jˈoːm
يونٽن	jˌoːnəʈˈʌn
ٺهرايائين	ʈʰˌəhərˌaːjaːˈiːn
ٻالڪ	baːlˈʌk
ٻانهي	baːnˈʌhi
ٻاهريان	bˌaːhərjˈaːn
ٻڌندو	bədʰˈʌndoː
ٽيپ	ʈˈeːp
ٽڪي	ʈˈʌki
پادرين	pˌaːdrˈiːn
پارا	pˈaːraː
پارليامينٽري	pˌaːrljˌaːminəʈˈʌri
پايه	paːˈiːh
پايي	pˈaːji
پردن	pərdˈʌn
پرديسي	pərdˈiːsi
پرهيزگار	pˌərhˌiːzɡˈaːr
پروڙ	pərˈoːr.
پريا	pˈʌrjaː
پريل	pˈʌrjal
پرڏيهه	pˌərɖihˈʌh
پنري	pənˈʌri
پهتل	pˌəhət̪ˈʌl
پو	pˈoː
پورس	poːrˈʌs
پوندڙ	poːndˈʌr.
پوٽا	pˈoːʈaː
پيارڻ	pjaːrˈʌɳ
پيج	pˈeːɟ
پين	pˈeːn
پيچيده	pˌeːcidˈʌh
پيڊيا	pˈeːɖjaː
پھتي	pəhˈʌt̪i
ٿلها	ʈəlˈʌhaː
ٿلھو	ʈəlˈʌhoː
ٿڌيون	ʈədʰjˈoːn
ڀائيچاري	bʰˌaːicˈaːri
ڀاڳو	bʰˈaːɡoː
ڀينر	bʰeːnˈʌr
ڀڄ	bʰˈʌɟ
ڄمون	ɟəmˈoːn
ڄڻن	ɟəɳˈʌn
چئو	cˈʌoː
چانھن	cˈaːnhn
چمڪدار	cˌəməkdˈaːr
چنگ	cˈʌnɡ
چونس	cˈoːns
چونڊجڻ	cˌoːnɖəɟˈʌɳ
چي	cˈeː
چيمبر	ceːmbˈʌr
چپن	cəpˈʌn
چھري	cəhˈʌri
ڇاڙ	cʰˈaːr.
ڇنڊڇاڻ	cʰˌənɖəcʰˈaːɳ
ڇپجندا	cʰˌəpəɟˈʌndaː
ڇپجندڙ	cʰˌəpəɟəndˈʌr.
ڇپيون	cʰəpjˈoːn
ڇھين	cʰəhˈiːn
ڊائري	ɖaːˈɪri
ڊرائيور	ɖˌəraːjˈoːr
ڊگهن	ɖˌəɡəhˈʌn
ڏانڊي	ɖˈaːnɖi
ڏاھر	ɖaːhˈʌr
ڏهاڙن	ɖˌəhaːr.ˈʌn
ڏورانهن	ɖˌoːraːnəhˈʌn
ڏيپلائي	ɖˌeːplˈaːi
ڏکيائي	ɖəkʰjˈaːi
ڦاڙي	pʰˈaːr.i
کائبو	kʰˌaːɪbˈoː
کائيندي	kʰaːˈiːndi
کار	kʰˈaːr
کاڻ	kʰˈaːɳ
کاڻين	kʰaːɳˈiːn
کلن	kʰəlˈʌn
کوليائين	kʰˌoːljaːˈiːn
کڙو	kʰˈʌr.oː
ڪائناتي	kˌaːɪnˈaːt̪i
ڪائونسلون	kˌaːoːnsəlˈoːn
ڪاربن	kˌaːrəbˈʌn
ڪارين	kaːrˈiːn
ڪاسٽ	kaːsˈʌʈ
ڪاظم	kaːʐˈʌm
ڪاميابيون	kˌaːmjaːbjˈoːn
ڪاٽي	kˈaːʈi
ڪاپي	kˈaːpi
ڪاھ	kˈaːh
ڪبوتر	kəbˈoːt̪ər
ڪتا	kˈʌt̪aː
ڪتبخانو	kˌət̪əbxˈaːnoː
ڪتبي	kˌət̪bˈiː
ڪراس	kərˈaːs
ڪرسي	kərˈʌsi
ڪرندو	kərˈʌndoː
ڪرندڙ	kˌərəndˈʌr.
ڪسٽم	kˌəsəʈˈʌm
ڪشمور	kˌəʃmˈuːr
ڪلپنا	kˌələpˈʌnaː
ڪلھوڙا	kˌəlhˈuːr.aː
ڪني	kˈʌni
ڪوي	kʋˈeː
ڪوٺجي	koːʈʰˈʌɟi
ڪوڏر	koːɖˈʌr
ڪٽڪ	kəʈˈʌk
ڪچين	kəcˈiːn
گائڪ	ɡaːˈɪk
گبسن	ɡˌəbəsˈʌn
گج	ɡˈʌɟ
گذاريندا	ɡˌəzaːrˈiːndaː
گلاس	ɡəlˈaːs
گوڙ	ɡˈoːr.
ڳائڻو	ɡaːˈɪɳoː
ڳتيل	ɡˈʌt̪jal
ڳن	ɡˈʌn
ڳهه	ɡəhˈʌh
ڳڻتي	ɡəɳˈʌt̪i
ھلڪي	həlˈʌki
آدي	ˈaːdi
آرسي	aːrˈʌsi
آرو	ˈaːroː
آرٽيڪل	ˌaːrʈikˈʌl
آسٽريلين	ˌaːsəʈrilˈiːn
آلت	aːlˈʌt̪
آمدورفت	ˌaːmdˌoːrəfˈʌt̪
آمري	aːmˈʌri
آمريڪن	ˌaːmrikˈʌn
آڻبو	ˌaːɳbˈoː
آڻيندڙ	ˌaːɳindˈʌr.
احتجاجي	ˌɛht̪əɟˈaːɟi
استنبول	ˌɪstɪnbˈoːl
اسمن	ˌasəmˈʌn
اسٽون	ˌasʈˈoːn
اسٽڊيز	ˌasəʈɖˈiːz
اشارن	ˌaʃaːrˈʌn
اصحاب	ˌaʂhˈaːb
اصحابن	ˌaʂhaːbˈʌn
افراد	ˌafrˈaːd
افروز	ˌafrˈoːz
الاباما	ˌalaːbˈaːmaː
الحاق	ˌalhˈaːq
الهام	ˌalhˈaːm
امرت	ˌamərˈʌt̪
امروٽي	ˌamrˈoːʈi
انتقام	ˌɪntɪqˈaːm
اندازن	ˌandaːzˈʌn
انديشو	andˈiːʃoː
انڍڙ	ˌanəɖʰˈʌr.
اهلڪارن	ˌahəlkaːrˈʌn
اهيو	ˈahjoː
اولين	uːlˈiːn
اونهائي	ˌuːnhˈaːi
اونھو	ˈuːnhoː
اويس	uːˈiːs
اوکا	ˈuːkʰaː
ايليٽ	eːlˈiːʈ
ايمرجنسي	ˌeːmərəɟˈʌnsi
ايمنسٽي	ˌeːmənsˈʌʈi
اينگلو	eːnɡˈʌloː
ايڊنبرا	ˌeːɖənbˈʌraː
ايڊٽ	eːɖˈʌʈ
ايڪسپو	ˌeːkəsˈʌpoː
اڀرندو	ˌabʰərˈʌndoː
اڇاڻ	acʰˈaːɳ
اڏامندڙ	ˌaɖaːməndˈʌr.
اڪبري	ˌakəbˈʌri
اڪيلائي	ˌakilˈaːi
اھوئي	ahˈoːi
بئريسٽر	bˌərisəʈˈʌr
بديع	bˈʌdi
برازيل	bərˈaːzjal
برفي	bərˈʌfi
برقعي	bˌərqˈaːi
بسر	bəsˈʌr
بلاغت	bˌəlaːɣˈʌt̪
بلوغت	bˌəloːɣˈʌt̪
بلين	bəlˈiːn
بهاول	bˌəhaːˈoːl
بهرو	bəhˈʌroː
بياس	bjˈaːs
بيسڪ	bˈeːsək
بينڪاڪ	bˈeːnkˌaːk
بيڪن	bˈeːkən
بگھڙ	bəɡʰˈʌr.
تاندورا	t̪aːndˈoːraː
تاڃي	t̪ˈaːɲi
تاڪيد	t̪aːkˈiːd
ترجمن	t̪ˌərəɟəmˈʌn
تضاد	t̪əzˈaːd
تقدير	t̪ˌəqdˈiːr
تقليد	t̪ˌəqlˈiːd
تولا	t̪ˈoːlaː
تيرهين	t̪ˌeːrhˈiːn
تيرھين	t̪ˌeːrhˈiːn
تيليون	t̪eːljˈoːn
جاٽن	ɟaːʈˈʌn
جاڳرتا	ɟˌaːɡərˈʌt̪aː
جرئت	ɟərˈʌt̪
جلسو	ɟəlˈʌsoː
جلسي	ɟəlˈʌsi
جمنا	ɟəmˈʌnaː
جهمر	ɟˌəhəmˈʌr
جهٽ	ɟəhˈʌʈ
جوڌا	ɟˈoːdʰaː
جوڻو	ɟˈoːɳoː
جياپي	ɟjˈaːpi
جيوڻي	ɟjˈoːɳi
جھلي	ɟəhˈʌli
حادثن	hˌaːdəsˈʌn
حتمي	hət̪ˈʌmi
حصيدار	hˌəʂidˈaːr
حلاج	həlˈaːɟ
حويلي	hʋˈeːli
حيوانات	hjʋˌaːnˈaːt
خاڪا	xˈaːkaː
خداآباد	xˌədaːaːbˈaːd
خريف	xərˈiːf
خضر	xəzˈʌr
خوردبيني	xʊɾdbˈiːni
خونريزي	xˌoːnrˈiːzi
دانائي	daːnˈaːi
درجابندي	dˈarɟaːbndi
درسگاهه	dˌərəsɡaːhˈʌh
دريون	dərjˈoːn
دستاويزن	dˌəst̪aːʋizˈʌn
ديال	djˈaːl
ديول	djˈoːl
راغب	raːɣˈʌb
رامائڻ	rˌaːmaːˈɪɳ
رتو	rˈʌt̪oː
رضوان	rəzʋˈaːn
رن	rˈʌn
رنگريز	rˌənɡərˈiːz
روئي	rˈoːi
روئڻ	roːˈɪɳ
روانگي	rʋˈaːnɡi
روبرو	roːbˈʌroː
روزمره	rˌoːzəmərˈʌh
روش	rˈoːʃ
روي	rʋˈeː
روپيه	roːpˈiːh
رياضيدان	rjˌaːzidˈaːn
ريزيڊنٽ	rˌeːziɖənˈʌʈ
ريڍار	reːɖʰˈaːr
رپورٽون	rˌəpoːrʈˈoːn
رچاء	rˈʌcaː
رڳن	rəɡˈʌn
زبيده	zəbˈiːdəh
زخمن	zˌəxəmˈʌn
زم	zˈʌm
زمري	zəmˈʌri
زوري	zˈoːri
سئفٽ	səfˈʌʈ
سائينداد	sˌaːindˈaːd
سائيڪل	sˌaːikˈʌl
ساخت	sˈaːxt̪
ساڍن	saːɖʰˈʌn
سجاڳ	səɟˈaːɡ
سربراه	sˌərəbrˈaːh
سرداري	sərdˈaːri
سريلي	sərˈiːli
سطحي	sətˈʌhi
سلامي	səlˈaːmi
سندون	səndˈuːn
سندين	səndˈiːn
سنٿالن	sˌəntʰaːlˈʌn
سنڌيانا	sɪndhjˈaːnaː
سنھي	sˈʌnhi
سورتون	sˌoːrt̪ˈoːn
سوڀي	sˈoːbʰi
سيزن	seːzˈʌn
سڌيون	sədʰjˈoːn
سڏيائون	sˌəɖjaːˈoːn
سگنل	sˌəɡənˈʌl
شالا	ʃˈaːlaː
شانتي	ʃaːnˈʌt̪i
شهداد	ʃˌəhədˈaːd
شهنشاه	ʃˌəhənʃˈaːh
شھابي	ʃˌəhaːbˈiː
صدمي	ʂədˈʌmi
طبيبن	təbˈiːbən
طي	tˈeː
ظهير	ʐəhˈiːr
عبدالجبار	ˌabdˌaːləɟbˈaːr
عدن	adˈʌn
عقلي	aqˈʌli
علماء	alˈʌmaː
عملو	amˈʌloː
عنوانن	ʊnʋˈaːnn
عه	ˈah
عهدا	ahˈʌdaː
غدودن	ɣˌədoːdˈʌn
غذائي	ɣəzˈaːi
غرق	ɣərˈʌq
فائينل	fˌaːinˈʌl
فتوحات	fˌət̪oːhˈaːt
فرائيڊ	fˌəraːˈiːɖ
فرمائش	fˌərmaːˈɪʃ
فقدان	fˌəqdˈaːn
فلابرٽ	fˌəlaːbərˈʌʈ
فلاڻي	fəlˈaːɳi
فوجداري	fˌoːɟdˈaːri
فيلو	fˈeːloː
فيملي	feːmˈʌli
قرآني	qərˈaːni
قرضن	qˌərəzˈʌn
قسطن	qˈɪstn
قصور	qəʂˈoːr
قصيدا	qəʂˈiːdaː
قصيدي	qəʂˈiːdi
قضا	qˈʌzaː
قوس	qˈoːs
قيمتون	qˌeːmt̪ˈoːn
لائينز	lˌaːinˈʌz
لامحدود	lˌaːməhdˈoːd
لاهن	laːhˈʌn
لاهوري	laːhˈoːri
لاکاٽ	laːkʰˈaːʈ
لنڪيش	lˌənkˈiːʃ
لنگهه	lˌənɡəhˈʌh
لهجن	lˌəhəɟˈʌn
لهري	ləhˈʌri
لوئر	loːˈɪr
ليلي	lˈeːli
ليڊرن	lˌeːɖərˈʌn
لکجي	ləkʰˈʌɟi
لکمير	lˌəkʰmˈiːr
لکندڙن	lˌəkʰəndər.ˈʌn
لکنو	ləkʰˈʌnoː
لھرن	lˌəhərˈʌn
مئنيجر	mˌəniɟˈʌr
مئو	mˈʌoː
ماليڪيولن	mˌaːlikjoːlˈʌn
ماڱر	mˌaːŋ̩ˈʌr
متعدد	mˌət̪aːdˈʌd
متڀيد	mˌət̪bʰˈiːd
محاورا	mˌəhaːˈoːraː
مختصرن	mˌəxt̪əʂərˈʌn
مدبر	mˌədəbˈʌr
مذاق	məzˈaːq
مزاجن	mˌəzaːɟˈʌn
مزارون	mˌəzaːrˈoːn
مسواڙ	məsʋˈaːr.
مسڪينن	mˌəskinˈʌn
مشائخ	mˌəʃaːˈɪx
مشير	məʃˈiːr
مشڪلاتن	mˌəʃəklaːt̪ˈʌn
مصوري	məʂˈoːri
مظلوم	mˌəʐlˈuːm
معاهدن	mˌaːhədˈʌn
معتصم	mˌaːt̪əʂˈʌm
معزالدين	mˌaːzaːldˈiːn
منتشر	mˌənət̪əʃˈʌr
منسٽر	mˌənsəʈˈʌr
منشيات	mˌənʃiˈaːt
منصوبن	mˌənʂuːbˈʌn
مهاراشٽر	mˌəhaːrˌaːʃəʈˈʌr
مهاڻي	məhˈaːɳi
مهمن	mˌəhəmˈʌn
موتمار	mˌoːt̪mˈaːr
موقعا	mˈoːqaː
مياڻي	mjˈaːɳi
ميسارجي	mˌeːsaːrˈʌɟi
ميندي	mˈeːndi
مٿا	mˈʌtʰaː
مٿانئس	mˌətʰaːnˈʌs
مڃن	məɲˈʌn
مڏ	mˈʌɖ
مڙهي	mər.ˈʌhi
مڪو	mˈʌkoː
مڱڻي	mˌəŋ̩ˈʌɳi
نابالغ	naːbˈaːləɣ
ناميارن	nˌaːmjaːrˈʌn
ناناڻن	nˌaːnaːɳˈʌn
نشانن	nɪʃˈaːnn
نشونما	nˌəʃoːnˈʌmaː
نقوي	nˈʌqʋi
نهرو	nəhˈʌroː
نوبت	noːbˈʌt̪
نڀائي	nəbʰˈaːi
نک	nˈʌkʰ
هاء	hˈaː
هاسارام	hˌaːsaːrˈaːm
هاڃو	hˈaːɲoː
همدرد	hˌəmədˈʌrd
همه	həmˈʌh
همير	həmˈiːr
هوٿل	hoːʈˈʌl
هوڏي	hˈoːɖi
هيلن	heːlˈʌn
هيمون	heːmˈoːn
وآله	ʋaːlˈʌh
وائس	ʋaːˈɪs
واقعاتي	ʋaːqˈaːt̪i
وجهندو	ʋˌəɟəhˈʌndoː
وريو	ʋˈʌrjoː
وصفون	ʋˌəʂfˈoːn
وقار	ʋəqˈaːr
وهڪرا	ʋˌəhəkˈʌraː
وومين	ʋoːmˈiːn
وياڪرڻ	ʋjˌaːkərˈʌɳ
ويلٿ	ʋeːlˈʌʈ
ويڙهاڪ	ʋˌeːr.hˈaːk
وٿي	ʋˈʌtʰi
وڇون	ʋəcʰˈoːn
وڌل	ʋədʰˈʌl
وڏيري	ʋəɖˈiːri
وڙھي	ʋˈʌr.hi
وڪٽوريه	ʋˌəkʈoːrˈiːh
وڳوڙ	ʋəɡˈoːr.
يادگيري	jˌaːdɡˈiːri
ياسر	jaːsˈʌr
ينگ	jˈʌnɡ
يڪسان	jˌəksˈaːn
ٺهندڙ	ʈʰˌəhəndˈʌr.
ٺھرائي	ʈʰˌəhrˈaːi
ٻنڌ	bˈʌndʰ
ٻوڏن	boːɖˈʌn
ٻيرن	beːrˈʌn
ٻڌائن	bˌədʰaːˈɪn
ٻڌبو	bˌədʰbˈoː
ٽاڊ	ʈˈaːɖ
ٽرانس	ʈərˈaːns
ٽم	ʈˈʌm
ٽنھي	ʈˈʌnhi
ٽيھ	ʈˈeːh
ٽپو	ʈˈʌpoː
ٽڪرائجي	ʈˌəkraːˈɪɟi
ٽڻ	ʈˈʌɳ
پاشا	pˈaːʃaː
پانيل	pˈaːnjal
پاڇي	pˈaːcʰi
پاڻيٺ	paːɳˈiːʈʰ
پبلشنگ	pˌəbələʃˈʌnɡ
پدم	pədˈʌm
پرائڻ	pˌəraːˈɪɳ
پراجيڪٽ	pˌəraːɟikˈʌʈ
پرايائين	pˌəraːjaːˈiːn
پردا	pˈʌrdaː
پروفيشنل	pˌəroːfˌiːʃənˈʌl
پرولي	pərˈoːli
پرچارڪ	pˌərcaːrˈʌk
پرڏيھي	pˌərɖˈiːhi
پرڪشش	pˌərəkəʃˈʌʃ
پنهون	pˌənhˈuːn
پنٿ	pənˈʌʈ
پوپ	pˈoːp
پوپٽ	poːpˈʌʈ
پوکبا	pˌoːkʰbˈaː
پيشوا	pˈeːʃʋaː
پيڙهه	pˌeːr.əhˈʌh
پٽاندڙ	pˌəʈaːndˈʌr.
پٽڪو	pəʈˈʌkoː
پڙاڏو	pər.ˈaːɖoː
پکڙيو	pəkʰˈʌr.joː
ٿائيلينڊ	tʰˌaːilˈiːnɖ
ٿرڙي	ʈərˈʌr.i
ٿڪ	ʈˈʌk
ڀاء	bʰˈaː
ڀيٽي	bʰˈeːʈi
ڀڃڻ	bʰəɲˈʌɳ
ڄامن	ɟaːmˈʌn
چؤسٽا	cˌəa͡ʊsˈʌʈaː
چارٽر	cˌaːrəʈˈʌr
چانڊين	caːnɖˈiːn
چاهين	caːhˈiːn
چاڙھيو	cˈaːr.hjoː
چناب	cənˈaːb
چوان	cʋˈaːn
چواڻي	cʋˈaːɳi
چورن	coːrˈʌn
ڇانئجي	cʰaːnˈʌɟi
ڇپائڻ	cʰˌəpaːˈɪɳ
ڇڄ	cʰˈʌɟ
ڊائون	ɖaːˈoːn
ڊبلن	ɖˌəbəlˈʌn
ڊھي	ɖˈʌhi
ڌوڙ	dʰˈoːr.
ڌيئرن	dʰeːˈɪrən
ڌيئرون	dʰeːˈɪroːn
ڌيوت	dʰjˈoːt̪
ڏاند	ɖˈaːnd
ڏبي	ɖəbˈiː
ڏسبا	ɖˌɪsbˈaː
ڏسن	ɖɪsˈʌn
ڏيئا	ɖˈeːaː
ڏھين	ɖəhˈiːn
ڦرندو	pʰərˈʌndoː
ڦرندي	pʰərˈʌndi
ڦول	pʰˈoːl
ڦولن	pʰoːlˈʌn
ڦٽندو	pʰəʈˈʌndoː
ڦھلجي	pʰˌəhəlˈʌɟi
کائنس	kʰaːˈɪns
کانپوء	kʰˈaːnpoː
کرب	kʰərˈʌb
کليو	kʰˈʌljoː
کوٽايو	kʰoːʈˈaːjoː
کيتي	kʰˈeːt̪i
کيڏيو	kʰˈeːɖjoː
کٽا	kʰˈʌʈaː
ڪالاباغ	kˌaːlaːbˈaːɣ
ڪرين	kərˈiːn
ڪعب	kˈaːb
ڪماري	kəmˈaːri
ڪمپنيون	kˌəmpənjˈoːn
ڪنفيڊريشن	kˌənfˌiːɖriʃˈʌn
ڪنواري	kənʋˈaːri
ڪنگراڻي	kˌənɡərˈaːɳi
ڪوئلو	koːˈɪloː
ڪوئپر	koːˈɪpər
ڪورائي	koːrˈaːi
ڪونھي	kˈoːnhi
ڪوه	kˈoːh
ڪوڪ	kˈoːk
ڪيريبين	kˌeːribˈiːn
ڪيلي	kˈeːli
ڪيمسٽري	kˌeːməsəʈˈʌri
ڪينجھر	kˌeːnəɟəhˈʌr
ڪٽيل	kˈʌʈjal
ڪچهريون	kˌəcəhərjˈoːn
ڪڍيائين	kˌəɖʰjaːˈiːn
گاني	ɡˈaːni
گرفتاري	ɡˈɪrɪftˌaːri
گلي	ɡˈʌli
گندي	ɡˈʌndi
گهميل	ɡəhˈʌmjal
گهوٽڪي	ɡˌəhoːʈˈʌki
گهڙيال	ɡˌəhər.jˈaːl
گوشه	ɡoːʃˈʌh
گولن	ɡoːlˈʌn
گولڊن	ɡˌoːləɖˈʌn
گوڪل	ɡoːkˈʌl
گيڙو	ɡˈeːr.oː
گڻ	ɡˈʌɳ
ڳوڙهين	ɡˌoːr.hˈiːn
ھاجرہ	hˌaːɟərˈʌh
ھلائي	həlˈaːi
ھلڻ	həlˈʌɳ
ھند	hˈʌnd
ھول	hˈoːl
ھير	hˈeːr
ھڪجھڙائي	hˌəkəɟˌəhr.ˈaːi
آئلينڊز	ˌaːɪlinɖˈʌz
آجو	ˈaːɟoː
آخرين	ˌaːxrˈiːn
آرپار	ˌaːrpˈaːr
آرڊيننس	ˌaːrɖinˈʌns
آمدرفت	ˌaːmədˌərəfˈʌt̪
آگرو	aːɡˈʌroː
ائٽلانٽڪ	ˌaʈlˌaːnəʈˈʌk
ابراھيم	ˌabraːhˈiːm
ابوالفضل	abʋˈaːləfˌəzəl
اترپرديش	ˌat̪ərˌəprdˈiːʃ
اتساهه	ˌat̪saːhˈʌh
اذان	azˈaːn
ازبڪستان	ˌazəbˌəkˈɪstaːn
استعفي	ast̪ˈaːfi
اسدالله	ˌasdˌaːləlˈʌh
اسڪالرشپ	ˌaskˌaːlərəʃˈʌp
اشتهار	ˌɪʃtɪhˈaːr
اصحابي	ˌaʂhaːbˈiː
اصلوڪن	ˌaʂloːkˈʌn
اصولي	ʊʂˈuːli
اطمينان	ˌatminˈaːn
افاديت	ˌafaːdˈiːt̪
افتخار	ˌɪftɪxˈaːr
الحال	ˌalhˈaːl
الفا	alˈʌfaː
الفضل	ˌaləfəzˈʌl
اللو	alˈʌloː
الهامي	ˌalhˈaːmi
الھيار	ˌalhjˈaːr
انتشار	ˌɪntɪʃˈaːr
اندلس	ˌandəlˈʌs
انفرا	ˌanəfˈʌraː
انومان	ˌanoːmˈaːn
اهتمام	ˌahət̪mˈaːm
اهنسا	ahˈʌnsaː
اوس	ˈuːs
اوندهه	ˌuːndəhˈʌh
اونھي	ˈuːnhi
ايسوسيئيٽ	ˌeːsoːsiˈiːʈ
ايسڊ	eːsˈʌɖ
ايشياٽڪ	ˌeːʃjaːʈˈʌk
ايماندار	ˌeːmaːndˈaːr
اينڊروئيڊ	ˌeːnɖəroːˈiːɖ
ايٽمن	ˌeːʈəmˈʌn
ايپل	eːpˈʌl
ايٿوپيا	eːtʰˈoːpjaː
ايڊيشنل	ˌeːɖiʃənˈʌl
ايڌي	ˈeːdʰi
ايڪ	ˈeːk
ايڪس	eːkˈʌs
ايڪي	ˈeːki
اٽل	aʈˈʌl
اڀو	ˈabʰoː
اڀي	ˈabʰi
اچيو	ˈacjoː
اڇن	acʰˈʌn
اڪادمي	ˌakaːdˈʌmi
اڻبڻت	ˌaɳəbəɳˈʌt̪
ایک	ˈeːkʰ
بائيٽ	bˈaːiʈ
بادشاھتون	bˈaːdʃˌaːht̪ˌoːn
بادشاھن	bˈaːdʃˌaːhən
بارگاهه	bˈaːrɡˌaːhəh
بانيڪار	bˈaːnikˌaːr
بانيڪارن	bˈaːnikˌaːrən
بخشڻ	bˌəxəʃˈʌɳ
بخوبي	bˌəxoːbˈiː
بدعت	bədˈaːt̪
برادرس	bˌəraːdərˈʌs
برتري	bˌərət̪ˈʌri
بطوطا	bətˈoːtaː
بعض	bˈaːz
بـ	bˈeːlˈetəcʰˈahacˈaːrbˈʊr.i
بليدي	bəlˈiːdi
بوٽ	bˈoːʈ
بيانن	bjˈaːnən
بينظيرآباد	bˈeːnʐˌiːraːbˈaːd
بينگ	bˈeːnɡ
بڪين	bəkˈiːn
بگاڙ	bəɡˈaːr.
بگهڙ	bˌəɡəhˈʌr.
بڻايائين	bˌəɳaːjaːˈiːn
بھاولپور	bˌəhaːˌoːlpˈoːr
تاحيات	t̪ˌaːhiˈaːt
تبتي	t̪əbˈʌt̪i
تجزئي	t̪ˌəɟəzˈʌi
تجنيس	t̪ˌəɟnˈiːs
تذڪرن	t̪ˌəzəkərˈʌn
ترديد	t̪ərdˈiːd
ترڪستان	t̪ˌərəkˈɪstaːn
تقاضا	t̪əqˈaːzaː
تمر	t̪əmˈʌr
توجھ	t̪oːɟˈʌh
تکو	t̪ˈʌkʰoː
تڪڙ	t̪əkˈʌr.
تھذيبن	t̪ˌəhzibˈʌn
ثنا	sˈʌnaː
جاگرافيدان	ɟˌaːɡrˌaːfidˈaːn
جبران	ɟˌəbrˈaːn
جذبا	ɟˌəzbˈaː
جرنيل	ɟərˈʌnjal
جسمم	ɟˌəsəmˈʌm
جسڪاڻي	ɟˌəskˈaːɳi
جليل	ɟˈʌljal
جماليات	ɟˌəmaːliˈaːt
جنون	ɟənˈoːn
جنيوا	ɟˈʌnjʋaː
جهرڪن	ɟˌəhərəkˈʌn
جهم	ɟəhˈʌm
جوڊيشل	ɟˌoːɖiʃˈʌl
جوڙيندو	ɟoːr.ˈiːndoː
جيتريون	ɟˌeːt̪rjˈoːn
جڳهہ	ɟˌəɡəhˈʌh
جھانگير	ɟˌəhaːnɡˈiːr
حاجب	haːɟˈʌb
حالانڪ	hˌaːlaːnˈʌk
حسد	həsˈʌd
حفاظتي	hˌəfaːʐˈʌt̪i
حفظ	həfˈʌʐ
خاصو	xˈaːʂoː
خانقاه	xˌaːnqˈaːh
خبردار	xˌəbrdˈaːr
خدائن	xˌədaːˈɪn
خنساء	xˈʌnsaː
خواجن	xʋaːɟˈʌn
خيالات	xjˌaːlˈaːt
دائم	daːˈɪm
دراز	dərˈaːz
دوڙ	dˈoːr.
دينيات	dˌeːniˈaːt
دھشلا	dˌəhəʃˈʌlaː
ذڪريا	zəkˈʌrjaː
رئفلس	rˌəfəlˈʌs
رائس	raːˈɪs
ربذه	rˌəbəzˈʌh
رجسٽرار	rˌəɟəsˌəʈrˈaːr
رخصت	rˈʊxʂət̪
رشتا	rˈʌʃt̪aː
رضاڪار	rˌəzaːkˈaːr
رغبت	rˌəɣəbˈʌt̪
رهايو	rəhˈaːjoː
رو	rˈoː
ريج	rˈeːɟ
رٿيل	rˈʌtʰjal
رڪ	rˈʌk
رڪني	rəkˈʌni
رڳ	rˈʌɡ
زناني	zənˈaːni
زهري	zəhˈʌri
زيوس	zjˈoːs
سائل	saːˈɪl
سامراجي	sˌaːmrˈaːɟi
سراسر	sˌəraːsˈʌr
سرمائيدارن	sˌərmˌaːidaːrˈʌn
سروسز	sˌəroːsˈʌz
سرڪٽ	sˌərəkˈʌʈ
سعدي	sˈaːdi
سلمه	sˌələmˈʌh
سليس	səlˈiːs
سماچار	sˌəmaːcˈaːr
سمجهايو	sˌəməɟhˈaːjoː
سموادي	səmʋˈaːdi
سمون	səmˈoːn
سنڌيت	sɪndhˈiːt̪
سوارن	sʋaːrˈʌn
سودا	sˈoːdaː
سوڍو	sˈoːɖʰoː
سوڍي	sˈoːɖʰi
سيمي	sˈeːmi
سيکارڻ	sˌeːkʰaːrˈʌɳ
سٺيون	səʈʰjˈoːn
سٿين	sətʰˈiːn
سڌار	sədʰˈaːr
سڏائين	sˌəɖaːˈiːn
سڏايو	səɖˈaːjoː
سگهيون	sˌəɡhjˈoːn
سگھيا	sˈʌɡʰjaː
شارٽ	ʃaːrˈʌʈ
شاھد	ʃaːhˈʌd
شبد	ʃəbˈʌd
شعاع	ʃˈaːaː
شناخت	ʃənˈaːxt̪
شيدي	ʃˈeːdi
شڪاگو	ʃəkˈaːɡoː
شھباز	ʃˌəhbˈaːz
شھتيرن	ʃˌəht̪irˈʌn
صحارا	ʂəhˈaːraː
صليبي	ʂˌəlibˈiː
صورتخطي	ʂˌoːrət̪əxˈʌti
طباعت	təbˈaːaːt̪
طرفدار	tˌərəfdˈaːr
طواف	tʋˈaːf
طوھر	toːhˈʌr
عبدالقيوم	ˌabdˌaːlqjˈoːm
علاؤالدين	ˌalaːˌa͡ʊaːldˈiːn
عمدا	amˈʌdaː
عيب	aˈiːb
عينيه	ˌainˈiːh
غيرجانبدار	ɣˌeːrɟˈaːnɪbdˌaːr
فتحن	fˌət̪əhˈʌn
فحش	fəhˈʌʃ
فرمانبرداري	fˌərmˌaːnbərdˈaːri
فرنيچر	fˌərnicˈʌr
فرياد	fərjˈaːd
فقهه	fˌəqəhˈʌh
فقيري	fəqˈiːri
فورسز	fˌoːrəsˈʌz
فيسٽيول	fˌeːsʈjˈoːl
قافلو	qaːfˈʌloː
قاهره	qˌaːhərˈʌh
قبوليو	qəbˈoːljoː
قدس	qədˈʌs
قراقرم	qˌəraːqərˈʌm
قطع	qˈʌtaː
قميص	qəmˈiːʂ
قنوج	qənˈoːɟ
قومپرستي	qˌoːmpərˈʌst̪i
لائيٽ	laːˈiːʈ
لازوال	laːzʋˈaːl
لافاني	laːfˈaːni
لاڳاتار	lˌaːɡaːt̪ˈaːr
لتاڙي	lət̪ˈaːr.i
لطيفي	lətˈiːfi
لغارين	lˌəɣaːrˈiːn
لهن	ləhˈʌn
لوهار	loːhˈaːr
لٽي	lˈʌʈi
لڌل	lədʰˈʌl
مائٽي	mˈaːʈi
ماديت	maːdˈiːt̪
مالش	maːlˈʌʃ
مايي	mˈaːji
ماڻيندڙ	mˌaːɳindˈʌr.
ماھرين	mˌaːhrˈiːn
ماھوار	maːhʋˈaːr
مجلسون	mˌəɟəlsˈoːn
محاوري	mˌəhaːˈoːri
محڪمي	mˌəhəkˈʌmi
مخفف	mʊxˈaffaf
مدرس	mˌədərˈʌs
مراٺي	mərˈaːʈʰi
مرحلا	mˌərəhˈʌlaː
مرهٽن	mˌərəhəʈˈʌn
مزدوري	mˌəzdˈuːri
مشروب	mˌəʃrˈuːb
مصنوعات	mˌəʂnʋˈaːt̪
مطلع	mətˈʌlaː
مظھر	mˌəʐəhˈʌr
معاملات	mˌaːməlˈaːt
معبود	maːbˈoːd
معذور	maːzˈoːr
معراج	maːrˈaːɟ
معروضي	maːrˈoːzi
معصومي	maːʂˈoːmi
معلم	maːlˈʌm
مغيره	mˌəɣirˈʌh
مفعول	mˌəfaːˈoːl
مفڪرن	mˌəfəkərˈʌn
مفھوم	mˌəfhˈuːm
مقدما	mʊqˈadmaː
ملاحن	mˌəlaːhˈʌn
ملت	məlˈʌt̪
ململ	mˌələmˈʌl
منات	mˌənˈaːt
منجھس	mˌənəɟəhˈʌs
منش	mənˈʌʃ
منصوري	mˌənʂˈuːri
منٽو	mənˈʌʈoː
مهذب	mˌəhəzˈʌb
موج	mˈoːɟ
مودودي	moːdˈoːdi
موهي	mˈoːhi
موھن	moːhˈʌn
ميرا	mˈeːraː
ميسوپوٽيميا	mˌeːsoːpoːʈˈiːmjaː
مٺڻ	məʈʰˈʌɳ
مٽجي	məʈˈʌɟi
مڃائي	məɲˈaːi
مڌيا	mˈʌdʰjaː
نئيون	nəjˈoːn
نارايڻ	nˌaːraːˈiːɳ
نافرماني	nˌaːfərmˈaːni
ناٺي	nˈaːʈʰi
نتاشا	nət̪ˈaːʃaː
نرمي	nərˈʌmi
نستعليق	nˌəst̪aːlˈiːq
نشيني	nəʃˈiːni
نصابي	nˌəʂaːbˈiː
نظرداري	naʐˈardaːrˌiː
نظرن	naʐˈarn
نفعي	nəfˈaːi
نقطا	nəqˈʌtaː
نويسن	nʋeːsˈʌn
نوڪريون	nˌoːkrjˈoːn
نيوزيلينڊ	njˌoːzilˈiːnɖ
نيوڪليائي	njˌoːkljˈaːi
نڪو	nˈʌkoː
هالائي	haːlˈaːi
هدايتڪاري	hˌədaːˌiːt̪kˈaːri
هنگلاج	hˌənɡəlˈaːɟ
هيڪاري	heːkˈaːri
هيڪٽر	hˌeːkəʈˈʌr
هٽلر	hˌəʈəlˈʌr
وادين	ʋaːdˈiːn
واسديو	ʋaːsˈʌdjoː
وجهبو	ʋˌəɟəhəbˈoː
ورج	ʋərˈʌɟ
ورزي	ʋərˈʌzi
وعظ	ʋˈaːʐ
وقوع	ʋˈʌquː
وليج	ʋəlˈiːɟ
ونگن	ʋənɡˈʌn
وهنجڻ	ʋˌəhənəɟˈʌɳ
ويجھ	ʋeːɟˈʌh
ويلنٽائن	ʋˌeːlənʈaːˈɪn
ويٽنامي	ʋˌeːʈnˈaːmi
وٺرائڻ	ʋˌəʈʰraːˈɪɳ
وٺنديون	ʋˌəʈʰndjˈoːn
وڄي	ʋˈʌɟi
وڌن	ʋədʰˈʌn
وڌيا	ʋˈʌdʰjaː
وک	ʋˈʌkʰ
وڳڻ	ʋəɡˈʌɳ
يرقان	jˌərqˈaːn
يني	jˈʌni
ٺاهيندي	ʈʰaːhˈiːndi
ٺهرائڻ	ʈʰˌəhəraːˈɪɳ
ٺڪراٺو	ʈʰˌəkrˈaːʈʰoː
ٺھندا	ʈʰəhˈʌndaː
ٺھندو	ʈʰəhˈʌndoː
ٺھيو	ʈʰˈʌhjoː
ٻاجهري	bˌaːɟəhˈʌri
ٻاهرئين	bˌaːhərˈiːn
ٻري	bˈʌri
ٻرڻ	bərˈʌɳ
ٻنيون	bənjˈoːn
ٻهراڙي	bˌəhərˈaːr.i
ٻيجل	beːɟˈʌl
ٻيڻي	bˈeːɳi
ٻڌائيندي	bˌədʰaːˈiːndi
ٽائمز	ʈˌaːɪmˈʌz
ٽاڪرو	ʈaːkˈʌroː
ٽري	ʈˈʌri
ٽيمپل	ʈeːmpˈʌl
پ	pˈeː
پائليٽ	pˌaːɪlˈiːʈ
پائونڊن	pˌaːoːnɖˈʌn
پائيندو	paːˈiːndoː
پانيلن	pˌaːnilˈʌn
پانڌي	pˈaːndʰi
پاڻهئي	pˌaːɳəhˈʌi
پختي	pˈʌxt̪i
پربت	pˌərəbˈʌt̪
پرديس	pərdˈiːs
پرستن	pˌərəst̪ˈʌn
پرنسلي	pˌərənsˈʌli
پرنٽر	pˌərənəʈˈʌr
پريفيڪچر	pˌərifˌiːkəcˈʌr
پسندن	pˌəsəndˈʌn
پلاڻ	pəlˈaːɳ
پمفليٽ	pˌəməflˈiːʈ
پناه	pənˈaːh
پهچندا	pˌəhəcˈʌndaː
پورب	poːrˈʌb
پورن	poːrˈʌn
پوڙهو	poːr.ˈʌhoː
پيئجي	peːˈɪɟi
پيتو	pˈeːt̪oː
پيرا	pˈeːraː
پيغمبرن	pˌeːɣəmbərˈʌn
پيڙهي	peːr.ˈʌhi
پٹ	pˈʌʈ
پٽڙو	pəʈˈʌr.oː
پٿريلي	pˌəʈrˈiːli
پگهر	pˌəɡəhˈʌr
پیدا	pˈeːdaː
ٿوهر	tʰoːhˈʌr
ڀائيچارو	bʰˌaːicˈaːroː
ڀائٽي	bʰˈaːʈi
ڀرائي	bʰərˈaːi
ڀريون	bʰərjˈoːn
ڀل	bʰˈʌl
ڀي	bʰˈeː
ڀيلن	bʰeːlˈʌn
ڀيم	bʰˈeːm
ڀڃڪڙي	bʰˌəɲəkˈʌr.i
ڀڳوت	bʰəɡˈoːt̪
ڄاڙي	ɟˈaːr.i
ڄاڻندو	ɟaːɳˈʌndoː
ڄمائي	ɟəmˈaːi
ڄڻڪ	ɟəɳˈʌk
چارڻن	cˌaːrəɳˈʌn
چاهيان	caːhjˈaːn
چاڙهه	cˌaːr.əhˈʌh
چرخي	cərˈʌxi
چرين	cərˈiːn
چشم	cəʃˈʌm
چوندي	cˈoːndi
چيون	cjˈoːn
ڇنڊ	cʰˈʌnɖ
ڇٽ	cʰˈʌʈ
ڇپرائي	cʰˌəprˈaːi
ڇڊي	cʰˈʌɖi
ڇڪجي	cʰəkˈʌɟi
ڊائريا	ɖaːˈɪrjaː
ڊائريڪٽوريٽ	ɖˌaːɪrˌiːkʈoːrˈiːʈ
ڊاهي	ɖˈaːhi
ڊسپينسري	ɖˌəspinsˈʌri
ڊفينس	ɖəfˈiːns
ڊڪ	ɖˈʌk
ڌاڳن	dʰaːɡˈʌn
ڌمڪي	dʰəmˈʌki
ڏاڏا	ɖˈaːɖaː
ڏاڪي	ɖˈaːki
ڏجين	ɖəɟˈiːn
ڏسجن	ɖˌɪsəɟˈʌn
ڏسندڙ	ɖˌɪsəndˈʌr.
ڏنگ	ɖˈʌnɡ
ڏوهن	ɖoːhˈʌn
ڏيکاريندا	ɖˌeːkʰaːrˈiːndaː
ڏھون	ɖəhˈoːn
ڙي	r.ˈeː
ڦاهي	pʰˈaːhi
ڦڙا	pʰˈʌr.aː
کائجن	kʰˌaːɪɟˈʌn
کلون	kʰəlˈoːn
کوجنائون	kʰˌoːɟnaːˈoːn
کوٽيل	kʰˈoːʈjal
کوٽڻ	kʰoːʈˈʌɳ
کوپڙي	kʰoːpˈʌr.i
کٻي	kʰˈʌbi
کپري	kʰəpˈʌri
کڏن	kʰəɖˈʌn
ڪارگل	kˌaːrəɡˈʌl
ڪاف	kˈaːf
ڪالا	kˈaːlaː
ڪامورن	kˌaːmoːrˈʌn
ڪانڀو	kaːnˈʌbʰoː
ڪانگن	kaːnɡˈʌn
ڪاڻ	kˈaːɳ
ڪبا	kəbˈaː
ڪتابڙو	kˌɪtaːbˈʌr.oː
ڪرسمس	kˌərəsəmˈʌs
ڪرڻن	kˌərəɳˈʌn
ڪشنچند	kˌəʃəncˈʌnd
ڪفايت	kˌəfaːˈiːt̪
ڪلراٺي	kˌəlrˈaːʈʰi
ڪلھوڙي	kˌəlhˈuːr.i
ڪمپيوٽنگ	kˌəmpjoːʈˈʌnɡ
ڪهي	kˈʌhi
ڪوانٽم	kʋˌaːnəʈˈʌm
ڪورٽون	kˌoːrʈˈoːn
ڪون	kˈoːn
ڪوٺين	koːʈʰˈiːn
ڪوٽا	kˈoːʈaː
ڪوڏي	kˈoːɖi
ڪوڪا	kˈoːkaː
ڪيرائڻ	kˌeːraːˈɪɳ
ڪيسن	keːsˈʌn
ڪيٿائيئرليخ	kˌeːtʰaːiˈɪrlˌiːx
ڪيڏي	kˈeːɖi
ڪپي	kˈʌpi
ڪٿائون	kˌətʰaːˈoːn
ڪڍبو	kˌəɖʰbˈoː
گائيڊ	ɡaːˈiːɖ
گارڊن	ɡˌaːrəɖˈʌn
گذارش	ɡˌəzaːrˈʌʃ
گرمکي	ɡˌərəmˈʌkʰi
گروه	ɡərˈoːh
گري	ɡˈʌri
گرڊرن	ɡˌərəɖərˈʌn
گمنام	ɡˌəmnˈaːm
گنجي	ɡənˈʌɟi
گندگي	ɡəndˈʌɡi
گهوٽالي	ɡˌəhoːʈˈaːli
گهڙڻ	ɡˌəhər.ˈʌɳ
گورڪي	ɡoːrˈʌki
گوپانگ	ɡoːpˈaːnɡ
گپتا	ɡəpˈʌt̪aː
گھرڙيائي	ɡʰˌərr.jˈaːi
گھمڻ	ɡʰəmˈʌɳ
ڳائو	ɡˈaːoː
ڳنڍجي	ɡˌənəɖʰˈʌɟi
ڳولهي	ɡoːlˈʌhi
ڳولهڻ	ɡˌoːləhˈʌɳ
ڳڙ	ɡˈʌr.
ڳڻ	ɡˈʌɳ
ھارون	haːrˈoːn
ھرھڪ	hˌərəhˈʌk
ھميشھ	hˌəmiʃˈʌh
ھنر	hənˈʌr
ھيس	hˈeːs
ھڏڪيون	hˌəɖkjˈoːn
ھڻي	hˈʌɳi
آئرس	ˌaːɪrˈʌs
آئزڪ	ˌaːɪzˈʌk
آئنسٽائن	ˌaːɪnsˌəʈaːˈɪn
آئيس	aːˈiːs
آئيوري	aːjˈoːri
آبائي	aːbˈaːi
آزار	aːzˈaːr
آهوجا	aːhˈoːɟaː
آپ	ˈaːp
آڊيشن	ˌaːɖiʃˈʌn
ابدالي	ˌabdˈaːli
اتهاسن	ˌat̪haːsˈʌn
اثرات	ˌasərˈaːt
اجتماع	ɪɟtˈɪmaː
احد	ˈɛhd
ادل	adˈʌl
اربن	ˌarəbˈʌn
اربين	ˌarbˈiːn
ارتسخ	ˌɪrtɪsˈʌx
ارڙ	arˈʌr.
استحڪام	ˌɪstɛhkˈaːm
اسراڻ	ˌasrˈaːɳ
اسٽائيل	ˌasʈˈaːjal
اسٽيشنن	ˌasʈˌiːʃənˈʌn
اسپتالون	ˌasəpt̪aːlˈoːn
اسڪين	ˌaskˈiːn
اعتدال	ˌeːtɪdˈaːl
افغانن	ˌafɣaːnˈʌn
افقي	afˈʌqi
اقليتي	ˌaqlˈiːt̪i
الائي	alˈaːi
الحسين	ˌaləhsˈiːn
الهاس	ˌalhˈaːs
امامن	ˌamaːmˈʌn
امروٽ	ˌamrˈoːʈ
انر	anˈʌr
انناس	ˌannˈaːs
انڊلٺ	ˌɪnɖəlˈʌʈʰ
انڌي	ˈandʰi
اولاهين	ˌuːlaːhˈiːn
اوليت	uːlˈiːt̪
اوڏن	uːɖˈʌn
ايبرڊين	ˌeːbərɖˈiːn
ايبڪ	eːbˈʌk
ايسرداس	ˌeːsrdˈaːs
اينجلس	ˌeːnəɟəlˈʌs
ايوڌيا	eːˈoːdʰjaː
اچارن	ˌacaːrˈʌn
اگرچ	aɡˈʌrc
اھل	ahˈʌl
بااثر	bˈaːaːsˌər
بابو	bˈaːbˈoː
بارڪ	bˈaːrək
باطن	bˈaːtən
باقائده	bˈaːqaːˌɪdəh
بانسري	bˈaːnsərˌiː
بدرآن	bˌədrˈaːn
بدل	bədˈʌl
بدليل	bədˈʌljal
بدو	bˈʌdoː
براهوي	bərˈaːhʋi
برطانيائي	bˌərtaːnjˈaːi
برقعو	bˌərqˈaːoː
برلن	bˌərəlˈʌn
برهمڻي	bˌərəhəmˈʌɳi
بسنت	bˌəsənˈʌt̪
بشارت	bˌəʃaːrˈʌt̪
بمباري	bəmbˈaːri
بمطابق	bˌəmtaːbˈʌq
بيابان	bjˈaːbˈaːn
بيلي	bˈeːli
بيهاري	bˈeːhaːrˌiː
بيهاريو	bˈeːhaːrjˌoː
بيهوش	bˈeːhoːʃ
بيٺڪي	bˈeːʈʰkˌiː
بٽالين	bˌəʈaːlˈiːn
بچو	bˈʌcoː
بھی	bˈʌhi
تابع	t̪aːbˈeː
تاجل	t̪aːɟˈʌl
تاجڪ	t̪aːɟˈʌk
تاجڪستان	t̪ˌaːɟəkˈɪstaːn
تاڪن	t̪aːkˈʌn
تبسم	t̪ˌəbəsˈʌm
تختن	t̪əxt̪ˈʌn
تخمينو	t̪ˌəxmˈiːnoː
تراب	t̪ərˈaːb
تقريبا	t̪ˌəqribˈaː
تل	t̪ˈʌl
تلاوت	t̪ˌəlaːˈoːt̪
تلخ	tˈalx
تمنا	t̪əmˈʌnaː
تنظيمي	t̪ˌənʐˈiːmi
توري	t̪ˈoːri
توريت	t̪oːrˈiːt̪
تڪن	t̪əkˈʌn
جاڳندي	ɟaːɡˈʌndi
جبريت	ɟˌəbrˈiːt̪
جراثيم	ɟˌəraːsˈiːm
جلندر	ɟˌələndˈʌr
جلي	ɟˈʌli
جمالو	ɟəmˈaːloː
جهرڪ	ɟˌəhərˈʌk
جهول	ɟəhˈoːl
جهولي	ɟəhˈoːli
جهڪر	ɟˌəhəkˈʌr
جوهري	ɟoːhˈʌri
جوڙايل	ɟoːr.ˈaːjal
جوڙيندڙ	ɟˌoːr.indˈʌr.
جيسينا	ɟeːsˈiːnaː
جيوڙا	ɟjˈoːr.aː
جپاني	ɟəpˈaːni
جڳهن	ɟˌəɡəhˈʌn
جھنڊي	ɟəhˈʌnɖi
حاجن	haːɟˈʌn
حبشي	həbˈʌʃi
حفص	həfˈʌʂ
حلقا	həlˈʌqaː
خارجه	xˌaːrəɟˈʌh
خاطري	xaːtˈʌri
خام	xˈaːm
خديجه	xˌədiɟˈʌh
خرابين	xˌəraːbˈiːn
خفيه	xəfˈiːh
خميسو	xəmˈiːsoː
خوابن	xʋaːbˈʌn
خواجہ	xʋaːɟˈʌh
دؤرن	dˌəa͡ʊrˈʌn
دالان	daːlˈaːn
داٻ	dˈaːb
درياخان	dˌərjaːxˈaːn
درٻارين	dˌərbaːrˈiːn
درگا	dərˈʌɡaː
دشت	dˈʌʃt̪
دفتري	dˌəfət̪ˈʌri
دليون	dəljˈoːn
دوربين	dˌoːrbˈiːn
ديدار	deːdˈaːr
ديندار	deːndˈaːr
ذهنن	zˌəhənˈʌn
ذي	zˈeː
ذھني	zəhˈʌni
رابطا	raːbˈʌtaː
رابن	raːbˈɪn
راقم	raːqˈʌm
راڄن	raːɟˈʌn
راڄڙ	raːɟˈʌr.
راڻا	rˈaːɳaː
رسا	rˈʌsaː
رسوخ	rəsˈoːx
رشد	rəʃˈʌd
رفته	rˈafəth
رنڊڪ	rənɖˈʌk
رورل	roːrˈʌl
روغن	roːɣˈʌn
رولنگ	roːlˈʌnɡ
روٽي	rˈoːʈi
ريحان	reːhˈaːn
ريزڪي	reːzˈʌki
ريلي	rˈeːli
ريڪجاويڪ	rˌeːkɟaːʋˈiːk
رپورٽن	rˌəpoːrəʈˈʌn
رٿون	rətʰˈoːn
رڪجي	rəkˈʌɟi
رھنمائي	rˌəhənmˈaːi
زاهد	zaːhˈʌd
زرخيزي	zˌərxˈiːzi
زلزلو	zˌalzˈaloː
زنجبار	zˌənəɟbˈaːr
سائٽ	sˈaːʈ
ساراھ	saːrˈaːh
سازگار	sˌaːzɡˈaːr
ساڙڻ	saːr.ˈʌɳ
ساڳيون	saːɡjˈoːn
سجدو	səɟˈʌdoː
سجدي	səɟˈʌdi
سختيون	səxt̪jˈoːn
سرجن	sˌərəɟˈʌn
سرس	sərˈʌs
سرشتن	sˌərəʃt̪ˈʌn
سرمايي	sˌərmˈaːji
سرپرست	sˌərəpərˈʌst̪
سرگس	sˌərəɡˈʌs
سس	sˈʌs
سفرناما	sˌəfərnˈaːmaː
سلمان	sˌəlmˈaːn
سلو	sˈʌloː
سمجهندي	sˌəməɟəhˈʌndi
سمجهون	sˌəməɟhˈoːn
سميجو	səmˈiːɟoː
سمپورن	sˌəmpuːrˈʌn
سندري	səndˈʌri
سنهري	sˌənəhˈʌri
سنهڙو	sˌənəhˈʌr.oː
سنوارڻ	sˌənʋaːrˈʌɳ
سنگتي	sənɡˈʌt̪i
سنگر	sənɡˈʌr
سهرو	səhˈʌroː
سهولتن	sˌəhoːlət̪ˈʌn
سوء	sˈoː
سوئي	sˈoːi
سوات	sʋˈaːt̪
سودو	sˈoːdoː
سوراشٽر	sˌoːraːʃəʈˈʌr
سونپيو	sˈoːnpjoː
سوڙهي	soːr.ˈʌhi
سيمينارن	sˌeːminaːrˈʌn
سينگاريو	seːnɡˈaːrjoː
سيوهاڻي	sjoːhˈaːɳi
سيوھڻ	sjoːhˈʌɳ
سيکاٽ	seːkʰˈaːʈ
سيڪس	seːkˈʌs
سيڪڙي	seːkˈʌr.i
سپ	sˈʌp
سپڙ	səpˈʌr.
سڌارو	sədʰˈaːroː
سڌين	sədʰˈiːn
سڏيندو	səɖˈiːndoː
سگھڙ	səɡʰˈʌr.
سھارو	səhˈaːroː
شائر	ʃaːˈɪr
شاهجهاني	ʃˌaːhəɟhˈaːni
شاگردياڻي	ʃˌaːɡrdjˈaːɳi
شاھپور	ʃˌaːhpˈoːr
شرم	ʃərˈʌm
شمع	ʃˈʌmaː
شهريار	ʃˌəhərjˈaːr
شهريت	ʃˌəhərˈiːt̪
شهنشاهت	ʃˌəhənʃaːhˈʌt̪
شودر	ʃoːdˈʌr
شيو	ʃjˈoː
شڌ	ʃˈʌdʰ
شھرت	ʃˌəhərˈʌt̪
صحيون	ʂəhjˈoːn
صدف	ʂədˈʌf
صفي	ʂˈʌfi
صليب	ʂəlˈiːb
صہ	ʂˈʌh
ضابطن	zˌaːbətˈʌn
ضخيم	zəxˈiːm
طبقا	təbˈʌqaː
طرفي	tərˈʌfi
طهر	təhˈʌr
ظاھري	ʐaːhˈʌri
عبدالحفيظ	ˌabdˌaːləhfˈiːʐ
عبدالوهاب	ˌabdˌaːloːhˈaːb
عشرت	ˌaʃərˈʌt̪
عصمت	ˌaʂəmˈʌt̪
عقيل	ˈaqjal
عهدنامي	ˌahədnˈaːmi
غدار	ɣədˈaːr
غداري	ɣədˈaːri
غرض	ɣərˈʌz
غلبي	ɣˌəlbˈiː
غلطين	ɣˌəltˈiːn
فاتحن	fˌaːt̪əhˈʌn
فاسفورس	fˌaːsfoːrˈʌs
فرضن	fˌərəzˈʌn
فريسڪو	fˌərisˈʌkoː
فضول	fəzˈoːl
فلسفين	fˌələsfˈiːn
فلپ	fəlˈʌp
قبرص	qˌəbərˈʌʂ
قفقاز	qˌəfqˈaːz
قلندري	qˌələndˈʌri
لائبيريا	lˌaːɪbˈiːrjaː
لاري	lˈaːri
لاشعور	lˌaːʃaːˈoːr
لاڏائو	laːɖˈaːoː
لاڏاڻي	laːɖˈaːɳi
لاگ	lˈaːɡ
لب	lˈʌb
لبيا	ləbjˈaː
لنڪن	lˌənəkˈʌn
لهجا	ləhˈʌɟaː
ليڪا	lˈeːkaː
لٽجي	ləʈˈʌɟi
لڙايون	lˌər.aːjˈoːn
لکتون	lˌəkʰt̪ˈuːn
لڪائڻ	lˌəkaːˈɪɳ
لڳائيندا	lˌəɡaːˈiːndaː
لڳڀڳ	lˌəɡəbʰˈʌɡ
لھجو	ləhˈʌɟoː
لھجي	ləhˈʌɟi
مائيڪل	mˌaːikˈʌl
مات	mˈaːt̪
ماحوليات	mˌaːhoːliˈaːt
ماريندا	maːrˈiːndaː
ماريندڙ	mˌaːrindˈʌr.
مارٽن	mˌaːrəʈˈʌn
ماڊرن	mˌaːɖərˈʌn
متاع	mˈʌt̪aː
مجاهدين	mˌəɟaːhədˈiːn
محاصرو	mˌəhaːʂˈʌroː
محبتي	mˌəhəbˈʌt̪i
محمدي	mˌəhəmˈʌdi
محيط	məhˈiːt
مدير	mədˈiːr
مذڪر	mʊzˈakːar
مرهٺي	mˌərəhˈʌʈʰi
مسیح	mˈʌsih
مشاهدا	mˌəʃaːhˈʌdaː
مشترڪ	mˌəʃt̪ərˈʌk
مشروط	mˌəʃrˈuːt
مشورا	məʃˈoːraː
مطالبي	mʊtˈaːlɪbˌiː
مظاهرن	mˌəʐaːhərˈʌn
معائنو	maːˈɪnoː
معتدل	mˌaːt̪ədˈʌl
معقول	maːqˈoːl
معلوماتي	mˌaːloːmˈaːt̪i
معمار	maːmˈaːr
مقدمن	mʊqˈadmn
ملاڪا	məlˈaːkaː
ملتوي	məlˈʌt̪ʋi
منجهانئن	mˌənəɟhaːnˈʌn
منحصر	mˌənəhəʂˈʌr
مهارن	mˌəhaːrˈʌn
موومينٽ	mʋˌoːminˈʌʈ
موڪليون	mˌoːkljˈoːn
مياڻ	mjˈaːɳ
مينگهواڙ	mˌeːnɡəhʋˈaːr.
مٽر	məʈˈʌr
مٽن	məʈˈʌn
مچي	mˈʌci
مڇر	məcʰˈʌr
مڪتبه	mˌəkət̪əbˈʌh
نااميد	nˌaːaːmˈiːd
نابود	naːbˈoːd
ناريون	naːrjˈoːn
نانو	nˈaːnoː
نسخ	nəsˈʌx
نشاستي	nəʃˈaːst̪i
نفاذ	nəfˈaːz
نفساني	nˌəfsˈaːni
نقص	nəqˈʌʂ
نقصانن	nˌəqʂaːnˈʌn
نقطو	nəqˈʌtoː
نقطي	nəqˈʌti
ننجا	nənˈʌɟaː
نوشهرو	nˌoːʃəhˈʌroː
نوع	nˈuː
نيچ	nˈeːc
نکاد	nəkʰˈaːd
هالي	hˈaːli
هانگ	hˈaːnɡ
هجو	hˈʌɟoː
هروڀرو	hˌəroːbʰˈʌroː
هلنديون	hˌəlndjˈoːn
هليون	həljˈoːn
هندومت	hˌɪnduːmˈʌt̪
هيل	hˈeːl
هيونسانگ	hjoːnsˈaːnɡ
هيٺانهين	hˌeːʈʰaːnhˈiːn
هيگ	hˈeːɡ
هٽ	hˈʌʈ
واعظ	ʋaːˈaːʐ
واڪ	ʋˈaːk
وتايو	ʋət̪ˈaːjoː
وجد	ʋəɟˈʌd
وجدان	ʋˌəɟdˈaːn
وراڻي	ʋərˈaːɳi
ورھين	ʋˌərhˈiːn
وسڪارو	ʋˌəskˈaːroː
وفاداري	ʋˌəfaːdˈaːri
ويزن	ʋeːzˈʌn
ويساک	ʋeːsˈaːkʰ
ويلي	ʋˈeːli
ويٽو	ʋˈeːʈoː
ويڙھاڪ	ʋeːr.hˈaːk
وٺائڻ	ʋˌəʈʰaːˈɪɳ
وچم	ʋəcˈʌm
وڊيوز	ʋəɖjˈoːz
وڏيرا	ʋəɖˈiːraː
وڙھڻ	ʋər.hˈʌɳ
وڪڙن	ʋˌəkər.ˈʌn
ياب	jˈaːb
ياقوت	jaːqˈoːt̪
يونس	jˈoːns
يڪتاري	jˌəkt̪ˈaːri
ٺيڪيدار	ʈʰˌeːkidˈaːr
ٻاجهر	bˌaːɟəhˈʌr
ٻانهون	bˌaːnhˈoːn
ٻانهين	bˌaːnhˈiːn
ٻانھن	bˈaːnhn
ٻاونجاهه	bˌaːoːnɟaːhˈʌh
ٻرن	bərˈʌn
ٻورو	bˈoːroː
ٻوڙا	bˈoːr.aː
ٻيڻو	bˈeːɳoː
ٻٽير	bəʈˈiːr
ٽئڪس	ʈəkˈʌs
ٽنڊوآدم	ʈˌənɖʋaːdˈʌm
ٽنگيل	ʈˈʌnɡjal
ٽورنامينٽ	ʈˌoːrnˌaːminˈʌʈ
ٽوپ	ʈˈoːp
ٽيبل	ʈeːbˈʌl
ٽيليڪاسٽ	ʈˌeːlikaːsˈʌʈ
ٽڙي	ʈˈʌr.i
ٽکڙ	ʈəkʰˈʌr.
ٽڪراء	ʈəkˈʌraː
پئدائش	pˌədaːˈɪʃ
پارٽ	paːrˈʌʈ
پاسيرو	paːsˈiːroː
پالش	paːlˈʌʃ
پاپولر	pˌaːpoːlˈʌr
پاڻيء	pˈaːɳi
پبلڪيشن	pˌəbəlkiʃˈʌn
پتر	pət̪ˈʌr
پتل	pət̪ˈʌl
پختا	pˈʌxt̪aː
پختونخوا	pˌəxt̪uːnˈʌxʋaː
پرتي	pərˈʌt̪i
پرده	pərdˈʌh
پرزائيڊنگ	pˌərzˌaːiɖˈʌnɡ
پرهه	pˌərəhˈʌh
پروسيس	pˌəroːsˈiːs
پروٽو	pərˈoːʈoː
پروڊيوس	pˌəroːɖjˈoːs
پريزيڊنسي	pˌəriziɖˈʌnsi
پلاننگ	pˌəlaːnˈʌnɡ
پمپ	pˈʌmp
پهلوي	pəhˈʌlʋi
پهچن	pˌəhəcˈʌn
پورهيي	poːrˈʌhji
پوسٽل	pˌoːsəʈˈʌl
پوڄيندا	poːɟˈiːndaː
پيالي	pjˈaːli
پيروڪارن	pˌeːroːkaːrˈʌn
پيٽرول	pˌeːʈrˈoːl
پٺ	pˈʌʈʰ
پٽڻ	pəʈˈʌɳ
پپر	pəpˈʌr
پڪڙ	pəkˈʌr.
پھاڙ	pəhˈaːr.
پھچائي	pˌəhcˈaːi
ٿنڀن	ʈˌənəbʰˈʌn
ٿيسز	tʰeːsˈʌz
ڀائٽيو	bʰˈaːʈjoː
ڀاڻس	bʰaːɳˈʌs
ڀريندا	bʰərˈiːndaː
ڀوڏيسر	bʰˌoːɖisˈʌr
ڀڪشو	bʰəkˈʌʃoː
ڄاڻائين	ɟˌaːɳaːˈiːn
ڄيٺ	ɟˈeːʈʰ
ڄيٺانند	ɟˌeːʈʰaːnˈʌnd
چادرون	cˌaːdrˈoːn
چانڊڪي	caːnɖˈʌki
چاچڙ	caːcˈʌr.
چاڙھڻ	caːr.hˈʌɳ
چنبا	cənbˈaː
چورائيندو	cˌoːraːˈiːndoː
چيائينس	cjaːˈiːns
چيتن	ceːt̪ˈʌn
چيلهار	cˌeːlhˈaːr
چيلھ	ceːlˈʌh
چڙهيو	cər.ˈʌhjoː
چڙھي	cˈʌr.hi
چڱن	cˌəŋ̩ˈʌn
ڇلو	cʰˈʌloː
ڇنڇر	cʰˌənəcʰˈʌr
ڇڙوڇڙ	cʰˌər.oːcʰˈʌr.
ڊائريڪشن	ɖˌaːɪrˌiːkəʃˈʌn
ڊرائنگ	ɖˌəraːˈɪnɡ
ڊرگھ	ɖərˈʌɡʰ
ڊويزنل	ɖʋˌeːzənˈʌl
ڊگھا	ɖˈʌɡʰaː
ڌماڪن	dʰˌəmaːkˈʌn
ڌيء	dʰˈeː
ڍولڪ	ɖʰoːlˈʌk
ڏامر	ɖaːmˈʌr
ڏنس	ɖˈʌns
ڏنگي	ɖˈʌnɡi
ڏوھاري	ɖoːhˈaːri
ڏوھن	ɖoːhˈʌn
ڏيتي	ɖˈeːt̪i
ڏڪر	ɖəkˈʌr
ڦريل	pʰˈʌrjal
ڦهلائڻ	pʰˌəhəlaːˈɪɳ
ڦڦڙ	pʰəpʰˈʌr.
ڦڪو	pʰˈʌkoː
کؤنر	kʰˌəa͡ʊnˈʌr
کائن	kʰaːˈɪn
کارائجي	kʰˌaːraːˈɪɟi
کاڌائين	kʰˌaːdʰaːˈiːn
کرج	kʰərˈʌɟ
کري	kʰˈʌri
کلاڙي	kʰəlˈaːr.i
کنئي	kʰənˈʌi
کنڊرن	kʰˌənɖərˈʌn
کوليا	kʰˈoːljaː
کيل	kʰˈeːl
کڏون	kʰəɖˈoːn
کہ	kʰˈʌh
ڪاتب	kaːt̪ˈʌb
ڪاروهنوار	kˌaːroːhənʋˈaːr
ڪاسٽر	kˌaːsəʈˈʌr
ڪالونيون	kˌaːloːnjˈoːn
ڪاميڊي	kaːmˈiːɖi
ڪاڪي	kˈaːki
ڪتبخاني	kˌət̪əbxˈaːni
ڪتو	kˈʌt̪oː
ڪس	kˈʌs
ڪشادي	kəʃˈaːdi
ڪشتو	kˈʌʃt̪oː
ڪلاڪار	kˌəlaːkˈaːr
ڪلثوم	kˌəlsˈuːm
ڪلفٽن	kˌələfəʈˈʌn
ڪلي	kˈʌli
ڪمرو	kəmˈʌroː
ڪنگز	kənɡˈʌz
ڪوئن	koːˈɪn
ڪوتا	kˈoːt̪aː
ڪورنگي	koːrˈʌnɡi
ڪومل	koːmˈʌl
ڪوٺيندا	koːʈʰˈiːndaː
ڪوڏ	kˈoːɖ
ڪوڙا	kˈoːr.aː
ڪيم	kˈeːm
ڪيڙا	kˈeːr.aː
ڪيڪ	kˈeːk
ڪچري	kəcˈʌri
ڪڍندي	kəɖʰˈʌndi
ڪڍيون	kəɖʰjˈoːn
ڪڙيو	kˈʌr.joː
ڪڪڙن	kˌəkər.ˈʌn
گا	ɡˈaː
گائڪي	ɡaːˈɪki
گروئن	ɡˌəroːˈɪn
گرونانڪ	ɡˌəroːnaːnˈʌk
گلان	ɡəlˈaːn
گلستان	ɡˌəlˈɪstaːn
گهاري	ɡəhˈaːri
گهرايل	ɡˌəhərˈaːjal
گهرڙا	ɡˌəhərˈʌr.aː
گهم	ɡəhˈʌm
گهيريل	ɡəhˈiːrjal
گوڏن	ɡoːɖˈʌn
گيلاني	ɡeːlˈaːni
گڏاپ	ɡəɖˈaːp
گڏھ	ɡəɖˈʌh
گھوڙو	ɡʰˈoːr.oː
گھيري	ɡʰˈeːri
گھڙي	ɡʰˈʌr.i
ڳاله	ɡaːlˈʌh
ڳالھھ	ɡˌaːləhˈʌh
ڳنڍيو	ɡənˈʌɖʰjoː
ڳڻي	ɡˈʌɳi
ھاسپيٽل	hˌaːspiʈˈʌl
ھاضمي	haːzˈʌmi
ھلايو	həlˈaːjoː
ھينئر	heːnˈʌr
ھينري	heːnˈʌri
ھڏن	həɖˈʌn
آدرش	ˌaːdərˈʌʃ
آريجا	aːrˈiːɟaː
آرڪڊ	ˌaːrəkˈʌɖ
آفاق	aːfˈaːq
آلات	ˌaːlˈaːt
آندائون	ˌaːndaːˈoːn
آنرري	ˌaːnərˈʌri
آنرس	ˌaːnərˈʌs
آهسته	ˌaːhəst̪ˈʌh
آهنگي	aːhˈʌnɡi
آچاريا	aːcˈaːrjaː
آڏي	ˈaːɖi
آکيري	aːkʰˈiːri
آڱوٺي	ˌaːŋ̩ˈoːʈʰi
ائٽمن	ˌaʈəmˈʌn
ابوالبقا	abʋˈaːləbqaː
ابڙا	abˈʌr.aː
اثرائتو	ˌasraːˈɪt̪oː
اثير	asˈiːr
اجائي	aɟˈaːi
اجايو	aɟˈaːjoː
اجلاسن	ˌaɟlaːsˈʌn
اخباري	ˌaxbˈaːri
اداڪارائن	ˌadaːkˌaːraːˈɪn
ادو	ˈadoː
ارادن	ˌaraːdˈʌn
ارطغرل	ˌarətˌəɣərˈʌl
ارون	arˈoːn
ارڙھن	ˌarər.hˈʌn
ازخود	ˌazxˈoːd
اسرار	ˌasrˈaːr
اسود	asˈoːd
اسپورٽس	ˌaspˌoːrəʈˈʌs
اسٿان	ˌastʰˈaːn
اصفهان	ˌaʂəfhˈaːn
افتتاحي	ˌɪftɪt̪ˈaːhi
الائنس	ˌalaːˈɪns
الاساطير	ˌalaːsaːtˈiːr
الحسن	ˌaləhəsˈʌn
الدوله	ˌaldoːlˈʌh
المال	ˌalmˈaːl
المومنين	ˌalmˌoːmnˈiːn
الهڏنو	ˌaləhəɖˈʌnoː
الوطني	ˌaloːtˈʌni
امريڪا	ˌamrˈiːkaː
املهه	ˌamələhˈʌh
انسائيڪلو	ˌansaːikˈʌloː
انضمام	ˌanəzmˈaːm
انفرميشن	ˌanəfˌərmiʃˈʌn
انقلابن	ˌɪnqɪlaːbˈʌn
انڌو	ˈandʰoː
اورنگ	uːrˈʌnɡ
اوزون	uːzˈoːn
اوسط	uːsˈʌt
اولمپڪ	ˌuːləmpˈʌk
اوٽ	ˈuːʈ
اوچا	ˈuːcaː
ايجنسين	ˌeːɟnsˈiːn
ايندڙن	ˌeːndər.ˈʌn
اينٽلانٽڪ	ˌeːnəʈlaːnəʈˈʌk
ايٽ	ˈeːʈ
ايڊز	eːɖˈʌz
ايڪسچينج	ˌeːkəscinˈʌɟ
ايڪٽر	ˌeːkəʈˈʌr
اٿئي	aʈˈʌi
اڏامڻ	ˌaɖaːmˈʌɳ
اڏايو	aɖˈaːjoː
اڏرڻ	ˌaɖərˈʌɳ
اڻاٺ	aɳˈaːʈʰ
اڻلڀ	ˌaɳəlˈʌbʰ
اڻويھين	ˌaɳʋihˈiːn
اڻٿڪ	ˌaɳəʈˈʌk
باراني	bˈaːraːnˌiː
باشعور	bˈaːʃaːˌoːr
بالله	bˈaːləlˌəh
باندر	bˈaːndər
باڊي	bˈaːɖi
باگڙين	bˈaːɡr.ˌiːn
بدقسمتي	bˌədəqˌəsəmˈʌt̪i
بدي	bˈʌdi
بذات	bˌəzˈaːt
براهمڻ	bˌəraːhəmˈʌɳ
برلا	bərˈʌlaː
برنارڊشا	bˌərnˌaːrəɖˈʌʃaː
برهان	bˌərhˈaːn
برو	bˈʌroː
بسال	bəsˈaːl
بشمول	bˌəʃmˈuːl
بلو	bˈʌloː
بنگلا	bənɡˈʌlaː
بها	bˈʌhaː
بهڻ	bəhˈʌɳ
بو	bˈoː
بولي	bˈoːli
بونا	bˈoːnaː
بيري	bˈeːri
بيلجيم	bˈeːlɟˌiːm
بيڪٽيريا	bˈeːkʈˌiːrjaː
بپتسما	bˌəpət̪əsˈʌmaː
بڊو	bˈʌɖoː
بڙدي	bər.ˈʌdi
بگهاڙ	bˌəɡhˈaːr.
بگڙي	bəɡˈʌr.i
بھاول	bˌəhaːˈoːl
تا	t̪ˈaː
تاثرات	t̪ˌaːsərˈaːt
تاڙي	t̪ˈaːr.i
تباه	t̪əbˈaːh
تحريري	t̪ˌəhrˈiːri
تحفا	t̪əhˈʌfaː
ترغيب	t̪ˌərɣˈiːb
تسڪين	t̪ˌəskˈiːn
تعجب	t̪aːɟˈʌb
تلهار	t̪ˌəlhˈaːr
تمثيلي	t̪ˌəmsˈiːli
تنتن	t̪ˌənət̪ˈʌn
تندور	t̪əndˈuːr
توسيع	t̪ˈoːsi
توکان	t̪oːkʰˈaːn
تياريون	t̪jaːrjˈoːn
تيرن	t̪eːrˈʌn
تڪسيد	t̪ˌəksˈiːd
تڻو	t̪ˈʌɳoː
ثواب	sʋˈaːb
جئسيه	ɟəsˈiːh
جاسوس	ɟaːsˈoːs
جاسوسن	ɟˌaːsoːsˈʌn
جدائي	ɟˈʊdaːˌiː
جلاوطني	ɟˌəlaːoːtˈʌni
جم	ɟˈʌm
جميعت	ɟəmˈiːt̪
جنتا	ɟənˈʌt̪aː
جهليو	ɟəhˈʌljoː
جهنڊ	ɟəhˈʌnɖ
جهيڙو	ɟəhˈiːr.oː
جهڙوڪر	ɟˌəhər.uːkˈʌr
جهڳٽو	ɟˌəhəɡˈʌʈoː
جوائن	ɟˈaʋaːˈɪn
جوابده	ɟˈaʋaːbˌədəh
جيروسلم	ɟˌeːroːsəlˈʌm
جيسيه	ɟeːsˈiːh
جيم	ɟˈeːm
جيڏيون	ɟeːɖjˈoːn
جڪ	ɟˈʌk
جھوڪ	ɟəhˈoːk
حاجيبايوف	hˌaːɟibˈaːjoːf
حرفن	hˌərəfˈʌn
حرمين	hˌərmˈiːn
حرڪتون	hˌərəkt̪ˈoːn
حسابي	hˌəsaːbˈiː
حلب	həlˈʌb
حوارين	hʋaːrˈiːn
خطيب	xətˈiːb
خودڪار	xˈʊdkaːr
خيبرپختونخوا	xˌeːbərˌəpxt̪oːnˈʌxʋaː
درٻيلي	dˌərbˈiːli
درپيش	dˌərpˈiːʃ
دستبردار	dˌəst̪əbrdˈaːr
دلشاد	dˌəlʃˈaːd
ديھون	deːhˈoːn
دک	dˈʌkʰ
ذمري	zəmˈʌri
راجائون	rˌaːɟaːˈoːn
راما	rˈaːmaː
رامچندر	rˌaːməcəndˈʌr
رانا	rˈaːnaː
راڄو	rˈaːɟoː
راڌا	rˈaːdʰaː
رجعت	rəɟˈaːt̪
رخن	rˈʊxn
رساله	rˌəsaːlˈʌh
رشتي	rˈʌʃt̪i
رفتي	rˈafətˌiː
رقبو	rˌəqbˈoː
رليون	rəljˈoːn
رنگا	rˈʌnɡaː
روماني	roːmˈaːni
روپوش	roːpˈoːʃ
ريجنل	rˌeːɟənˈʌl
ريفرينڊم	rˌeːfrinɖˈʌm
ريڙهي	reːr.ˈʌhi
ريڪارڊ	rˌeːkaːrˈʌɖ
رکو	rˈʌkʰoː
رڪارڊنگ	rˌəkaːrəɖˈʌnɡ
زر	zˈʌr
زهريلي	zˌəhərˈiːli
زيادتي	zjaːdˈʌt̪i
سائنسز	sˌaːɪnsˈʌz
سالو	sˈaːloː
ساهي	sˈaːhi
ساهڙ	saːhˈʌr.
ساٺ	sˈaːʈʰ
ساڙ	sˈaːr.
سبڪتگين	sˌəbəkˌət̪ɡˈiːn
ستابو	sˌət̪aːbˈoː
سجاڳي	səɟˈaːɡi
سرندي	sərˈʌndi
سرواڻي	sərʋˈaːɳi
سفارتخاني	sˌəfaːrˌət̪xˈaːni
سفرنامن	sˌəfərnaːmˈʌn
سفيرن	sˌəfirˈʌn
سلطانن	sˌəltaːnˈʌn
سلفر	sˌələfˈʌr
سمائجي	sˌəmaːˈɪɟi
سناتن	sˌənaːt̪ˈʌn
سنجيده	sˌənɟidˈʌh
سندرو	səndˈʌroː
سنڀاليندڙ	sˌənbʰˌaːlindˈʌr.
سهاسي	səhˈaːsi
سوجھرو	sˌoːɟəhˈʌroː
سورن	soːrˈʌn
سوري	sˈoːri
سوليماني	sˌoːlimˈaːni
سونھري	sˈoːnhri
سوڄن	soːɟˈʌn
سوڙهو	soːr.ˈʌhoː
سيارچن	sjaːrcˈʌn
سياسيات	sjˌaːsiˈaːt
سيدنا	seːdˈʌnaː
سيلرا	seːlˈʌraː
سيوا	sjʋˈaː
سيکاري	seːkʰˈaːri
سپت	səpˈʌt̪
سڃاتل	sˌəɲaːt̪ˈʌl
سچا	sˈʌcaː
سڙڪ	sər.ˈʌk
سگهاري	sˌəɡhˈaːri
سھراب	sˌəhrˈaːb
شاهديون	ʃˌaːhədjˈoːn
شاهپور	ʃˌaːhəpˈoːr
شاگردي	ʃaːɡˈʌrdi
شاھجھان	ʃˌaːhəɟhˈaːn
شاھڪار	ʃˌaːhkˈaːr
شاھہ	ʃaːhˈʌh
شرما	ʃərˈʌmaː
شق	ʃˈʌq
شمالي	ʃəmˈaːli
شمل	ʃəmˈʌl
شناس	ʃənˈaːs
شھادت	ʃˌəhaːdˈʌt̪
صابر	ʂaːbˈɪr
صفتن	ʂˌəfət̪ˈʌn
صوتي	ʂˈoːt̪i
طبقات	tˌəbəqˈaːt
طرفو	tərˈʌfoː
طنزيه	tˌənzˈiːh
طيب	tˈeːb
عادتن	ˌaːdət̪ˈʌn
عادي	ˈaːdi
عبادتگاهن	abˈaːdət̪ɡaːhˌən
عبادتگاهه	abˈaːdət̪ɡaːhˌəh
عتاب	at̪ˈaːb
عدي	ˈadi
عرفات	ˌarəfˈaːt
علحدگي	ˌaləhədˈʌɡi
علميت	ˌalmˈiːt̪
علييف	aljˈiːf
عماد	amˈaːd
عمدن	ˌamədˈʌn
عنات	ˌanˈaːt
عيدي	aˈiːdi
غفار	ɣəfˈaːr
غيرقانوني	ɣˌeːrqaːnˈoːni
فال	fˈaːl
فانٽ	faːnˈʌʈ
فتوح	fˈʌt̪oːh
فرخ	fərˈʌx
فرهنگ	fˌərəhˈʌnɡ
فلمساز	fˈɪlmsaːz
فورٽ	foːrˈʌʈ
قافين	qaːfˈiːn
قباچي	qəbˈaːci
قبض	qəbˈʌz
قربت	qˌərəbˈʌt̪
قريبي	qˌəribˈiː
قيدخاني	qˌeːdxˈaːni
لائبريرين	lˌaːɪbrirˈiːn
لائجي	laːˈɪɟi
لانچر	laːncˈʌr
لانگ	lˈaːnɡ
لاڏ	lˈaːɖ
لاھي	lˈaːhi
لبنان	lˌəbnˈaːn
لسان	ləsˈaːn
لغتن	lˌəɣət̪ˈʌn
لقبن	lˌəqəbˈʌn
لو	lˈoː
لوه	lˈoːh
لياري	ljˈaːri
ليز	lˈeːz
ليزر	leːzˈʌr
لينس	lˈeːns
ليٽر	leːʈˈʌr
ليکراج	lˌeːkʰrˈaːɟ
لٿل	ləʈˈʌl
لڏ	lˈʌɖ
لڙائين	lˌər.aːˈiːn
لڪسمبرگ	lˌəkəsˌəmbərˈʌɡ
لڪيل	lˈʌkjal
لڳس	ləɡˈʌs
لھرون	lˌəhrˈuːn
مؤثر	mˌəa͡ʊsˈʌr
ماد	mˈaːd
مالوند	maːlˈoːnd
مالٽا	maːlˈʌʈaː
ماهي	mˈaːhi
ماٹھن	mˌaːʈəhˈʌn
ماٹھو	maːʈˈʌhoː
ماٿيلي	maːtʰˈiːli
ماڃر	maːɲˈʌr
ماڇين	maːcʰˈiːn
ماڙيون	maːr.jˈoːn
ماڻڪاڻي	mˌaːɳkˈaːɳi
متناسب	mˌət̪naːsˈʌb
متولي	mət̪ˈoːli
مجاور	mˌəɟaːˈoːr
مجدد	mˌəɟədˈʌd
محلن	mˌəhəlˈʌn
مخاطب	mˌəxaːtˈʌb
مختار	məxt̪ˈaːr
مد	mˈʌd
مربع	mˌərbˈaː
مرثيو	mərˈʌsjoː
مرڪبن	mˌərəkəbˈʌn
مزدڪ	mˌəzədˈʌk
مسالو	məsˈaːloː
مساوي	məsˈaːʋi
مستي	mˈʌst̪i
مسيحي	məsˈiːhi
مشاعري	mˌəʃaːˈaːɪrˌiː
مشڪلات	mˌəʃəkˌəlˈaːt
مصرين	mˌəʂrˈiːn
مصيبتن	mˌəʂibət̪ˈʌn
مفلس	mˌəfəlˈʌs
مقداري	mˌəqdˈaːri
ملئي	məlˈʌi
ملايا	məlˈaːjaː
ملبار	mˌəlbˈaːr
ملٽي	məlˈʌʈi
ملڪيتون	mˌəlkit̪ˈoːn
ملھائيندا	mˌəlhaːˈiːndaː
مملڪتي	mˌəmələkˈʌt̪i
منڊ	mˈʌnɖ
منڊلي	mənɖˈʌli
منگي	mˈʌnɡi
مهار	məhˈaːr
مهتا	məhˈʌt̪aː
مهراڻي	mˌəhərˈaːɳi
مهرون	mˌəhərˈuːn
مهيسر	mˌəhisˈʌr
مورثي	moːrˈʌsi
موسي	mˈoːsi
مولابخش	mˌoːlaːbəxˈʌʃ
مونث	moːnˈʌs
ميراث	meːrˈaːs
ميلبورن	mˌeːlbˈoːrən
ميڊيسن	mˌeːɖisˈʌn
مٿرا	məʈˈʌraː
مڃائڻ	mˌəɲaːˈɪɳ
مچ	mˈʌc
مچائي	məcˈaːi
مڇ	mˈʌcʰ
مڪانن	mˌəkaːnˈʌn
ناما	nˈaːmaː
ناميارا	naːmjˈaːraː
نانگن	naːnɡˈʌn
ناڻو	nˈaːɳoː
نبوي	nəbʋˈiː
نحو	nˈʌhoː
نرواڻ	nərʋˈaːɳ
نشو	nˈʌʃoː
نظامن	nɪʐˈaːmn
نعمتن	nˌaːmət̪ˈʌn
نقاب	nəqˈaːb
نقادن	nˌəqaːdˈʌn
نوڙت	noːr.ˈʌt̪
نوڪرن	nˌoːkərˈʌn
نير	nˈeːr
نيشاپور	nˌeːʃaːpˈoːr
نيلام	neːlˈaːm
نينهن	nˌeːnəhˈʌn
نڪتن	nˌəkət̪ˈʌn
نگورنو	nˌəɡoːrˈʌnoː
هئاسين	hˌəaːsˈiːn
هاجره	hˌaːɟərˈʌh
هارمون	hˌaːrmˈoːn
هاڪي	hˈaːki
هفتا	həfˈʌt̪aː
هلڪا	həlˈʌkaː
همايوني	hˌəmaːjˈoːni
هنج	hənˈʌɟ
هيٺاهين	hˌeːʈʰaːhˈiːn
هڻنديون	hˌəɳndjˈoːn
والٽر	ʋˌaːləʈˈʌr
وان	ʋˈaːn
واهپو	ʋaːhˈʌpoː
واٽس	ʋaːʈˈʌs
واٽون	ʋaːʈˈoːn
وجه	ʋəɟˈʌh
وجهبا	ʋˌəɟəhəbˈaː
ورت	ʋərˈʌt̪
ورنيڪيولر	ʋˌərnˌiːkjoːlˈʌr
ورڪنگ	ʋˌərəkˈʌnɡ
وزني	ʋəzˈʌni
وسارڻ	ʋˌəsaːrˈʌɳ
ووٽنگ	ʋoːʈˈʌnɡ
وياراوالا	ʋjˌaːraːʋˈaːlaː
ويدانتي	ʋˌeːdaːnˈʌt̪i
وينجهري	ʋˌeːnəɟəhˈʌri
ويهارو	ʋeːhˈaːroː
ويچارا	ʋeːcˈaːraː
ويڪسين	ʋˌeːksˈiːn
ويڳي	ʋˈeːɡi
وڄ	ʋˈʌɟ
وڌائيندو	ʋˌədʰaːˈiːndoː
وڙهندا	ʋˌər.əhˈʌndaː
وڙهيا	ʋər.ˈʌhjaː
وڻندو	ʋəɳˈʌndoː
يوسي	jˈoːsi
يونيسيف	jˌoːnisˈiːf
يڪي	jˈʌki
ٺاڪر	ʈʰaːkˈʌr
ٺاھن	ʈʰaːhˈʌn
ٻارهون	bˌaːrhˈoːn
ٻاروتڻ	bˌaːroːt̪ˈʌɳ
ٻاٻيهو	baːbˈiːhoː
ٻڌا	bˈʌdʰaː
ٻڌائيندا	bˌədʰaːˈiːndaː
ٻڙي	bˈʌr.i
ٽربيونل	ʈˌərbjˈoːnəl
ٽولو	ʈˈoːloː
ٽوليون	ʈoːljˈoːn
ٽيڪسٽائيل	ʈˌeːkəsʈˈaːjal
ٽيڪنيڪي	ʈˌeːknˈiːki
ٽيڪنڪ	ʈˌeːkənˈʌk
ٽيگ	ʈˈeːɡ
پات	pˈaːt̪
پارس	paːrˈʌs
پارن	paːrˈʌn
پاليندا	paːlˈiːndaː
پاڳارو	paːɡˈaːroː
پاڻهي	paːɳˈʌhi
پتلو	pət̪ˈʌloː
پراچين	pˌəraːcˈiːn
پرلوڪ	pˌərlˈuːk
پروهت	pˌəroːhˈʌt̪
پرڀرو	pˌərəbʰˈʌroː
پرکيو	pərˈʌkʰjoː
پسائي	pəsˈaːi
پسارڪي	pˌəsaːrˈʌki
پسي	pˈʌsi
پشت	pˈʌʃt̪
پلستر	pˌələst̪ˈʌr
پليو	pˈʌljoː
پليگ	pəlˈiːɡ
پناهگير	pˌənaːhəɡˈiːr
پنڊي	pˈʌnɖi
پهريدار	pˌəhəridˈaːr
پهچائيندو	pˌəhəcaːˈiːndoː
پورچوگيز	pˌoːrcoːɡˈiːz
پورھيت	pˌoːrhˈiːt̪
پوپٽي	poːpˈʌʈi
پوکيل	pˈoːkʰjal
پيرين	peːrˈiːn
پيشنگوئي	pˌeːʃnɡˈoːi
پٺڀرائي	pˌəʈʰəbʰrˈaːi
پڌرنامي	pˌədʰərnˈaːmi
پڙھندا	pər.hˈʌndaː
پڙھندڙ	pˌər.həndˈʌr.
پڻس	pəɳˈʌs
پیش	pˈeːʃ
ٿرين	ʈərˈiːn
ٿل	ʈˈʌl
ٿلهيون	ʈˌəlhjˈoːn
ٿنڀا	ʈənˈʌbʰaː
ٿيڻي	tʰˈeːɳi
ٿڌا	ʈˈʌdʰaː
ڀاڪر	bʰaːkˈʌr
ڀاڻيجو	bʰaːɳˈiːɟoː
ڀرين	bʰərˈiːn
ڀڳتن	bʰˌəɡət̪ˈʌn
ڄاريون	ɟaːrjˈoːn
ڄاوا	ɟˈaːʋaː
ڄاڻايا	ɟaːɳˈaːjaː
ڄاڻون	ɟaːɳˈoːn
ڄڃ	ɟˈʌɲ
چئلينج	cˌəlinˈʌɟ
چاهيندا	caːhˈiːndaː
چاڙهيو	caːr.ˈʌhjoː
چاڙهڻ	cˌaːr.əhˈʌɳ
چاڳلي	caːɡˈʌli
چراگاھون	cˌəraːɡaːhˈoːn
چرڪس	cˌərəkˈʌs
چلي	cˈʌli
چنانچه	cˌənaːncˈʌh
چندي	cˈʌndi
چهچ	cəhˈʌc
چوهاڻ	coːhˈaːɳ
چوڏھن	cˌoːɖəhˈʌn
چوگرد	coːɡˈʌrd
چير	cˈeːr
چٽيو	cˈʌʈjoː
چٽڻي	cəʈˈʌɳi
چپلن	cˌəpəlˈʌn
چڱيون	cˌəŋ̩jˈoːn
ڇتو	cʰˈʌt̪oː
ڇلر	cʰəlˈʌr
ڇوٽ	cʰˈoːʈ
ڇٽو	cʰˈʌʈoː
ڊائجسٽ	ɖˌaːɪɟəsˈʌʈ
ڊرائيونگ	ɖˌəraːjˈoːnɡ
ڊويزنون	ɖʋˌeːznˈoːn
ڊيوڪ	ɖjˈoːk
ڊيگھھ	ɖeːɡʰˈʌh
ڊڀري	ɖəbʰˈʌri
ڊگهين	ɖˌəɡhˈiːn
ڌرمداس	dʰˌərəmdˈaːs
ڌنار	dʰənˈaːr
ڌنڌ	dʰˈʌndʰ
ڌوڪي	dʰˈoːki
ڌٻڻ	dʰəbˈʌɳ
ڌڙ	dʰˈʌr.
ڍال	ɖʰˈaːl
ڍاٽ	ɖʰˈaːʈ
ڍڪجي	ɖʰəkˈʌɟi
ڍڳيون	ɖʰəɡjˈoːn
ڏ	ɖˈeː
ڏاج	ɖˈaːɟ
ڏاهري	ɖaːhˈʌri
ڏاهي	ɖˈaːhi
ڏاکڻين	ɖˌaːkʰɳˈiːn
ڏاکڻيون	ɖˌaːkʰɳjˈoːn
ڏسڻو	ɖɪsˈʌɳoː
ڏهي	ɖˈʌhi
ڏوري	ɖˈoːri
ڏيئو	ɖˈeːoː
ڏيپلو	ɖeːpˈʌloː
ڏيھي	ɖˈeːhi
ڦار	pʰˈaːr
ڦاھي	pʰˈaːhi
ڦڪا	pʰˈʌkaː
کاتا	kʰˈaːt̪aː
کتل	kʰət̪ˈʌl
کلڻ	kʰəlˈʌɳ
کوليون	kʰoːljˈoːn
کڙي	kʰˈʌr.i
کڻندڙ	kʰˌəɳəndˈʌr.
کیا	kʰjˈaː
ڪئمبرج	kˌəmbərˈʌɟ
ڪئمپس	kəmpˈʌs
ڪارائتا	kˌaːraːˈɪt̪aː
ڪاراباخ	kˌaːraːbˈaːx
ڪاراڻ	kaːrˈaːɳ
ڪارروايون	kˌaːrrʋaːjˈoːn
ڪاغذن	kˌaːɣəzˈʌn
ڪاوڙجي	kˌaːoːr.ˈʌɟi
ڪاڪا	kˈaːkaː
ڪجھہ	kˌəɟəhˈʌh
ڪرام	kərˈaːm
ڪرامت	kˌəraːmˈʌt̪
ڪرتب	kˌərət̪ˈʌb
ڪرمنل	kˌərəmənˈʌl
ڪسي	kˈʌsi
ڪشادو	kəʃˈaːdoː
ڪلمتي	kˌələmˈʌt̪i
ڪمائتو	kˌəmaːˈɪt̪oː
ڪمپيئر	kˌəmpiˈɪr
ڪمپيئرنگ	kˌəmpiˈɪrənɡ
ڪنب	kˈʌnb
ڪنداسين	kˌəndaːsˈiːn
ڪهڙيون	kˌəhər.jˈoːn
ڪوريائي	koːrjˈaːi
ڪورٽن	kˌoːrəʈˈʌn
ڪوٺائي	koːʈʰˈaːi
ڪوپرنيڪس	kˌoːpərnikˈʌs
ڪيان	kjˈaːn
ڪيرالا	keːrˈaːlaː
ڪيلو	kˈeːloː
ڪيلٽڪ	kˌeːləʈˈʌk
ڪيوبا	kjoːbˈaː
ڪيڊٽ	keːɖˈʌʈ
ڪيڏو	kˈeːɖoː
ڪٽر	kəʈˈʌr
ڪکن	kəkʰˈʌn
گئسي	ɡˈʌsi
گايتري	ɡˌaːit̪ˈʌri
گدرا	ɡədˈʌraː
گذار	ɡəzˈaːr
گرد	ɡˈʌrd
گرڙيون	ɡˌərr.jˈoːn
گلو	ɡˈʌloː
گلوبل	ɡˌəloːbˈʌl
گليشيئر	ɡˌəliʃiˈɪr
گهرندا	ɡˌəhərˈʌndaː
گهرندو	ɡˌəhərˈʌndoː
گهرڻ	ɡˌəhərˈʌɳ
گهمندو	ɡˌəhəmˈʌndoː
گهور	ɡəhˈoːr
گهي	ɡˈʌhi
گهٽي	ɡəhˈʌʈi
گهڙين	ɡˌəhər.ˈiːn
گهڙيو	ɡəhˈʌr.joː
گوني	ɡˈoːni
گوپال	ɡoːpˈaːl
گڏائي	ɡəɖˈaːi
گھرائي	ɡʰərˈaːi
گھڻين	ɡʰəɳˈiːn
ڳائبي	ɡˌaːɪbˈiː
ڳالهائيندو	ɡˌaːlhaːˈiːndoː
ڳالهائيندي	ɡˌaːlhaːˈiːndi
ڳالهايو	ɡˌaːlhˈaːjoː
ڳالھائڻ	ɡˌaːlhaːˈɪɳ
ڳرا	ɡˈʌraː
ڳنڍڻ	ɡˌənəɖʰˈʌɳ
ڳوٺاڻا	ɡoːʈʰˈaːɳaː
ڳوڙهيون	ɡˌoːr.hjˈoːn
ڳڙھي	ɡˈʌr.hi
ھار	hˈaːr
ھارمون	hˌaːrmˈoːn
ھضم	həzˈʌm
ھمايون	hˌəmaːjˈoːn
ھوائن	hʋaːˈɪn
ھوابازي	hʋaːbˈaːzi
ھيٺيان	heːʈʰjˈaːn
ھٽائي	həʈˈaːi
ھڪدم	hˌəkədˈʌm
ھڪڙا	həkˈʌr.aː
ھگانا	həɡˈaːnaː
